구분,대여소명,,대여일자,대여건수,반납건수,합계,위도,경도
마포구,101, (구)합정동 주민센터,201901,233,234,467,37.549561,126.905754
마포구,101, (구)합정동 주민센터,201902,203,227,430,37.549561,126.905754
마포구,101, (구)합정동 주민센터,201903,423,475,898,37.549561,126.905754
마포구,101, (구)합정동 주민센터,201904,640,734,1374,37.549561,126.905754
마포구,101, (구)합정동 주민센터,201905,1068,1128,2196,37.549561,126.905754
마포구,101, (구)합정동 주민센터,201906,1104,1094,2198,37.549561,126.905754
마포구,101, (구)합정동 주민센터,201907,1050,1060,2110,37.549561,126.905754
마포구,101, (구)합정동 주민센터,201908,976,963,1939,37.549561,126.905754
마포구,101, (구)합정동 주민센터,201909,850,848,1698,37.549561,126.905754
마포구,101, (구)합정동 주민센터,201910,1045,1070,2115,37.549561,126.905754
마포구,101, (구)합정동 주민센터,201911,646,670,1316,37.549561,126.905754
마포구,101, (구)합정동 주민센터,201912,424,396,820,37.549561,126.905754
마포구,101, (구)합정동 주민센터,202001,305,313,618,37.549561,126.905754
마포구,101, (구)합정동 주민센터,202002,308,307,615,37.549561,126.905754
마포구,101, (구)합정동 주민센터,202003,646,640,1286,37.549561,126.905754
마포구,101, (구)합정동 주민센터,202004,758,757,1515,37.549561,126.905754
마포구,101, (구)합정동 주민센터,202005,881,887,1768,37.549561,126.905754
마포구,101, (구)합정동 주민센터,202006,995,976,1971,37.549561,126.905754
마포구,102, 망원역 1번출구 앞,201901,766,825,1591,37.555649,126.910629
마포구,102, 망원역 1번출구 앞,201902,758,693,1451,37.555649,126.910629
마포구,102, 망원역 1번출구 앞,201903,1640,1654,3294,37.555649,126.910629
마포구,102, 망원역 1번출구 앞,201904,2694,2520,5214,37.555649,126.910629
마포구,102, 망원역 1번출구 앞,201905,4151,3800,7951,37.555649,126.910629
마포구,102, 망원역 1번출구 앞,201906,4337,3973,8310,37.555649,126.910629
마포구,102, 망원역 1번출구 앞,201907,3973,3646,7619,37.555649,126.910629
마포구,102, 망원역 1번출구 앞,201908,4285,3900,8185,37.555649,126.910629
마포구,102, 망원역 1번출구 앞,201909,3453,3336,6789,37.555649,126.910629
마포구,102, 망원역 1번출구 앞,201910,4648,4266,8914,37.555649,126.910629
마포구,102, 망원역 1번출구 앞,201911,2701,2567,5268,37.555649,126.910629
마포구,102, 망원역 1번출구 앞,201912,1537,1497,3034,37.555649,126.910629
마포구,102, 망원역 1번출구 앞,202001,1329,1294,2623,37.555649,126.910629
마포구,102, 망원역 1번출구 앞,202002,1296,1204,2500,37.555649,126.910629
마포구,102, 망원역 1번출구 앞,202003,2598,2516,5114,37.555649,126.910629
마포구,102, 망원역 1번출구 앞,202004,3428,3244,6672,37.555649,126.910629
마포구,102, 망원역 1번출구 앞,202005,3786,3583,7369,37.555649,126.910629
마포구,102, 망원역 1번출구 앞,202006,4138,3858,7996,37.555649,126.910629
마포구,103, 망원역 2번출구 앞,201901,600,626,1226,37.554951,126.910835
마포구,103, 망원역 2번출구 앞,201902,574,595,1169,37.554951,126.910835
마포구,103, 망원역 2번출구 앞,201903,1256,1303,2559,37.554951,126.910835
마포구,103, 망원역 2번출구 앞,201904,1873,1852,3725,37.554951,126.910835
마포구,103, 망원역 2번출구 앞,201905,2633,2490,5123,37.554951,126.910835
마포구,103, 망원역 2번출구 앞,201906,2914,2790,5704,37.554951,126.910835
마포구,103, 망원역 2번출구 앞,201907,2685,2581,5266,37.554951,126.910835
마포구,103, 망원역 2번출구 앞,201908,2609,2393,5002,37.554951,126.910835
마포구,103, 망원역 2번출구 앞,201909,2577,2540,5117,37.554951,126.910835
마포구,103, 망원역 2번출구 앞,201910,3055,3024,6079,37.554951,126.910835
마포구,103, 망원역 2번출구 앞,201911,1680,1653,3333,37.554951,126.910835
마포구,103, 망원역 2번출구 앞,201912,906,924,1830,37.554951,126.910835
마포구,103, 망원역 2번출구 앞,202001,772,831,1603,37.554951,126.910835
마포구,103, 망원역 2번출구 앞,202002,734,786,1520,37.554951,126.910835
마포구,103, 망원역 2번출구 앞,202003,1861,1913,3774,37.554951,126.910835
마포구,103, 망원역 2번출구 앞,202004,2636,2546,5182,37.554951,126.910835
마포구,103, 망원역 2번출구 앞,202005,3112,3060,6172,37.554951,126.910835
마포구,103, 망원역 2번출구 앞,202006,3041,2992,6033,37.554951,126.910835
마포구,104, 합정역 1번출구 앞,201901,647,589,1236,37.550629,126.914986
마포구,104, 합정역 1번출구 앞,201902,633,537,1170,37.550629,126.914986
마포구,104, 합정역 1번출구 앞,201903,1225,976,2201,37.550629,126.914986
마포구,104, 합정역 1번출구 앞,201904,1561,1346,2907,37.550629,126.914986
마포구,104, 합정역 1번출구 앞,201905,2456,2340,4796,37.550629,126.914986
마포구,104, 합정역 1번출구 앞,201906,2443,2352,4795,37.550629,126.914986
마포구,104, 합정역 1번출구 앞,201907,2323,2174,4497,37.550629,126.914986
마포구,104, 합정역 1번출구 앞,201908,2007,1781,3788,37.550629,126.914986
마포구,104, 합정역 1번출구 앞,201909,2163,2054,4217,37.550629,126.914986
마포구,104, 합정역 1번출구 앞,201910,2596,2475,5071,37.550629,126.914986
마포구,104, 합정역 1번출구 앞,201911,1896,1600,3496,37.550629,126.914986
마포구,104, 합정역 1번출구 앞,201912,1085,826,1911,37.550629,126.914986
마포구,104, 합정역 1번출구 앞,202001,905,707,1612,37.550629,126.914986
마포구,104, 합정역 1번출구 앞,202002,915,765,1680,37.550629,126.914986
마포구,104, 합정역 1번출구 앞,202003,1700,1555,3255,37.550629,126.914986
마포구,104, 합정역 1번출구 앞,202004,2183,2133,4316,37.550629,126.914986
마포구,104, 합정역 1번출구 앞,202005,2116,2104,4220,37.550629,126.914986
마포구,104, 합정역 1번출구 앞,202006,2131,2101,4232,37.550629,126.914986
마포구,105, 합정역 5번출구 앞,201901,417,302,719,37.550007,126.914825
마포구,105, 합정역 5번출구 앞,201902,430,293,723,37.550007,126.914825
마포구,105, 합정역 5번출구 앞,201903,757,564,1321,37.550007,126.914825
마포구,105, 합정역 5번출구 앞,201904,1057,868,1925,37.550007,126.914825
마포구,105, 합정역 5번출구 앞,201905,1373,1250,2623,37.550007,126.914825
마포구,105, 합정역 5번출구 앞,201906,1404,1333,2737,37.550007,126.914825
마포구,105, 합정역 5번출구 앞,201907,1178,1110,2288,37.550007,126.914825
마포구,105, 합정역 5번출구 앞,201908,1096,1020,2116,37.550007,126.914825
마포구,105, 합정역 5번출구 앞,201909,1137,1100,2237,37.550007,126.914825
마포구,105, 합정역 5번출구 앞,201910,1370,1313,2683,37.550007,126.914825
마포구,105, 합정역 5번출구 앞,201911,447,421,868,37.550007,126.914825
마포구,105, 합정역 5번출구 앞,201912,481,399,880,37.550007,126.914825
마포구,105, 합정역 5번출구 앞,202001,504,397,901,37.550007,126.914825
마포구,105, 합정역 5번출구 앞,202002,445,404,849,37.550007,126.914825
마포구,105, 합정역 5번출구 앞,202003,949,899,1848,37.550007,126.914825
마포구,105, 합정역 5번출구 앞,202004,1322,1302,2624,37.550007,126.914825
마포구,105, 합정역 5번출구 앞,202005,1537,1526,3063,37.550007,126.914825
마포구,105, 합정역 5번출구 앞,202006,1515,1462,2977,37.550007,126.914825
마포구,106, 합정역 7번출구 앞,201901,830,698,1528,37.548645,126.912827
마포구,106, 합정역 7번출구 앞,201902,849,805,1654,37.548645,126.912827
마포구,106, 합정역 7번출구 앞,201903,1831,1762,3593,37.548645,126.912827
마포구,106, 합정역 7번출구 앞,201904,3556,3420,6976,37.548645,126.912827
마포구,106, 합정역 7번출구 앞,201905,5278,5220,10498,37.548645,126.912827
마포구,106, 합정역 7번출구 앞,201906,5258,5182,10440,37.548645,126.912827
마포구,106, 합정역 7번출구 앞,201907,3899,3725,7624,37.548645,126.912827
마포구,106, 합정역 7번출구 앞,201908,4297,4147,8444,37.548645,126.912827
마포구,106, 합정역 7번출구 앞,201909,4602,4549,9151,37.548645,126.912827
마포구,106, 합정역 7번출구 앞,201910,5510,5452,10962,37.548645,126.912827
마포구,106, 합정역 7번출구 앞,201911,2844,2740,5584,37.548645,126.912827
마포구,106, 합정역 7번출구 앞,201912,1268,1133,2401,37.548645,126.912827
마포구,106, 합정역 7번출구 앞,202001,1109,1009,2118,37.548645,126.912827
마포구,106, 합정역 7번출구 앞,202002,1299,1304,2603,37.548645,126.912827
마포구,106, 합정역 7번출구 앞,202003,4332,4450,8782,37.548645,126.912827
마포구,106, 합정역 7번출구 앞,202004,6237,6280,12517,37.548645,126.912827
마포구,106, 합정역 7번출구 앞,202005,6221,6216,12437,37.548645,126.912827
마포구,106, 합정역 7번출구 앞,202006,5561,5535,11096,37.548645,126.912827
마포구,107, 신한은행 서교동금융센터점 앞,201901,884,1285,2169,37.55751,126.918503
마포구,107, 신한은행 서교동금융센터점 앞,201902,699,1013,1712,37.55751,126.918503
마포구,107, 신한은행 서교동금융센터점 앞,201903,1318,1847,3165,37.55751,126.918503
마포구,107, 신한은행 서교동금융센터점 앞,201904,1839,2402,4241,37.55751,126.918503
마포구,107, 신한은행 서교동금융센터점 앞,201905,2883,3364,6247,37.55751,126.918503
마포구,107, 신한은행 서교동금융센터점 앞,201906,3054,3529,6583,37.55751,126.918503
마포구,107, 신한은행 서교동금융센터점 앞,201907,3321,3779,7100,37.55751,126.918503
마포구,107, 신한은행 서교동금융센터점 앞,201908,3106,3515,6621,37.55751,126.918503
마포구,107, 신한은행 서교동금융센터점 앞,201909,2686,3155,5841,37.55751,126.918503
마포구,107, 신한은행 서교동금융센터점 앞,201910,3250,3866,7116,37.55751,126.918503
마포구,107, 신한은행 서교동금융센터점 앞,201911,2091,2574,4665,37.55751,126.918503
마포구,107, 신한은행 서교동금융센터점 앞,201912,1208,1622,2830,37.55751,126.918503
마포구,107, 신한은행 서교동금융센터점 앞,202001,1078,1453,2531,37.55751,126.918503
마포구,107, 신한은행 서교동금융센터점 앞,202002,1059,1413,2472,37.55751,126.918503
마포구,107, 신한은행 서교동금융센터점 앞,202003,1795,2172,3967,37.55751,126.918503
마포구,107, 신한은행 서교동금융센터점 앞,202004,2491,2878,5369,37.55751,126.918503
마포구,107, 신한은행 서교동금융센터점 앞,202005,2955,3137,6092,37.55751,126.918503
마포구,107, 신한은행 서교동금융센터점 앞,202006,3231,3508,6739,37.55751,126.918503
마포구,108, 서교동 사거리,201901,609,654,1263,37.552746,126.918617
마포구,108, 서교동 사거리,201902,539,550,1089,37.552746,126.918617
마포구,108, 서교동 사거리,201903,1077,1103,2180,37.552746,126.918617
마포구,108, 서교동 사거리,201904,1497,1589,3086,37.552746,126.918617
마포구,108, 서교동 사거리,201905,2211,2376,4587,37.552746,126.918617
마포구,108, 서교동 사거리,201906,2362,2409,4771,37.552746,126.918617
마포구,108, 서교동 사거리,201907,2135,2217,4352,37.552746,126.918617
마포구,108, 서교동 사거리,201908,2079,2056,4135,37.552746,126.918617
마포구,108, 서교동 사거리,201909,1879,1926,3805,37.552746,126.918617
마포구,108, 서교동 사거리,201910,2246,2291,4537,37.552746,126.918617
마포구,108, 서교동 사거리,201911,1592,1619,3211,37.552746,126.918617
마포구,108, 서교동 사거리,201912,1016,1032,2048,37.552746,126.918617
마포구,108, 서교동 사거리,202001,759,775,1534,37.552746,126.918617
마포구,108, 서교동 사거리,202002,744,781,1525,37.552746,126.918617
마포구,108, 서교동 사거리,202003,1329,1333,2662,37.552746,126.918617
마포구,108, 서교동 사거리,202004,1831,1813,3644,37.552746,126.918617
마포구,108, 서교동 사거리,202005,2017,2026,4043,37.552746,126.918617
마포구,108, 서교동 사거리,202006,1985,2014,3999,37.552746,126.918617
마포구,109, 제일빌딩 앞,201901,459,594,1053,37.547691,126.919983
마포구,109, 제일빌딩 앞,201902,481,479,960,37.547691,126.919983
마포구,109, 제일빌딩 앞,201903,936,992,1928,37.547691,126.919983
마포구,109, 제일빌딩 앞,201904,1600,1607,3207,37.547691,126.919983
마포구,109, 제일빌딩 앞,201905,2587,2484,5071,37.547691,126.919983
마포구,109, 제일빌딩 앞,201906,2589,2501,5090,37.547691,126.919983
마포구,109, 제일빌딩 앞,201907,2414,2307,4721,37.547691,126.919983
마포구,109, 제일빌딩 앞,201908,2291,2222,4513,37.547691,126.919983
마포구,109, 제일빌딩 앞,201909,2265,2178,4443,37.547691,126.919983
마포구,109, 제일빌딩 앞,201910,2713,2592,5305,37.547691,126.919983
마포구,109, 제일빌딩 앞,201911,1434,1468,2902,37.547691,126.919983
마포구,109, 제일빌딩 앞,201912,770,795,1565,37.547691,126.919983
마포구,109, 제일빌딩 앞,202001,686,761,1447,37.547691,126.919983
마포구,109, 제일빌딩 앞,202002,716,702,1418,37.547691,126.919983
마포구,109, 제일빌딩 앞,202003,1584,1655,3239,37.547691,126.919983
마포구,109, 제일빌딩 앞,202004,866,851,1717,37.547691,126.919983
마포구,109, 제일빌딩 앞,202005,2351,2348,4699,37.547691,126.919983
마포구,109, 제일빌딩 앞,202006,2459,2417,4876,37.547691,126.919983
서대문구,110, 사천교,201901,272,153,425,#N/A,#N/A
서대문구,110, 사천교,201902,329,201,530,#N/A,#N/A
서대문구,110, 사천교,201903,628,397,1025,#N/A,#N/A
서대문구,110, 사천교,201904,903,592,1495,#N/A,#N/A
서대문구,110, 사천교,201905,1362,905,2267,#N/A,#N/A
서대문구,110, 사천교,201906,1458,979,2437,#N/A,#N/A
서대문구,110, 사천교,201907,1509,969,2478,#N/A,#N/A
서대문구,110, 사천교,201908,1297,844,2141,#N/A,#N/A
서대문구,110, 사천교,201909,1104,830,1934,#N/A,#N/A
서대문구,110, 사천교,201910,1186,856,2042,#N/A,#N/A
서대문구,110, 사천교,201911,908,581,1489,#N/A,#N/A
서대문구,110, 사천교,201912,588,328,916,#N/A,#N/A
서대문구,110, 사천교,202001,458,309,767,#N/A,#N/A
서대문구,110, 사천교,202002,465,334,799,#N/A,#N/A
서대문구,110, 사천교,202003,792,615,1407,#N/A,#N/A
서대문구,110, 사천교,202004,794,726,1520,#N/A,#N/A
서대문구,110, 사천교,202005,859,772,1631,#N/A,#N/A
서대문구,110, 사천교,202006,1042,795,1837,#N/A,#N/A
마포구,111, 상수역 2번출구 앞,201901,391,307,698,37.547871,126.923531
마포구,111, 상수역 2번출구 앞,201902,444,416,860,37.547871,126.923531
마포구,111, 상수역 2번출구 앞,201903,1026,967,1993,37.547871,126.923531
마포구,111, 상수역 2번출구 앞,201904,1596,1454,3050,37.547871,126.923531
마포구,111, 상수역 2번출구 앞,201905,2334,2255,4589,37.547871,126.923531
마포구,111, 상수역 2번출구 앞,201906,2175,2092,4267,37.547871,126.923531
마포구,111, 상수역 2번출구 앞,201907,1921,1844,3765,37.547871,126.923531
마포구,111, 상수역 2번출구 앞,201908,1818,1749,3567,37.547871,126.923531
마포구,111, 상수역 2번출구 앞,201909,2010,1973,3983,37.547871,126.923531
마포구,111, 상수역 2번출구 앞,201910,2122,2086,4208,37.547871,126.923531
마포구,111, 상수역 2번출구 앞,201911,1210,1089,2299,37.547871,126.923531
마포구,111, 상수역 2번출구 앞,201912,541,455,996,37.547871,126.923531
마포구,111, 상수역 2번출구 앞,202001,496,423,919,37.547871,126.923531
마포구,111, 상수역 2번출구 앞,202002,523,498,1021,37.547871,126.923531
마포구,111, 상수역 2번출구 앞,202003,1719,1814,3533,37.547871,126.923531
마포구,111, 상수역 2번출구 앞,202004,2557,2710,5267,37.547871,126.923531
마포구,111, 상수역 2번출구 앞,202005,2325,2299,4624,37.547871,126.923531
마포구,111, 상수역 2번출구 앞,202006,2111,2065,4176,37.547871,126.923531
마포구,112, 극동방송국 앞,201901,399,352,751,37.549202,126.923203
마포구,112, 극동방송국 앞,201902,389,354,743,37.549202,126.923203
마포구,112, 극동방송국 앞,201903,954,936,1890,37.549202,126.923203
마포구,112, 극동방송국 앞,201904,1588,1676,3264,37.549202,126.923203
마포구,112, 극동방송국 앞,201905,2290,2223,4513,37.549202,126.923203
마포구,112, 극동방송국 앞,201906,2180,2196,4376,37.549202,126.923203
마포구,112, 극동방송국 앞,201907,1808,1753,3561,37.549202,126.923203
마포구,112, 극동방송국 앞,201908,1517,1455,2972,37.549202,126.923203
마포구,112, 극동방송국 앞,201909,1901,1905,3806,37.549202,126.923203
마포구,112, 극동방송국 앞,201910,2140,2136,4276,37.549202,126.923203
마포구,112, 극동방송국 앞,201911,1245,1258,2503,37.549202,126.923203
마포구,112, 극동방송국 앞,201912,624,628,1252,37.549202,126.923203
마포구,112, 극동방송국 앞,202001,493,527,1020,37.549202,126.923203
마포구,112, 극동방송국 앞,202002,496,484,980,37.549202,126.923203
마포구,112, 극동방송국 앞,202003,1082,1141,2223,37.549202,126.923203
마포구,112, 극동방송국 앞,202004,1667,1634,3301,37.549202,126.923203
마포구,112, 극동방송국 앞,202005,1547,1544,3091,37.549202,126.923203
마포구,112, 극동방송국 앞,202006,1580,1548,3128,37.549202,126.923203
마포구,113, 홍대입구역 2번출구 앞,201901,2313,3132,5445,37.557499,126.923805
마포구,113, 홍대입구역 2번출구 앞,201902,2072,2748,4820,37.557499,126.923805
마포구,113, 홍대입구역 2번출구 앞,201903,4414,5572,9986,37.557499,126.923805
마포구,113, 홍대입구역 2번출구 앞,201904,5407,7112,12519,37.557499,126.923805
마포구,113, 홍대입구역 2번출구 앞,201905,8378,10214,18592,37.557499,126.923805
마포구,113, 홍대입구역 2번출구 앞,201906,8894,10453,19347,37.557499,126.923805
마포구,113, 홍대입구역 2번출구 앞,201907,7889,9376,17265,37.557499,126.923805
마포구,113, 홍대입구역 2번출구 앞,201908,7690,8443,16133,37.557499,126.923805
마포구,113, 홍대입구역 2번출구 앞,201909,7388,8286,15674,37.557499,126.923805
마포구,113, 홍대입구역 2번출구 앞,201910,9047,10365,19412,37.557499,126.923805
마포구,113, 홍대입구역 2번출구 앞,201911,6036,7334,13370,37.557499,126.923805
마포구,113, 홍대입구역 2번출구 앞,201912,3681,4322,8003,37.557499,126.923805
마포구,113, 홍대입구역 2번출구 앞,202001,2864,3566,6430,37.557499,126.923805
마포구,113, 홍대입구역 2번출구 앞,202002,2676,3460,6136,37.557499,126.923805
마포구,113, 홍대입구역 2번출구 앞,202003,4690,5330,10020,37.557499,126.923805
마포구,113, 홍대입구역 2번출구 앞,202004,6534,7068,13602,37.557499,126.923805
마포구,113, 홍대입구역 2번출구 앞,202005,6818,7164,13982,37.557499,126.923805
마포구,113, 홍대입구역 2번출구 앞,202006,6583,7436,14019,37.557499,126.923805
마포구,114, 홍대입구역 8번출구 앞,201901,966,1121,2087,37.55706,126.924423
마포구,114, 홍대입구역 8번출구 앞,201902,868,956,1824,37.55706,126.924423
마포구,114, 홍대입구역 8번출구 앞,201903,1719,2069,3788,37.55706,126.924423
마포구,114, 홍대입구역 8번출구 앞,201904,2640,2899,5539,37.55706,126.924423
마포구,114, 홍대입구역 8번출구 앞,201905,4004,4177,8181,37.55706,126.924423
마포구,114, 홍대입구역 8번출구 앞,201906,4203,4348,8551,37.55706,126.924423
마포구,114, 홍대입구역 8번출구 앞,201907,3515,3664,7179,37.55706,126.924423
마포구,114, 홍대입구역 8번출구 앞,201908,3385,3441,6826,37.55706,126.924423
마포구,114, 홍대입구역 8번출구 앞,201909,3282,3387,6669,37.55706,126.924423
마포구,114, 홍대입구역 8번출구 앞,201910,4004,4146,8150,37.55706,126.924423
마포구,114, 홍대입구역 8번출구 앞,201911,2491,2652,5143,37.55706,126.924423
마포구,114, 홍대입구역 8번출구 앞,201912,1465,1518,2983,37.55706,126.924423
마포구,114, 홍대입구역 8번출구 앞,202001,1289,1317,2606,37.55706,126.924423
마포구,114, 홍대입구역 8번출구 앞,202002,1125,1231,2356,37.55706,126.924423
마포구,114, 홍대입구역 8번출구 앞,202003,2188,2185,4373,37.55706,126.924423
마포구,114, 홍대입구역 8번출구 앞,202004,3242,3215,6457,37.55706,126.924423
마포구,114, 홍대입구역 8번출구 앞,202005,3462,3448,6910,37.55706,126.924423
마포구,114, 홍대입구역 8번출구 앞,202006,3212,3165,6377,37.55706,126.924423
서대문구,115, 사루비아 빌딩 앞,201901,637,546,1183,37.558933,126.927116
서대문구,115, 사루비아 빌딩 앞,201902,553,519,1072,37.558933,126.927116
서대문구,115, 사루비아 빌딩 앞,201903,991,913,1904,37.558933,126.927116
서대문구,115, 사루비아 빌딩 앞,201904,1493,1301,2794,37.558933,126.927116
서대문구,115, 사루비아 빌딩 앞,201905,2018,1740,3758,37.558933,126.927116
서대문구,115, 사루비아 빌딩 앞,201906,2118,1945,4063,37.558933,126.927116
서대문구,115, 사루비아 빌딩 앞,201907,2046,1797,3843,37.558933,126.927116
서대문구,115, 사루비아 빌딩 앞,201908,1838,1618,3456,37.558933,126.927116
서대문구,115, 사루비아 빌딩 앞,201909,1557,1460,3017,37.558933,126.927116
서대문구,115, 사루비아 빌딩 앞,201910,1987,1843,3830,37.558933,126.927116
서대문구,115, 사루비아 빌딩 앞,201911,1415,1159,2574,37.558933,126.927116
서대문구,115, 사루비아 빌딩 앞,201912,912,699,1611,37.558933,126.927116
서대문구,115, 사루비아 빌딩 앞,202001,795,640,1435,37.558933,126.927116
서대문구,115, 사루비아 빌딩 앞,202002,689,533,1222,37.558933,126.927116
서대문구,115, 사루비아 빌딩 앞,202003,1062,899,1961,37.558933,126.927116
서대문구,115, 사루비아 빌딩 앞,202004,1376,1273,2649,37.558933,126.927116
서대문구,115, 사루비아 빌딩 앞,202005,1375,1348,2723,37.558933,126.927116
서대문구,115, 사루비아 빌딩 앞,202006,1155,1110,2265,37.558933,126.927116
서대문구,116, 일진아이윌아파트 옆,201901,712,947,1659,37.564541,126.927071
서대문구,116, 일진아이윌아파트 옆,201902,570,766,1336,37.564541,126.927071
서대문구,116, 일진아이윌아파트 옆,201903,1109,1348,2457,37.564541,126.927071
서대문구,116, 일진아이윌아파트 옆,201904,1372,1568,2940,37.564541,126.927071
서대문구,116, 일진아이윌아파트 옆,201905,2164,2246,4410,37.564541,126.927071
서대문구,116, 일진아이윌아파트 옆,201906,2478,2520,4998,37.564541,126.927071
서대문구,116, 일진아이윌아파트 옆,201907,2146,2325,4471,37.564541,126.927071
서대문구,116, 일진아이윌아파트 옆,201908,2351,2456,4807,37.564541,126.927071
서대문구,116, 일진아이윌아파트 옆,201909,2019,2110,4129,37.564541,126.927071
서대문구,116, 일진아이윌아파트 옆,201910,2315,2469,4784,37.564541,126.927071
서대문구,116, 일진아이윌아파트 옆,201911,1331,1569,2900,37.564541,126.927071
서대문구,116, 일진아이윌아파트 옆,201912,917,1133,2050,37.564541,126.927071
서대문구,116, 일진아이윌아파트 옆,202001,789,905,1694,37.564541,126.927071
서대문구,116, 일진아이윌아파트 옆,202002,734,797,1531,37.564541,126.927071
서대문구,116, 일진아이윌아파트 옆,202003,1335,1410,2745,37.564541,126.927071
서대문구,116, 일진아이윌아파트 옆,202004,1937,1935,3872,37.564541,126.927071
서대문구,116, 일진아이윌아파트 옆,202005,2313,2309,4622,37.564541,126.927071
서대문구,116, 일진아이윌아파트 옆,202006,2287,2306,4593,37.564541,126.927071
서대문구,117, 홍은사거리,201903,40,32,72,37.59116,126.94133
서대문구,117, 홍은사거리,201904,1792,1744,3536,37.59116,126.94133
서대문구,117, 홍은사거리,201905,3227,3213,6440,37.59116,126.94133
서대문구,117, 홍은사거리,201906,3760,3786,7546,37.59116,126.94133
서대문구,117, 홍은사거리,201907,3403,3281,6684,37.59116,126.94133
서대문구,117, 홍은사거리,201908,2986,3005,5991,37.59116,126.94133
서대문구,117, 홍은사거리,201909,3093,3093,6186,37.59116,126.94133
서대문구,117, 홍은사거리,201910,3545,3479,7024,37.59116,126.94133
서대문구,117, 홍은사거리,201911,1920,1940,3860,37.59116,126.94133
서대문구,117, 홍은사거리,201912,1006,959,1965,37.59116,126.94133
서대문구,117, 홍은사거리,202001,1026,954,1980,37.59116,126.94133
서대문구,117, 홍은사거리,202002,1031,1008,2039,37.59116,126.94133
서대문구,117, 홍은사거리,202003,2966,2905,5871,37.59116,126.94133
서대문구,117, 홍은사거리,202004,4118,4112,8230,37.59116,126.94133
서대문구,117, 홍은사거리,202005,4509,4514,9023,37.59116,126.94133
서대문구,117, 홍은사거리,202006,4873,4896,9769,37.59116,126.94133
마포구,118, 광흥창역 2번출구 앞,201901,539,542,1081,37.547733,126.931763
마포구,118, 광흥창역 2번출구 앞,201902,415,465,880,37.547733,126.931763
마포구,118, 광흥창역 2번출구 앞,201903,920,871,1791,37.547733,126.931763
마포구,118, 광흥창역 2번출구 앞,201904,1357,1256,2613,37.547733,126.931763
마포구,118, 광흥창역 2번출구 앞,201905,1925,1767,3692,37.547733,126.931763
마포구,118, 광흥창역 2번출구 앞,201906,1865,1725,3590,37.547733,126.931763
마포구,118, 광흥창역 2번출구 앞,201907,1827,1705,3532,37.547733,126.931763
마포구,118, 광흥창역 2번출구 앞,201908,1747,1712,3459,37.547733,126.931763
마포구,118, 광흥창역 2번출구 앞,201909,1672,1612,3284,37.547733,126.931763
마포구,118, 광흥창역 2번출구 앞,201910,1853,1723,3576,37.547733,126.931763
마포구,118, 광흥창역 2번출구 앞,201911,1192,1148,2340,37.547733,126.931763
마포구,118, 광흥창역 2번출구 앞,201912,701,741,1442,37.547733,126.931763
마포구,118, 광흥창역 2번출구 앞,202001,663,686,1349,37.547733,126.931763
마포구,118, 광흥창역 2번출구 앞,202002,595,656,1251,37.547733,126.931763
마포구,118, 광흥창역 2번출구 앞,202003,1268,1275,2543,37.547733,126.931763
마포구,118, 광흥창역 2번출구 앞,202004,1508,1505,3013,37.547733,126.931763
마포구,118, 광흥창역 2번출구 앞,202005,1587,1603,3190,37.547733,126.931763
마포구,118, 광흥창역 2번출구 앞,202006,1724,1655,3379,37.547733,126.931763
마포구,119, 서강나루 공원,201901,319,438,757,37.545284,126.931053
마포구,119, 서강나루 공원,201902,280,400,680,37.545284,126.931053
마포구,119, 서강나루 공원,201903,682,807,1489,37.545284,126.931053
마포구,119, 서강나루 공원,201904,1206,1397,2603,37.545284,126.931053
마포구,119, 서강나루 공원,201905,1888,1951,3839,37.545284,126.931053
마포구,119, 서강나루 공원,201906,2066,2092,4158,37.545284,126.931053
마포구,119, 서강나루 공원,201907,1632,1683,3315,37.545284,126.931053
마포구,119, 서강나루 공원,201908,1615,1630,3245,37.545284,126.931053
마포구,119, 서강나루 공원,201909,1840,1849,3689,37.545284,126.931053
마포구,119, 서강나루 공원,201910,2014,2154,4168,37.545284,126.931053
마포구,119, 서강나루 공원,201911,1059,1175,2234,37.545284,126.931053
마포구,119, 서강나루 공원,201912,500,583,1083,37.545284,126.931053
마포구,119, 서강나루 공원,202001,511,577,1088,37.545284,126.931053
마포구,119, 서강나루 공원,202002,474,541,1015,37.545284,126.931053
마포구,119, 서강나루 공원,202003,1343,1488,2831,37.545284,126.931053
마포구,119, 서강나루 공원,202004,2062,2093,4155,37.545284,126.931053
마포구,119, 서강나루 공원,202005,2367,2376,4743,37.545284,126.931053
마포구,119, 서강나루 공원,202006,2349,2360,4709,37.545284,126.931053
마포구,120, 신수동 사거리,201901,263,282,545,37.545242,126.934113
마포구,120, 신수동 사거리,201902,177,213,390,37.545242,126.934113
마포구,120, 신수동 사거리,201903,373,373,746,37.545242,126.934113
마포구,120, 신수동 사거리,201904,513,514,1027,37.545242,126.934113
마포구,120, 신수동 사거리,201905,757,759,1516,37.545242,126.934113
마포구,120, 신수동 사거리,201906,804,833,1637,37.545242,126.934113
마포구,120, 신수동 사거리,201907,785,768,1553,37.545242,126.934113
마포구,120, 신수동 사거리,201908,784,784,1568,37.545242,126.934113
마포구,120, 신수동 사거리,201909,690,701,1391,37.545242,126.934113
마포구,120, 신수동 사거리,201910,819,843,1662,37.545242,126.934113
마포구,120, 신수동 사거리,201911,570,580,1150,37.545242,126.934113
마포구,120, 신수동 사거리,201912,315,302,617,37.545242,126.934113
마포구,120, 신수동 사거리,202001,268,266,534,37.545242,126.934113
마포구,120, 신수동 사거리,202002,235,233,468,37.545242,126.934113
마포구,120, 신수동 사거리,202003,426,436,862,37.545242,126.934113
마포구,120, 신수동 사거리,202004,611,621,1232,37.545242,126.934113
마포구,120, 신수동 사거리,202005,656,663,1319,37.545242,126.934113
마포구,120, 신수동 사거리,202006,605,618,1223,37.545242,126.934113
마포구,121, 마포소방서 앞,201901,325,389,714,37.549767,126.933174
마포구,121, 마포소방서 앞,201902,309,334,643,37.549767,126.933174
마포구,121, 마포소방서 앞,201903,582,630,1212,37.549767,126.933174
마포구,121, 마포소방서 앞,201904,734,751,1485,37.549767,126.933174
마포구,121, 마포소방서 앞,201905,1128,967,2095,37.549767,126.933174
마포구,121, 마포소방서 앞,201906,1159,985,2144,37.549767,126.933174
마포구,121, 마포소방서 앞,201907,999,860,1859,37.549767,126.933174
마포구,121, 마포소방서 앞,201908,954,836,1790,37.549767,126.933174
마포구,121, 마포소방서 앞,201909,906,787,1693,37.549767,126.933174
마포구,121, 마포소방서 앞,201910,1270,1122,2392,37.549767,126.933174
마포구,121, 마포소방서 앞,201911,733,835,1568,37.549767,126.933174
마포구,121, 마포소방서 앞,201912,406,429,835,37.549767,126.933174
마포구,121, 마포소방서 앞,202001,340,391,731,37.549767,126.933174
마포구,121, 마포소방서 앞,202002,360,421,781,37.549767,126.933174
마포구,121, 마포소방서 앞,202003,739,738,1477,37.549767,126.933174
마포구,121, 마포소방서 앞,202004,941,877,1818,37.549767,126.933174
마포구,121, 마포소방서 앞,202005,1008,910,1918,37.549767,126.933174
마포구,121, 마포소방서 앞,202006,1217,1087,2304,37.549767,126.933174
마포구,122, 신성기사식당 앞,201901,421,412,833,37.547459,126.938377
마포구,122, 신성기사식당 앞,201902,405,368,773,37.547459,126.938377
마포구,122, 신성기사식당 앞,201903,782,758,1540,37.547459,126.938377
마포구,122, 신성기사식당 앞,201904,1004,1101,2105,37.547459,126.938377
마포구,122, 신성기사식당 앞,201905,1528,1573,3101,37.547459,126.938377
마포구,122, 신성기사식당 앞,201906,1475,1475,2950,37.547459,126.938377
마포구,122, 신성기사식당 앞,201907,1294,1345,2639,37.547459,126.938377
마포구,122, 신성기사식당 앞,201908,1301,1391,2692,37.547459,126.938377
마포구,122, 신성기사식당 앞,201909,1150,1098,2248,37.547459,126.938377
마포구,122, 신성기사식당 앞,201910,1418,1363,2781,37.547459,126.938377
마포구,122, 신성기사식당 앞,201911,951,983,1934,37.547459,126.938377
마포구,122, 신성기사식당 앞,201912,433,476,909,37.547459,126.938377
마포구,122, 신성기사식당 앞,202001,515,490,1005,37.547459,126.938377
마포구,122, 신성기사식당 앞,202002,479,467,946,37.547459,126.938377
마포구,122, 신성기사식당 앞,202003,840,830,1670,37.547459,126.938377
마포구,122, 신성기사식당 앞,202004,1120,1100,2220,37.547459,126.938377
마포구,122, 신성기사식당 앞,202005,1303,1292,2595,37.547459,126.938377
마포구,122, 신성기사식당 앞,202006,1326,1311,2637,37.547459,126.938377
서대문구,123, 문화촌 공원,201901,311,327,638,37.59433,126.947388
서대문구,123, 문화촌 공원,201902,351,307,658,37.59433,126.947388
서대문구,123, 문화촌 공원,201903,736,750,1486,37.59433,126.947388
서대문구,123, 문화촌 공원,201904,1454,1456,2910,37.59433,126.947388
서대문구,123, 문화촌 공원,201905,2079,2122,4201,37.59433,126.947388
서대문구,123, 문화촌 공원,201906,2349,2376,4725,37.59433,126.947388
서대문구,123, 문화촌 공원,201907,2160,2310,4470,37.59433,126.947388
서대문구,123, 문화촌 공원,201908,2056,2164,4220,37.59433,126.947388
서대문구,123, 문화촌 공원,201909,1880,1911,3791,37.59433,126.947388
서대문구,123, 문화촌 공원,201910,2167,2212,4379,37.59433,126.947388
서대문구,123, 문화촌 공원,201911,1327,1375,2702,37.59433,126.947388
서대문구,123, 문화촌 공원,201912,712,716,1428,37.59433,126.947388
서대문구,123, 문화촌 공원,202001,689,655,1344,37.59433,126.947388
서대문구,123, 문화촌 공원,202002,614,570,1184,37.59433,126.947388
서대문구,123, 문화촌 공원,202003,1779,1730,3509,37.59433,126.947388
서대문구,123, 문화촌 공원,202004,2740,2775,5515,37.59433,126.947388
서대문구,123, 문화촌 공원,202005,2720,2731,5451,37.59433,126.947388
서대문구,123, 문화촌 공원,202006,2943,2995,5938,37.59433,126.947388
마포구,124, 서강대 정문 건너편,201901,546,471,1017,37.55114,126.936989
마포구,124, 서강대 정문 건너편,201902,489,410,899,37.55114,126.936989
마포구,124, 서강대 정문 건너편,201903,1121,992,2113,37.55114,126.936989
마포구,124, 서강대 정문 건너편,201904,1581,1339,2920,37.55114,126.936989
마포구,124, 서강대 정문 건너편,201905,2123,1791,3914,37.55114,126.936989
마포구,124, 서강대 정문 건너편,201906,2043,1646,3689,37.55114,126.936989
마포구,124, 서강대 정문 건너편,201907,1845,1430,3275,37.55114,126.936989
마포구,124, 서강대 정문 건너편,201908,1920,1548,3468,37.55114,126.936989
마포구,124, 서강대 정문 건너편,201909,1793,1578,3371,37.55114,126.936989
마포구,124, 서강대 정문 건너편,201910,2060,1767,3827,37.55114,126.936989
마포구,124, 서강대 정문 건너편,201911,1661,1384,3045,37.55114,126.936989
마포구,124, 서강대 정문 건너편,201912,1002,837,1839,37.55114,126.936989
마포구,124, 서강대 정문 건너편,202001,778,604,1382,37.55114,126.936989
마포구,124, 서강대 정문 건너편,202002,690,540,1230,37.55114,126.936989
마포구,124, 서강대 정문 건너편,202003,1148,963,2111,37.55114,126.936989
마포구,124, 서강대 정문 건너편,202004,1621,1434,3055,37.55114,126.936989
마포구,124, 서강대 정문 건너편,202005,1568,1474,3042,37.55114,126.936989
마포구,124, 서강대 정문 건너편,202006,1637,1445,3082,37.55114,126.936989
마포구,125, 서강대 남문 옆,201901,385,427,812,37.549484,126.93895
마포구,125, 서강대 남문 옆,201902,382,352,734,37.549484,126.93895
마포구,125, 서강대 남문 옆,201903,1163,1155,2318,37.549484,126.93895
마포구,125, 서강대 남문 옆,201904,1337,1409,2746,37.549484,126.93895
마포구,125, 서강대 남문 옆,201905,1825,1813,3638,37.549484,126.93895
마포구,125, 서강대 남문 옆,201906,1845,1839,3684,37.549484,126.93895
마포구,125, 서강대 남문 옆,201907,1800,1737,3537,37.549484,126.93895
마포구,125, 서강대 남문 옆,201908,1480,1448,2928,37.549484,126.93895
마포구,125, 서강대 남문 옆,201909,1599,1631,3230,37.549484,126.93895
마포구,125, 서강대 남문 옆,201910,1814,1814,3628,37.549484,126.93895
마포구,125, 서강대 남문 옆,201911,1211,1271,2482,37.549484,126.93895
마포구,125, 서강대 남문 옆,201912,643,696,1339,37.549484,126.93895
마포구,125, 서강대 남문 옆,202001,496,537,1033,37.549484,126.93895
마포구,125, 서강대 남문 옆,202002,384,385,769,37.549484,126.93895
마포구,125, 서강대 남문 옆,202003,545,492,1037,37.549484,126.93895
마포구,125, 서강대 남문 옆,202004,590,535,1125,37.549484,126.93895
마포구,125, 서강대 남문 옆,202005,540,528,1068,37.549484,126.93895
마포구,125, 서강대 남문 옆,202006,617,597,1214,37.549484,126.93895
마포구,126, 서강대 후문 옆,201901,703,935,1638,37.550411,126.943848
마포구,126, 서강대 후문 옆,201902,564,727,1291,37.550411,126.943848
마포구,126, 서강대 후문 옆,201903,1618,1906,3524,37.550411,126.943848
마포구,126, 서강대 후문 옆,201904,2192,2356,4548,37.550411,126.943848
마포구,126, 서강대 후문 옆,201905,2721,2709,5430,37.550411,126.943848
마포구,126, 서강대 후문 옆,201906,2806,2831,5637,37.550411,126.943848
마포구,126, 서강대 후문 옆,201907,2580,2608,5188,37.550411,126.943848
마포구,126, 서강대 후문 옆,201908,2393,2432,4825,37.550411,126.943848
마포구,126, 서강대 후문 옆,201909,2415,2413,4828,37.550411,126.943848
마포구,126, 서강대 후문 옆,201910,2712,2646,5358,37.550411,126.943848
마포구,126, 서강대 후문 옆,201911,2124,2180,4304,37.550411,126.943848
마포구,126, 서강대 후문 옆,201912,1223,1277,2500,37.550411,126.943848
마포구,126, 서강대 후문 옆,202001,972,963,1935,37.550411,126.943848
마포구,126, 서강대 후문 옆,202002,770,715,1485,37.550411,126.943848
마포구,126, 서강대 후문 옆,202003,1044,994,2038,37.550411,126.943848
마포구,126, 서강대 후문 옆,202004,1424,1358,2782,37.550411,126.943848
마포구,126, 서강대 후문 옆,202005,1472,1465,2937,37.550411,126.943848
마포구,126, 서강대 후문 옆,202006,1569,1519,3088,37.550411,126.943848
마포구,127, 현대벤처빌 앞,201901,273,134,407,37.55352,126.936951
마포구,127, 현대벤처빌 앞,201902,251,99,350,37.55352,126.936951
마포구,127, 현대벤처빌 앞,201903,566,273,839,37.55352,126.936951
마포구,127, 현대벤처빌 앞,201904,656,355,1011,37.55352,126.936951
마포구,127, 현대벤처빌 앞,201905,679,480,1159,37.55352,126.936951
마포구,127, 현대벤처빌 앞,201906,772,556,1328,37.55352,126.936951
마포구,127, 현대벤처빌 앞,201907,654,459,1113,37.55352,126.936951
마포구,127, 현대벤처빌 앞,201908,614,440,1054,37.55352,126.936951
마포구,127, 현대벤처빌 앞,201909,474,393,867,37.55352,126.936951
마포구,127, 현대벤처빌 앞,201910,534,411,945,37.55352,126.936951
마포구,127, 현대벤처빌 앞,201911,559,315,874,37.55352,126.936951
마포구,127, 현대벤처빌 앞,201912,315,165,480,37.55352,126.936951
마포구,127, 현대벤처빌 앞,202001,271,118,389,37.55352,126.936951
마포구,127, 현대벤처빌 앞,202002,255,136,391,37.55352,126.936951
마포구,127, 현대벤처빌 앞,202003,287,188,475,37.55352,126.936951
마포구,127, 현대벤처빌 앞,202004,322,269,591,37.55352,126.936951
마포구,127, 현대벤처빌 앞,202005,291,280,571,37.55352,126.936951
마포구,127, 현대벤처빌 앞,202006,492,433,925,37.55352,126.936951
서대문구,128, 신촌역(2호선) 1번출구 옆,201901,885,1018,1903,37.555496,126.93634
서대문구,128, 신촌역(2호선) 1번출구 옆,201902,764,856,1620,37.555496,126.93634
서대문구,128, 신촌역(2호선) 1번출구 옆,201903,1426,1428,2854,37.555496,126.93634
서대문구,128, 신촌역(2호선) 1번출구 옆,201904,1892,1884,3776,37.555496,126.93634
서대문구,128, 신촌역(2호선) 1번출구 옆,201905,2724,2706,5430,37.555496,126.93634
서대문구,128, 신촌역(2호선) 1번출구 옆,201906,2920,2899,5819,37.555496,126.93634
서대문구,128, 신촌역(2호선) 1번출구 옆,201907,2753,2731,5484,37.555496,126.93634
서대문구,128, 신촌역(2호선) 1번출구 옆,201908,2603,2566,5169,37.555496,126.93634
서대문구,128, 신촌역(2호선) 1번출구 옆,201909,2265,2264,4529,37.555496,126.93634
서대문구,128, 신촌역(2호선) 1번출구 옆,201910,2836,2840,5676,37.555496,126.93634
서대문구,128, 신촌역(2호선) 1번출구 옆,201911,2101,2087,4188,37.555496,126.93634
서대문구,128, 신촌역(2호선) 1번출구 옆,201912,1200,1208,2408,37.555496,126.93634
서대문구,128, 신촌역(2호선) 1번출구 옆,202001,1036,1108,2144,37.555496,126.93634
서대문구,128, 신촌역(2호선) 1번출구 옆,202002,927,914,1841,37.555496,126.93634
서대문구,128, 신촌역(2호선) 1번출구 옆,202003,1437,1436,2873,37.555496,126.93634
서대문구,128, 신촌역(2호선) 1번출구 옆,202004,1824,1797,3621,37.555496,126.93634
서대문구,128, 신촌역(2호선) 1번출구 옆,202005,1953,1940,3893,37.555496,126.93634
서대문구,128, 신촌역(2호선) 1번출구 옆,202006,2087,2064,4151,37.555496,126.93634
마포구,129, 신촌역(2호선) 6번출구 옆,201901,484,560,1044,37.555054,126.937569
마포구,129, 신촌역(2호선) 6번출구 옆,201902,420,462,882,37.555054,126.937569
마포구,129, 신촌역(2호선) 6번출구 옆,201903,875,885,1760,37.555054,126.937569
마포구,129, 신촌역(2호선) 6번출구 옆,201904,1165,1242,2407,37.555054,126.937569
마포구,129, 신촌역(2호선) 6번출구 옆,201905,1767,1714,3481,37.555054,126.937569
마포구,129, 신촌역(2호선) 6번출구 옆,201906,1688,1683,3371,37.555054,126.937569
마포구,129, 신촌역(2호선) 6번출구 옆,201907,1595,1610,3205,37.555054,126.937569
마포구,129, 신촌역(2호선) 6번출구 옆,201908,1490,1514,3004,37.555054,126.937569
마포구,129, 신촌역(2호선) 6번출구 옆,201909,1595,1602,3197,37.555054,126.937569
마포구,129, 신촌역(2호선) 6번출구 옆,201910,1817,1818,3635,37.555054,126.937569
마포구,129, 신촌역(2호선) 6번출구 옆,201911,1205,1222,2427,37.555054,126.937569
마포구,129, 신촌역(2호선) 6번출구 옆,201912,717,730,1447,37.555054,126.937569
마포구,129, 신촌역(2호선) 6번출구 옆,202001,628,673,1301,37.555054,126.937569
마포구,129, 신촌역(2호선) 6번출구 옆,202002,505,528,1033,37.555054,126.937569
마포구,129, 신촌역(2호선) 6번출구 옆,202003,933,935,1868,37.555054,126.937569
마포구,129, 신촌역(2호선) 6번출구 옆,202004,1221,1213,2434,37.555054,126.937569
마포구,129, 신촌역(2호선) 6번출구 옆,202005,1144,1144,2288,37.555054,126.937569
마포구,129, 신촌역(2호선) 6번출구 옆,202006,1336,1323,2659,37.555054,126.937569
마포구,130, 신촌역(2호선) 7번출구 앞,201901,558,592,1150,37.554859,126.936157
마포구,130, 신촌역(2호선) 7번출구 앞,201902,426,468,894,37.554859,126.936157
마포구,130, 신촌역(2호선) 7번출구 앞,201903,1055,1139,2194,37.554859,126.936157
마포구,130, 신촌역(2호선) 7번출구 앞,201904,1633,1682,3315,37.554859,126.936157
마포구,130, 신촌역(2호선) 7번출구 앞,201905,2619,2653,5272,37.554859,126.936157
마포구,130, 신촌역(2호선) 7번출구 앞,201906,2623,2623,5246,37.554859,126.936157
마포구,130, 신촌역(2호선) 7번출구 앞,201907,2306,2321,4627,37.554859,126.936157
마포구,130, 신촌역(2호선) 7번출구 앞,201908,2129,2115,4244,37.554859,126.936157
마포구,130, 신촌역(2호선) 7번출구 앞,201909,2172,2171,4343,37.554859,126.936157
마포구,130, 신촌역(2호선) 7번출구 앞,201910,2568,2597,5165,37.554859,126.936157
마포구,130, 신촌역(2호선) 7번출구 앞,201911,1786,1801,3587,37.554859,126.936157
마포구,130, 신촌역(2호선) 7번출구 앞,201912,933,986,1919,37.554859,126.936157
마포구,130, 신촌역(2호선) 7번출구 앞,202001,828,922,1750,37.554859,126.936157
마포구,130, 신촌역(2호선) 7번출구 앞,202002,776,783,1559,37.554859,126.936157
마포구,130, 신촌역(2호선) 7번출구 앞,202003,1537,1537,3074,37.554859,126.936157
마포구,130, 신촌역(2호선) 7번출구 앞,202004,2280,2281,4561,37.554859,126.936157
마포구,130, 신촌역(2호선) 7번출구 앞,202005,2432,2435,4867,37.554859,126.936157
마포구,130, 신촌역(2호선) 7번출구 앞,202006,2223,2213,4436,37.554859,126.936157
서대문구,131, 증산2교,201901,481,533,1014,37.584171,126.911102
서대문구,131, 증산2교,201902,501,524,1025,37.584171,126.911102
서대문구,131, 증산2교,201903,953,1049,2002,37.584171,126.911102
서대문구,131, 증산2교,201904,1521,1612,3133,37.584171,126.911102
서대문구,131, 증산2교,201905,2450,2600,5050,37.584171,126.911102
서대문구,131, 증산2교,201906,2650,2923,5573,37.584171,126.911102
서대문구,131, 증산2교,201907,2398,2695,5093,37.584171,126.911102
서대문구,131, 증산2교,201908,2377,2693,5070,37.584171,126.911102
서대문구,131, 증산2교,201909,2308,2471,4779,37.584171,126.911102
서대문구,131, 증산2교,201910,2524,2713,5237,37.584171,126.911102
서대문구,131, 증산2교,201911,1513,1626,3139,37.584171,126.911102
서대문구,131, 증산2교,201912,881,929,1810,37.584171,126.911102
서대문구,131, 증산2교,202001,786,777,1563,37.584171,126.911102
서대문구,131, 증산2교,202002,881,891,1772,37.584171,126.911102
서대문구,131, 증산2교,202003,2261,2328,4589,37.584171,126.911102
서대문구,131, 증산2교,202004,3121,3201,6322,37.584171,126.911102
서대문구,131, 증산2교,202005,3349,3369,6718,37.584171,126.911102
서대문구,131, 증산2교,202006,3515,3699,7214,37.584171,126.911102
서대문구,133, 해담는다리,201901,371,365,736,37.582031,126.908997
서대문구,133, 해담는다리,201902,352,371,723,37.582031,126.908997
서대문구,133, 해담는다리,201903,817,885,1702,37.582031,126.908997
서대문구,133, 해담는다리,201904,1334,1437,2771,37.582031,126.908997
서대문구,133, 해담는다리,201905,1822,2054,3876,37.582031,126.908997
서대문구,133, 해담는다리,201906,2029,2285,4314,37.582031,126.908997
서대문구,133, 해담는다리,201907,2041,2230,4271,37.582031,126.908997
서대문구,133, 해담는다리,201908,2148,2427,4575,37.582031,126.908997
서대문구,133, 해담는다리,201909,2196,2443,4639,37.582031,126.908997
서대문구,133, 해담는다리,201910,2550,2628,5178,37.582031,126.908997
서대문구,133, 해담는다리,201911,1499,1568,3067,37.582031,126.908997
서대문구,133, 해담는다리,201912,871,936,1807,37.582031,126.908997
서대문구,133, 해담는다리,202001,894,951,1845,37.582031,126.908997
서대문구,133, 해담는다리,202002,862,886,1748,37.582031,126.908997
서대문구,133, 해담는다리,202003,1863,1933,3796,37.582031,126.908997
서대문구,133, 해담는다리,202004,2374,2427,4801,37.582031,126.908997
서대문구,133, 해담는다리,202005,2602,2671,5273,37.582031,126.908997
서대문구,133, 해담는다리,202006,2714,2927,5641,37.582031,126.908997
서대문구,134, 연세로 명물길,201901,371,463,834,37.557892,126.93808
서대문구,134, 연세로 명물길,201902,364,422,786,37.557892,126.93808
서대문구,134, 연세로 명물길,201903,595,721,1316,37.557892,126.93808
서대문구,134, 연세로 명물길,201904,782,840,1622,37.557892,126.93808
서대문구,134, 연세로 명물길,201905,1269,1263,2532,37.557892,126.93808
서대문구,134, 연세로 명물길,201906,1311,1304,2615,37.557892,126.93808
서대문구,134, 연세로 명물길,201907,1212,1227,2439,37.557892,126.93808
서대문구,134, 연세로 명물길,201908,1150,1187,2337,37.557892,126.93808
서대문구,134, 연세로 명물길,201909,928,934,1862,37.557892,126.93808
서대문구,134, 연세로 명물길,201910,1215,1242,2457,37.557892,126.93808
서대문구,134, 연세로 명물길,201911,828,847,1675,37.557892,126.93808
서대문구,134, 연세로 명물길,201912,477,586,1063,37.557892,126.93808
서대문구,134, 연세로 명물길,202001,486,617,1103,37.557892,126.93808
서대문구,134, 연세로 명물길,202002,474,538,1012,37.557892,126.93808
서대문구,134, 연세로 명물길,202003,757,816,1573,37.557892,126.93808
서대문구,134, 연세로 명물길,202004,1017,1020,2037,37.557892,126.93808
서대문구,134, 연세로 명물길,202005,1058,1055,2113,37.557892,126.93808
서대문구,134, 연세로 명물길,202006,1290,1276,2566,37.557892,126.93808
서대문구,135, 명물길 원형무대 앞,201901,198,292,490,37.559101,126.939178
서대문구,135, 명물길 원형무대 앞,201902,170,305,475,37.559101,126.939178
서대문구,135, 명물길 원형무대 앞,201903,434,563,997,37.559101,126.939178
서대문구,135, 명물길 원형무대 앞,201904,723,753,1476,37.559101,126.939178
서대문구,135, 명물길 원형무대 앞,201905,1141,1138,2279,37.559101,126.939178
서대문구,135, 명물길 원형무대 앞,201906,1138,1153,2291,37.559101,126.939178
서대문구,135, 명물길 원형무대 앞,201907,1048,1047,2095,37.559101,126.939178
서대문구,135, 명물길 원형무대 앞,201908,996,993,1989,37.559101,126.939178
서대문구,135, 명물길 원형무대 앞,201909,819,811,1630,37.559101,126.939178
서대문구,135, 명물길 원형무대 앞,201910,945,947,1892,37.559101,126.939178
서대문구,135, 명물길 원형무대 앞,201911,669,755,1424,37.559101,126.939178
서대문구,135, 명물길 원형무대 앞,201912,417,479,896,37.559101,126.939178
서대문구,135, 명물길 원형무대 앞,202001,345,427,772,37.559101,126.939178
서대문구,135, 명물길 원형무대 앞,202002,329,396,725,37.559101,126.939178
서대문구,135, 명물길 원형무대 앞,202003,472,495,967,37.559101,126.939178
서대문구,135, 명물길 원형무대 앞,202004,734,740,1474,37.559101,126.939178
서대문구,135, 명물길 원형무대 앞,202005,808,797,1605,37.559101,126.939178
서대문구,135, 명물길 원형무대 앞,202006,937,928,1865,37.559101,126.939178
마포구,136, 대흥동 주민센터,201901,199,67,266,37.556004,126.942299
마포구,136, 대흥동 주민센터,201902,173,67,240,37.556004,126.942299
마포구,136, 대흥동 주민센터,201903,262,89,351,37.556004,126.942299
마포구,136, 대흥동 주민센터,201904,365,99,464,37.556004,126.942299
마포구,136, 대흥동 주민센터,201905,469,152,621,37.556004,126.942299
마포구,136, 대흥동 주민센터,201906,456,149,605,37.556004,126.942299
마포구,136, 대흥동 주민센터,201907,445,147,592,37.556004,126.942299
마포구,136, 대흥동 주민센터,201908,426,140,566,37.556004,126.942299
마포구,136, 대흥동 주민센터,201909,320,128,448,37.556004,126.942299
마포구,136, 대흥동 주민센터,201910,392,159,551,37.556004,126.942299
마포구,136, 대흥동 주민센터,201911,308,104,412,37.556004,126.942299
마포구,136, 대흥동 주민센터,201912,187,84,271,37.556004,126.942299
마포구,136, 대흥동 주민센터,202001,153,68,221,37.556004,126.942299
마포구,136, 대흥동 주민센터,202002,152,71,223,37.556004,126.942299
마포구,136, 대흥동 주민센터,202003,280,130,410,37.556004,126.942299
마포구,136, 대흥동 주민센터,202004,305,179,484,37.556004,126.942299
마포구,136, 대흥동 주민센터,202005,275,225,500,37.556004,126.942299
마포구,136, 대흥동 주민센터,202006,297,185,482,37.556004,126.942299
서대문구,137, NH농협 신촌지점 앞,201901,228,84,312,37.556812,126.943184
서대문구,137, NH농협 신촌지점 앞,201902,173,71,244,37.556812,126.943184
서대문구,137, NH농협 신촌지점 앞,201903,394,212,606,37.556812,126.943184
서대문구,137, NH농협 신촌지점 앞,201904,638,367,1005,37.556812,126.943184
서대문구,137, NH농협 신촌지점 앞,201905,756,463,1219,37.556812,126.943184
서대문구,137, NH농협 신촌지점 앞,201906,731,416,1147,37.556812,126.943184
서대문구,137, NH농협 신촌지점 앞,201907,819,420,1239,37.556812,126.943184
서대문구,137, NH농협 신촌지점 앞,201908,661,363,1024,37.556812,126.943184
서대문구,137, NH농협 신촌지점 앞,201909,543,384,927,37.556812,126.943184
서대문구,137, NH농협 신촌지점 앞,201910,645,469,1114,37.556812,126.943184
서대문구,137, NH농협 신촌지점 앞,201911,522,295,817,37.556812,126.943184
서대문구,137, NH농협 신촌지점 앞,201912,257,130,387,37.556812,126.943184
서대문구,137, NH농협 신촌지점 앞,202001,236,112,348,37.556812,126.943184
서대문구,137, NH농협 신촌지점 앞,202002,209,136,345,37.556812,126.943184
서대문구,137, NH농협 신촌지점 앞,202003,335,277,612,37.556812,126.943184
서대문구,137, NH농협 신촌지점 앞,202004,373,332,705,37.556812,126.943184
서대문구,137, NH농협 신촌지점 앞,202005,364,350,714,37.556812,126.943184
서대문구,137, NH농협 신촌지점 앞,202006,422,385,807,37.556812,126.943184
서대문구,138, 신촌동 제1공영주차장 앞,201901,338,313,651,37.559177,126.934525
서대문구,138, 신촌동 제1공영주차장 앞,201902,283,265,548,37.559177,126.934525
서대문구,138, 신촌동 제1공영주차장 앞,201903,570,539,1109,37.559177,126.934525
서대문구,138, 신촌동 제1공영주차장 앞,201904,741,719,1460,37.559177,126.934525
서대문구,138, 신촌동 제1공영주차장 앞,201905,1016,991,2007,37.559177,126.934525
서대문구,138, 신촌동 제1공영주차장 앞,201906,882,873,1755,37.559177,126.934525
서대문구,138, 신촌동 제1공영주차장 앞,201907,918,876,1794,37.559177,126.934525
서대문구,138, 신촌동 제1공영주차장 앞,201908,881,848,1729,37.559177,126.934525
서대문구,138, 신촌동 제1공영주차장 앞,201909,721,709,1430,37.559177,126.934525
서대문구,138, 신촌동 제1공영주차장 앞,201910,822,821,1643,37.559177,126.934525
서대문구,138, 신촌동 제1공영주차장 앞,201911,593,589,1182,37.559177,126.934525
서대문구,138, 신촌동 제1공영주차장 앞,201912,420,406,826,37.559177,126.934525
서대문구,138, 신촌동 제1공영주차장 앞,202001,322,328,650,37.559177,126.934525
서대문구,138, 신촌동 제1공영주차장 앞,202002,258,301,559,37.559177,126.934525
서대문구,138, 신촌동 제1공영주차장 앞,202003,510,511,1021,37.559177,126.934525
서대문구,138, 신촌동 제1공영주차장 앞,202004,658,663,1321,37.559177,126.934525
서대문구,138, 신촌동 제1공영주차장 앞,202005,738,740,1478,37.559177,126.934525
서대문구,138, 신촌동 제1공영주차장 앞,202006,934,898,1832,37.559177,126.934525
서대문구,139, 연세대 정문 건너편,201901,290,103,393,37.559795,126.934479
서대문구,139, 연세대 정문 건너편,201902,234,125,359,37.559795,126.934479
서대문구,139, 연세대 정문 건너편,201903,561,248,809,37.559795,126.934479
서대문구,139, 연세대 정문 건너편,201904,740,346,1086,37.559795,126.934479
서대문구,139, 연세대 정문 건너편,201905,879,455,1334,37.559795,126.934479
서대문구,139, 연세대 정문 건너편,201906,836,427,1263,37.559795,126.934479
서대문구,139, 연세대 정문 건너편,201907,978,479,1457,37.559795,126.934479
서대문구,139, 연세대 정문 건너편,201908,854,400,1254,37.559795,126.934479
서대문구,139, 연세대 정문 건너편,201909,694,427,1121,37.559795,126.934479
서대문구,139, 연세대 정문 건너편,201910,781,404,1185,37.559795,126.934479
서대문구,139, 연세대 정문 건너편,201911,636,279,915,37.559795,126.934479
서대문구,139, 연세대 정문 건너편,201912,395,155,550,37.559795,126.934479
서대문구,139, 연세대 정문 건너편,202001,304,104,408,37.559795,126.934479
서대문구,139, 연세대 정문 건너편,202002,282,114,396,37.559795,126.934479
서대문구,139, 연세대 정문 건너편,202003,498,209,707,37.559795,126.934479
서대문구,139, 연세대 정문 건너편,202004,436,359,795,37.559795,126.934479
서대문구,139, 연세대 정문 건너편,202005,385,298,683,37.559795,126.934479
서대문구,139, 연세대 정문 건너편,202006,427,283,710,37.559795,126.934479
서대문구,140, 이화여대 후문,201901,212,297,509,37.560009,126.940735
서대문구,140, 이화여대 후문,201902,185,223,408,37.560009,126.940735
서대문구,140, 이화여대 후문,201903,560,553,1113,37.560009,126.940735
서대문구,140, 이화여대 후문,201904,701,749,1450,37.560009,126.940735
서대문구,140, 이화여대 후문,201905,1028,1084,2112,37.560009,126.940735
서대문구,140, 이화여대 후문,201906,1160,1179,2339,37.560009,126.940735
서대문구,140, 이화여대 후문,201907,1068,1067,2135,37.560009,126.940735
서대문구,140, 이화여대 후문,201908,919,931,1850,37.560009,126.940735
서대문구,140, 이화여대 후문,201909,917,923,1840,37.560009,126.940735
서대문구,140, 이화여대 후문,201910,1093,1116,2209,37.560009,126.940735
서대문구,140, 이화여대 후문,201911,842,954,1796,37.560009,126.940735
서대문구,140, 이화여대 후문,201912,404,482,886,37.560009,126.940735
서대문구,140, 이화여대 후문,202001,298,380,678,37.560009,126.940735
서대문구,140, 이화여대 후문,202002,319,332,651,37.560009,126.940735
서대문구,140, 이화여대 후문,202003,472,482,954,37.560009,126.940735
서대문구,140, 이화여대 후문,202004,699,679,1378,37.560009,126.940735
서대문구,140, 이화여대 후문,202005,726,695,1421,37.560009,126.940735
서대문구,140, 이화여대 후문,202006,848,856,1704,37.560009,126.940735
서대문구,141, 연대 대운동장 옆,201901,321,235,556,37.562382,126.932648
서대문구,141, 연대 대운동장 옆,201902,287,171,458,37.562382,126.932648
서대문구,141, 연대 대운동장 옆,201903,615,486,1101,37.562382,126.932648
서대문구,141, 연대 대운동장 옆,201904,910,656,1566,37.562382,126.932648
서대문구,141, 연대 대운동장 옆,201905,1314,902,2216,37.562382,126.932648
서대문구,141, 연대 대운동장 옆,201906,1140,763,1903,37.562382,126.932648
서대문구,141, 연대 대운동장 옆,201907,1080,602,1682,37.562382,126.932648
서대문구,141, 연대 대운동장 옆,201908,1084,650,1734,37.562382,126.932648
서대문구,141, 연대 대운동장 옆,201909,1020,659,1679,37.562382,126.932648
서대문구,141, 연대 대운동장 옆,201910,1239,776,2015,37.562382,126.932648
서대문구,141, 연대 대운동장 옆,201911,845,508,1353,37.562382,126.932648
서대문구,141, 연대 대운동장 옆,201912,438,275,713,37.562382,126.932648
서대문구,141, 연대 대운동장 옆,202001,337,197,534,37.562382,126.932648
서대문구,141, 연대 대운동장 옆,202002,361,237,598,37.562382,126.932648
서대문구,141, 연대 대운동장 옆,202003,742,512,1254,37.562382,126.932648
서대문구,141, 연대 대운동장 옆,202004,669,508,1177,37.562382,126.932648
서대문구,141, 연대 대운동장 옆,202005,532,424,956,37.562382,126.932648
서대문구,141, 연대 대운동장 옆,202006,753,496,1249,37.562382,126.932648
마포구,142, 아현역 4번출구 앞,201901,211,153,364,37.557201,126.955666
마포구,142, 아현역 4번출구 앞,201902,241,175,416,37.557201,126.955666
마포구,142, 아현역 4번출구 앞,201903,433,326,759,37.557201,126.955666
마포구,142, 아현역 4번출구 앞,201904,561,490,1051,37.557201,126.955666
마포구,142, 아현역 4번출구 앞,201905,808,785,1593,37.557201,126.955666
마포구,142, 아현역 4번출구 앞,201906,773,753,1526,37.557201,126.955666
마포구,142, 아현역 4번출구 앞,201907,775,747,1522,37.557201,126.955666
마포구,142, 아현역 4번출구 앞,201908,754,740,1494,37.557201,126.955666
마포구,142, 아현역 4번출구 앞,201909,680,657,1337,37.557201,126.955666
마포구,142, 아현역 4번출구 앞,201910,789,779,1568,37.557201,126.955666
마포구,142, 아현역 4번출구 앞,201911,594,503,1097,37.557201,126.955666
마포구,142, 아현역 4번출구 앞,201912,401,309,710,37.557201,126.955666
마포구,142, 아현역 4번출구 앞,202001,354,286,640,37.557201,126.955666
마포구,142, 아현역 4번출구 앞,202002,268,217,485,37.557201,126.955666
마포구,142, 아현역 4번출구 앞,202003,492,454,946,37.557201,126.955666
마포구,142, 아현역 4번출구 앞,202004,614,614,1228,37.557201,126.955666
마포구,142, 아현역 4번출구 앞,202005,669,668,1337,37.557201,126.955666
마포구,142, 아현역 4번출구 앞,202006,602,591,1193,37.557201,126.955666
마포구,143, 공덕역 2번출구,201901,383,405,788,37.544579,126.950218
마포구,143, 공덕역 2번출구,201902,295,366,661,37.544579,126.950218
마포구,143, 공덕역 2번출구,201903,648,669,1317,37.544579,126.950218
마포구,143, 공덕역 2번출구,201904,1102,1162,2264,37.544579,126.950218
마포구,143, 공덕역 2번출구,201905,1635,1640,3275,37.544579,126.950218
마포구,143, 공덕역 2번출구,201906,1749,1763,3512,37.544579,126.950218
마포구,143, 공덕역 2번출구,201907,1744,1817,3561,37.544579,126.950218
마포구,143, 공덕역 2번출구,201908,1432,1460,2892,37.544579,126.950218
마포구,143, 공덕역 2번출구,201909,1438,1437,2875,37.544579,126.950218
마포구,143, 공덕역 2번출구,201910,2068,2154,4222,37.544579,126.950218
마포구,143, 공덕역 2번출구,201911,1035,1108,2143,37.544579,126.950218
마포구,143, 공덕역 2번출구,201912,530,579,1109,37.544579,126.950218
마포구,143, 공덕역 2번출구,202001,513,550,1063,37.544579,126.950218
마포구,143, 공덕역 2번출구,202002,466,519,985,37.544579,126.950218
마포구,143, 공덕역 2번출구,202003,941,963,1904,37.544579,126.950218
마포구,143, 공덕역 2번출구,202004,1317,1322,2639,37.544579,126.950218
마포구,143, 공덕역 2번출구,202005,1478,1491,2969,37.544579,126.950218
마포구,143, 공덕역 2번출구,202006,1667,1687,3354,37.544579,126.950218
마포구,144, 공덕역 8번출구,201901,725,825,1550,37.543579,126.951324
마포구,144, 공덕역 8번출구,201902,713,827,1540,37.543579,126.951324
마포구,144, 공덕역 8번출구,201903,1476,1693,3169,37.543579,126.951324
마포구,144, 공덕역 8번출구,201904,2501,2730,5231,37.543579,126.951324
마포구,144, 공덕역 8번출구,201905,4051,4325,8376,37.543579,126.951324
마포구,144, 공덕역 8번출구,201906,4134,4479,8613,37.543579,126.951324
마포구,144, 공덕역 8번출구,201907,3169,3573,6742,37.543579,126.951324
마포구,144, 공덕역 8번출구,201908,3486,3841,7327,37.543579,126.951324
마포구,144, 공덕역 8번출구,201909,3701,3860,7561,37.543579,126.951324
마포구,144, 공덕역 8번출구,201910,2869,3271,6140,37.543579,126.951324
마포구,144, 공덕역 8번출구,201911,2238,2567,4805,37.543579,126.951324
마포구,144, 공덕역 8번출구,201912,1151,1394,2545,37.543579,126.951324
마포구,144, 공덕역 8번출구,202001,1157,1346,2503,37.543579,126.951324
마포구,144, 공덕역 8번출구,202002,1131,1294,2425,37.543579,126.951324
마포구,144, 공덕역 8번출구,202003,2856,3109,5965,37.543579,126.951324
마포구,144, 공덕역 8번출구,202004,4154,4348,8502,37.543579,126.951324
마포구,144, 공덕역 8번출구,202005,4626,4760,9386,37.543579,126.951324
마포구,144, 공덕역 8번출구,202006,4003,4109,8112,37.543579,126.951324
마포구,145, 공덕역 5번출구,201901,411,478,889,37.54425,126.951637
마포구,145, 공덕역 5번출구,201902,379,426,805,37.54425,126.951637
마포구,145, 공덕역 5번출구,201903,681,726,1407,37.54425,126.951637
마포구,145, 공덕역 5번출구,201904,949,975,1924,37.54425,126.951637
마포구,145, 공덕역 5번출구,201905,1345,1331,2676,37.54425,126.951637
마포구,145, 공덕역 5번출구,201906,1539,1560,3099,37.54425,126.951637
마포구,145, 공덕역 5번출구,201907,1506,1581,3087,37.54425,126.951637
마포구,145, 공덕역 5번출구,201908,1423,1452,2875,37.54425,126.951637
마포구,145, 공덕역 5번출구,201909,1377,1382,2759,37.54425,126.951637
마포구,145, 공덕역 5번출구,201910,1900,1958,3858,37.54425,126.951637
마포구,145, 공덕역 5번출구,201911,1043,1206,2249,37.54425,126.951637
마포구,145, 공덕역 5번출구,201912,614,765,1379,37.54425,126.951637
마포구,145, 공덕역 5번출구,202001,513,668,1181,37.54425,126.951637
마포구,145, 공덕역 5번출구,202002,493,617,1110,37.54425,126.951637
마포구,145, 공덕역 5번출구,202003,944,1029,1973,37.54425,126.951637
마포구,145, 공덕역 5번출구,202004,1331,1332,2663,37.54425,126.951637
마포구,145, 공덕역 5번출구,202005,1227,1224,2451,37.54425,126.951637
마포구,145, 공덕역 5번출구,202006,1644,1636,3280,37.54425,126.951637
마포구,146, 마포역 2번출구 뒤,201901,456,522,978,37.539936,126.945824
마포구,146, 마포역 2번출구 뒤,201902,462,546,1008,37.539936,126.945824
마포구,146, 마포역 2번출구 뒤,201903,1009,1159,2168,37.539936,126.945824
마포구,146, 마포역 2번출구 뒤,201904,1912,2002,3914,37.539936,126.945824
마포구,146, 마포역 2번출구 뒤,201905,3112,3142,6254,37.539936,126.945824
마포구,146, 마포역 2번출구 뒤,201906,3135,3187,6322,37.539936,126.945824
마포구,146, 마포역 2번출구 뒤,201907,2916,3071,5987,37.539936,126.945824
마포구,146, 마포역 2번출구 뒤,201908,2671,2888,5559,37.539936,126.945824
마포구,146, 마포역 2번출구 뒤,201909,2819,2896,5715,37.539936,126.945824
마포구,146, 마포역 2번출구 뒤,201910,3371,3502,6873,37.539936,126.945824
마포구,146, 마포역 2번출구 뒤,201911,1832,2064,3896,37.539936,126.945824
마포구,146, 마포역 2번출구 뒤,201912,909,1097,2006,37.539936,126.945824
마포구,146, 마포역 2번출구 뒤,202001,772,991,1763,37.539936,126.945824
마포구,146, 마포역 2번출구 뒤,202002,840,1053,1893,37.539936,126.945824
마포구,146, 마포역 2번출구 뒤,202003,2261,2406,4667,37.539936,126.945824
마포구,146, 마포역 2번출구 뒤,202004,3158,3243,6401,37.539936,126.945824
마포구,146, 마포역 2번출구 뒤,202005,3980,4063,8043,37.539936,126.945824
마포구,146, 마포역 2번출구 뒤,202006,3683,3768,7451,37.539936,126.945824
마포구,147, 마포역 4번출구 뒤,201901,365,503,868,37.539272,126.945915
마포구,147, 마포역 4번출구 뒤,201902,389,509,898,37.539272,126.945915
마포구,147, 마포역 4번출구 뒤,201903,866,1051,1917,37.539272,126.945915
마포구,147, 마포역 4번출구 뒤,201904,1616,1814,3430,37.539272,126.945915
마포구,147, 마포역 4번출구 뒤,201905,2724,2889,5613,37.539272,126.945915
마포구,147, 마포역 4번출구 뒤,201906,2623,2776,5399,37.539272,126.945915
마포구,147, 마포역 4번출구 뒤,201907,2515,2610,5125,37.539272,126.945915
마포구,147, 마포역 4번출구 뒤,201908,2579,2728,5307,37.539272,126.945915
마포구,147, 마포역 4번출구 뒤,201909,2797,2931,5728,37.539272,126.945915
마포구,147, 마포역 4번출구 뒤,201910,3045,3235,6280,37.539272,126.945915
마포구,147, 마포역 4번출구 뒤,201911,1629,1848,3477,37.539272,126.945915
마포구,147, 마포역 4번출구 뒤,201912,868,1024,1892,37.539272,126.945915
마포구,147, 마포역 4번출구 뒤,202001,744,871,1615,37.539272,126.945915
마포구,147, 마포역 4번출구 뒤,202002,730,814,1544,37.539272,126.945915
마포구,147, 마포역 4번출구 뒤,202003,1947,2093,4040,37.539272,126.945915
마포구,147, 마포역 4번출구 뒤,202004,2831,2963,5794,37.539272,126.945915
마포구,147, 마포역 4번출구 뒤,202005,3435,3492,6927,37.539272,126.945915
마포구,147, 마포역 4번출구 뒤,202006,3299,3362,6661,37.539272,126.945915
마포구,148, 용강동 주민센터 앞,201901,359,485,844,37.542347,126.943024
마포구,148, 용강동 주민센터 앞,201902,352,446,798,37.542347,126.943024
마포구,148, 용강동 주민센터 앞,201903,729,946,1675,37.542347,126.943024
마포구,148, 용강동 주민센터 앞,201904,1230,1437,2667,37.542347,126.943024
마포구,148, 용강동 주민센터 앞,201905,1893,2080,3973,37.542347,126.943024
마포구,148, 용강동 주민센터 앞,201906,2076,2261,4337,37.542347,126.943024
마포구,148, 용강동 주민센터 앞,201907,1734,1992,3726,37.542347,126.943024
마포구,148, 용강동 주민센터 앞,201908,1741,1831,3572,37.542347,126.943024
마포구,148, 용강동 주민센터 앞,201909,1782,1883,3665,37.542347,126.943024
마포구,148, 용강동 주민센터 앞,201910,1962,2031,3993,37.542347,126.943024
마포구,148, 용강동 주민센터 앞,201911,1198,1283,2481,37.542347,126.943024
마포구,148, 용강동 주민센터 앞,201912,664,777,1441,37.542347,126.943024
마포구,148, 용강동 주민센터 앞,202001,647,714,1361,37.542347,126.943024
마포구,148, 용강동 주민센터 앞,202002,748,812,1560,37.542347,126.943024
마포구,148, 용강동 주민센터 앞,202003,1644,1797,3441,37.542347,126.943024
마포구,148, 용강동 주민센터 앞,202004,2672,2814,5486,37.542347,126.943024
마포구,148, 용강동 주민센터 앞,202005,2935,2980,5915,37.542347,126.943024
마포구,148, 용강동 주민센터 앞,202006,2708,2745,5453,37.542347,126.943024
마포구,150, 서강대역 2번출구 앞,201901,402,448,850,37.552956,126.934341
마포구,150, 서강대역 2번출구 앞,201902,336,407,743,37.552956,126.934341
마포구,150, 서강대역 2번출구 앞,201903,703,821,1524,37.552956,126.934341
마포구,150, 서강대역 2번출구 앞,201904,1141,1155,2296,37.552956,126.934341
마포구,150, 서강대역 2번출구 앞,201905,1849,1730,3579,37.552956,126.934341
마포구,150, 서강대역 2번출구 앞,201906,2012,2004,4016,37.552956,126.934341
마포구,150, 서강대역 2번출구 앞,201907,1799,1758,3557,37.552956,126.934341
마포구,150, 서강대역 2번출구 앞,201908,1666,1646,3312,37.552956,126.934341
마포구,150, 서강대역 2번출구 앞,201909,1720,1704,3424,37.552956,126.934341
마포구,150, 서강대역 2번출구 앞,201910,1986,1954,3940,37.552956,126.934341
마포구,150, 서강대역 2번출구 앞,201911,1345,1506,2851,37.552956,126.934341
마포구,150, 서강대역 2번출구 앞,201912,717,830,1547,37.552956,126.934341
마포구,150, 서강대역 2번출구 앞,202001,643,808,1451,37.552956,126.934341
마포구,150, 서강대역 2번출구 앞,202002,651,807,1458,37.552956,126.934341
마포구,150, 서강대역 2번출구 앞,202003,1397,1472,2869,37.552956,126.934341
마포구,150, 서강대역 2번출구 앞,202004,1879,1879,3758,37.552956,126.934341
마포구,150, 서강대역 2번출구 앞,202005,1780,1776,3556,37.552956,126.934341
마포구,150, 서강대역 2번출구 앞,202006,1530,1512,3042,37.552956,126.934341
마포구,151, 망원1동주민센터,201901,477,586,1063,37.555687,126.905548
마포구,151, 망원1동주민센터,201902,486,613,1099,37.555687,126.905548
마포구,151, 망원1동주민센터,201903,952,1189,2141,37.555687,126.905548
마포구,151, 망원1동주민센터,201904,1453,1731,3184,37.555687,126.905548
마포구,151, 망원1동주민센터,201905,2505,2761,5266,37.555687,126.905548
마포구,151, 망원1동주민센터,201906,2742,2902,5644,37.555687,126.905548
마포구,151, 망원1동주민센터,201907,2290,2508,4798,37.555687,126.905548
마포구,151, 망원1동주민센터,201908,2433,2694,5127,37.555687,126.905548
마포구,151, 망원1동주민센터,201909,2494,2550,5044,37.555687,126.905548
마포구,151, 망원1동주민센터,201910,2742,3004,5746,37.555687,126.905548
마포구,151, 망원1동주민센터,201911,1561,1880,3441,37.555687,126.905548
마포구,151, 망원1동주민센터,201912,928,1158,2086,37.555687,126.905548
마포구,151, 망원1동주민센터,202001,952,1191,2143,37.555687,126.905548
마포구,151, 망원1동주민센터,202002,903,1064,1967,37.555687,126.905548
마포구,151, 망원1동주민센터,202003,1989,2211,4200,37.555687,126.905548
마포구,151, 망원1동주민센터,202004,2683,2796,5479,37.555687,126.905548
마포구,151, 망원1동주민센터,202005,3106,3162,6268,37.555687,126.905548
마포구,151, 망원1동주민센터,202006,3145,3183,6328,37.555687,126.905548
마포구,152, 마포구민체육센터 앞,201901,702,906,1608,37.55661,126.898018
마포구,152, 마포구민체육센터 앞,201902,763,1026,1789,37.55661,126.898018
마포구,152, 마포구민체육센터 앞,201903,1821,2220,4041,37.55661,126.898018
마포구,152, 마포구민체육센터 앞,201904,3859,4739,8598,37.55661,126.898018
마포구,152, 마포구민체육센터 앞,201905,7344,8641,15985,37.55661,126.898018
마포구,152, 마포구민체육센터 앞,201906,7315,8444,15759,37.55661,126.898018
마포구,152, 마포구민체육센터 앞,201907,5823,6810,12633,37.55661,126.898018
마포구,152, 마포구민체육센터 앞,201908,7234,8193,15427,37.55661,126.898018
마포구,152, 마포구민체육센터 앞,201909,7795,8434,16229,37.55661,126.898018
마포구,152, 마포구민체육센터 앞,201910,7154,7991,15145,37.55661,126.898018
마포구,152, 마포구민체육센터 앞,201911,2804,3417,6221,37.55661,126.898018
마포구,152, 마포구민체육센터 앞,201912,1381,1659,3040,37.55661,126.898018
마포구,152, 마포구민체육센터 앞,202001,1447,1643,3090,37.55661,126.898018
마포구,152, 마포구민체육센터 앞,202002,1548,2077,3625,37.55661,126.898018
마포구,152, 마포구민체육센터 앞,202003,7456,8727,16183,37.55661,126.898018
마포구,152, 마포구민체육센터 앞,202004,9343,10360,19703,37.55661,126.898018
마포구,152, 마포구민체육센터 앞,202005,12155,12715,24870,37.55661,126.898018
마포구,152, 마포구민체육센터 앞,202006,11719,12388,24107,37.55661,126.898018
마포구,153, 성산2교 사거리,201901,509,515,1024,37.564697,126.912613
마포구,153, 성산2교 사거리,201902,449,467,916,37.564697,126.912613
마포구,153, 성산2교 사거리,201903,913,974,1887,37.564697,126.912613
마포구,153, 성산2교 사거리,201904,1448,1480,2928,37.564697,126.912613
마포구,153, 성산2교 사거리,201905,2204,2211,4415,37.564697,126.912613
마포구,153, 성산2교 사거리,201906,2423,2411,4834,37.564697,126.912613
마포구,153, 성산2교 사거리,201907,2371,2412,4783,37.564697,126.912613
마포구,153, 성산2교 사거리,201908,2223,2241,4464,37.564697,126.912613
마포구,153, 성산2교 사거리,201909,2016,2011,4027,37.564697,126.912613
마포구,153, 성산2교 사거리,201910,2035,2073,4108,37.564697,126.912613
마포구,153, 성산2교 사거리,201911,1250,1287,2537,37.564697,126.912613
마포구,153, 성산2교 사거리,201912,825,821,1646,37.564697,126.912613
마포구,153, 성산2교 사거리,202001,843,815,1658,37.564697,126.912613
마포구,153, 성산2교 사거리,202002,821,836,1657,37.564697,126.912613
마포구,153, 성산2교 사거리,202003,1481,1504,2985,37.564697,126.912613
마포구,153, 성산2교 사거리,202004,2024,2018,4042,37.564697,126.912613
마포구,153, 성산2교 사거리,202005,2444,2431,4875,37.564697,126.912613
마포구,153, 성산2교 사거리,202006,2706,2679,5385,37.564697,126.912613
마포구,154, 마포구청역,201901,722,814,1536,37.560909,126.905495
마포구,154, 마포구청역,201902,697,781,1478,37.560909,126.905495
마포구,154, 마포구청역,201903,1219,1290,2509,37.560909,126.905495
마포구,154, 마포구청역,201904,1727,1851,3578,37.560909,126.905495
마포구,154, 마포구청역,201905,2807,2785,5592,37.560909,126.905495
마포구,154, 마포구청역,201906,3115,3118,6233,37.560909,126.905495
마포구,154, 마포구청역,201907,3091,3158,6249,37.560909,126.905495
마포구,154, 마포구청역,201908,2440,2551,4991,37.560909,126.905495
마포구,154, 마포구청역,201909,2761,2763,5524,37.560909,126.905495
마포구,154, 마포구청역,201910,3275,3473,6748,37.560909,126.905495
마포구,154, 마포구청역,201911,1783,2011,3794,37.560909,126.905495
마포구,154, 마포구청역,201912,972,1173,2145,37.560909,126.905495
마포구,154, 마포구청역,202001,967,1144,2111,37.560909,126.905495
마포구,154, 마포구청역,202002,947,1163,2110,37.560909,126.905495
마포구,154, 마포구청역,202003,1927,2061,3988,37.560909,126.905495
마포구,154, 마포구청역,202004,2704,2709,5413,37.560909,126.905495
마포구,154, 마포구청역,202005,3284,3259,6543,37.560909,126.905495
마포구,154, 마포구청역,202006,3726,3732,7458,37.560909,126.905495
마포구,155, 가좌역1 번출구 뒤,201901,469,494,963,37.56855,126.914513
마포구,155, 가좌역1 번출구 뒤,201902,399,395,794,37.56855,126.914513
마포구,155, 가좌역1 번출구 뒤,201903,811,743,1554,37.56855,126.914513
마포구,155, 가좌역1 번출구 뒤,201904,1019,1022,2041,37.56855,126.914513
마포구,155, 가좌역1 번출구 뒤,201905,1629,1628,3257,37.56855,126.914513
마포구,155, 가좌역1 번출구 뒤,201906,1776,1757,3533,37.56855,126.914513
마포구,155, 가좌역1 번출구 뒤,201907,1703,1754,3457,37.56855,126.914513
마포구,155, 가좌역1 번출구 뒤,201908,1729,1748,3477,37.56855,126.914513
마포구,155, 가좌역1 번출구 뒤,201909,1372,1396,2768,37.56855,126.914513
마포구,155, 가좌역1 번출구 뒤,201910,1752,1746,3498,37.56855,126.914513
마포구,155, 가좌역1 번출구 뒤,201911,1160,1201,2361,37.56855,126.914513
마포구,155, 가좌역1 번출구 뒤,201912,756,744,1500,37.56855,126.914513
마포구,155, 가좌역1 번출구 뒤,202001,656,652,1308,37.56855,126.914513
마포구,155, 가좌역1 번출구 뒤,202002,688,684,1372,37.56855,126.914513
마포구,155, 가좌역1 번출구 뒤,202003,1175,1188,2363,37.56855,126.914513
마포구,155, 가좌역1 번출구 뒤,202004,1395,1393,2788,37.56855,126.914513
마포구,155, 가좌역1 번출구 뒤,202005,1657,1652,3309,37.56855,126.914513
마포구,155, 가좌역1 번출구 뒤,202006,1627,1629,3256,37.56855,126.914513
마포구,156, 서울서부지방법원 앞,201901,283,315,598,37.549904,126.955147
마포구,156, 서울서부지방법원 앞,201902,263,300,563,37.549904,126.955147
마포구,156, 서울서부지방법원 앞,201903,498,612,1110,37.549904,126.955147
마포구,156, 서울서부지방법원 앞,201904,736,823,1559,37.549904,126.955147
마포구,156, 서울서부지방법원 앞,201905,1147,1251,2398,37.549904,126.955147
마포구,156, 서울서부지방법원 앞,201906,1228,1305,2533,37.549904,126.955147
마포구,156, 서울서부지방법원 앞,201907,1240,1342,2582,37.549904,126.955147
마포구,156, 서울서부지방법원 앞,201908,1374,1488,2862,37.549904,126.955147
마포구,156, 서울서부지방법원 앞,201909,1119,1206,2325,37.549904,126.955147
마포구,156, 서울서부지방법원 앞,201910,1108,1116,2224,37.549904,126.955147
마포구,156, 서울서부지방법원 앞,201911,767,797,1564,37.549904,126.955147
마포구,156, 서울서부지방법원 앞,201912,419,504,923,37.549904,126.955147
마포구,156, 서울서부지방법원 앞,202001,409,542,951,37.549904,126.955147
마포구,156, 서울서부지방법원 앞,202002,401,474,875,37.549904,126.955147
마포구,156, 서울서부지방법원 앞,202003,711,760,1471,37.549904,126.955147
마포구,156, 서울서부지방법원 앞,202004,998,1008,2006,37.549904,126.955147
마포구,156, 서울서부지방법원 앞,202005,1145,1117,2262,37.549904,126.955147
마포구,156, 서울서부지방법원 앞,202006,1130,1128,2258,37.549904,126.955147
마포구,157, 애오개역 4번출구 앞,201901,411,512,923,37.553001,126.956688
마포구,157, 애오개역 4번출구 앞,201902,337,423,760,37.553001,126.956688
마포구,157, 애오개역 4번출구 앞,201903,639,705,1344,37.553001,126.956688
마포구,157, 애오개역 4번출구 앞,201904,1126,1243,2369,37.553001,126.956688
마포구,157, 애오개역 4번출구 앞,201905,1650,1757,3407,37.553001,126.956688
마포구,157, 애오개역 4번출구 앞,201906,1834,1942,3776,37.553001,126.956688
마포구,157, 애오개역 4번출구 앞,201907,1758,1874,3632,37.553001,126.956688
마포구,157, 애오개역 4번출구 앞,201908,1833,1894,3727,37.553001,126.956688
마포구,157, 애오개역 4번출구 앞,201909,1629,1726,3355,37.553001,126.956688
마포구,157, 애오개역 4번출구 앞,201910,1878,1950,3828,37.553001,126.956688
마포구,157, 애오개역 4번출구 앞,201911,1102,1136,2238,37.553001,126.956688
마포구,157, 애오개역 4번출구 앞,201912,630,630,1260,37.553001,126.956688
마포구,157, 애오개역 4번출구 앞,202001,541,585,1126,37.553001,126.956688
마포구,157, 애오개역 4번출구 앞,202002,468,451,919,37.553001,126.956688
마포구,157, 애오개역 4번출구 앞,202003,1015,1036,2051,37.553001,126.956688
마포구,157, 애오개역 4번출구 앞,202004,1456,1451,2907,37.553001,126.956688
마포구,157, 애오개역 4번출구 앞,202005,1703,1703,3406,37.553001,126.956688
마포구,157, 애오개역 4번출구 앞,202006,1676,1697,3373,37.553001,126.956688
서대문구,158, 독립문 어린이 공원,201901,297,293,590,37.571259,126.96048
서대문구,158, 독립문 어린이 공원,201902,275,269,544,37.571259,126.96048
서대문구,158, 독립문 어린이 공원,201903,495,450,945,37.571259,126.96048
서대문구,158, 독립문 어린이 공원,201904,684,633,1317,37.571259,126.96048
서대문구,158, 독립문 어린이 공원,201905,876,830,1706,37.571259,126.96048
서대문구,158, 독립문 어린이 공원,201906,900,836,1736,37.571259,126.96048
서대문구,158, 독립문 어린이 공원,201907,894,843,1737,37.571259,126.96048
서대문구,158, 독립문 어린이 공원,201908,813,791,1604,37.571259,126.96048
서대문구,158, 독립문 어린이 공원,201909,690,659,1349,37.571259,126.96048
서대문구,158, 독립문 어린이 공원,201910,675,674,1349,37.571259,126.96048
서대문구,158, 독립문 어린이 공원,201911,586,541,1127,37.571259,126.96048
서대문구,158, 독립문 어린이 공원,201912,371,352,723,37.571259,126.96048
서대문구,158, 독립문 어린이 공원,202001,372,284,656,37.571259,126.96048
서대문구,158, 독립문 어린이 공원,202002,340,261,601,37.571259,126.96048
서대문구,158, 독립문 어린이 공원,202003,698,616,1314,37.571259,126.96048
서대문구,158, 독립문 어린이 공원,202004,924,910,1834,37.571259,126.96048
서대문구,158, 독립문 어린이 공원,202005,855,852,1707,37.571259,126.96048
서대문구,158, 독립문 어린이 공원,202006,779,774,1553,37.571259,126.96048
서대문구,159, 이대역 4번 출구,201901,275,84,359,37.556953,126.946342
서대문구,159, 이대역 4번 출구,201902,262,95,357,37.556953,126.946342
서대문구,159, 이대역 4번 출구,201903,491,182,673,37.556953,126.946342
서대문구,159, 이대역 4번 출구,201904,775,303,1078,37.556953,126.946342
서대문구,159, 이대역 4번 출구,201905,776,434,1210,37.556953,126.946342
서대문구,159, 이대역 4번 출구,201906,766,408,1174,37.556953,126.946342
서대문구,159, 이대역 4번 출구,201907,773,357,1130,37.556953,126.946342
서대문구,159, 이대역 4번 출구,201908,621,306,927,37.556953,126.946342
서대문구,159, 이대역 4번 출구,201909,530,352,882,37.556953,126.946342
서대문구,159, 이대역 4번 출구,201910,531,386,917,37.556953,126.946342
서대문구,159, 이대역 4번 출구,201911,449,215,664,37.556953,126.946342
서대문구,159, 이대역 4번 출구,201912,206,108,314,37.556953,126.946342
서대문구,159, 이대역 4번 출구,202001,216,124,340,37.556953,126.946342
서대문구,159, 이대역 4번 출구,202002,136,94,230,37.556953,126.946342
서대문구,159, 이대역 4번 출구,202003,238,172,410,37.556953,126.946342
서대문구,159, 이대역 4번 출구,202004,346,309,655,37.556953,126.946342
서대문구,159, 이대역 4번 출구,202005,279,268,547,37.556953,126.946342
서대문구,159, 이대역 4번 출구,202006,290,253,543,37.556953,126.946342
서대문구,160, 북아현동 가구거리,201901,198,165,363,37.557549,126.959381
서대문구,160, 북아현동 가구거리,201902,196,124,320,37.557549,126.959381
서대문구,160, 북아현동 가구거리,201903,400,250,650,37.557549,126.959381
서대문구,160, 북아현동 가구거리,201904,681,428,1109,37.557549,126.959381
서대문구,160, 북아현동 가구거리,201905,1074,626,1700,37.557549,126.959381
서대문구,160, 북아현동 가구거리,201906,1113,610,1723,37.557549,126.959381
서대문구,160, 북아현동 가구거리,201907,912,585,1497,37.557549,126.959381
서대문구,160, 북아현동 가구거리,201908,891,550,1441,37.557549,126.959381
서대문구,160, 북아현동 가구거리,201909,879,572,1451,37.557549,126.959381
서대문구,160, 북아현동 가구거리,201910,1025,570,1595,37.557549,126.959381
서대문구,160, 북아현동 가구거리,201911,700,395,1095,37.557549,126.959381
서대문구,160, 북아현동 가구거리,201912,451,240,691,37.557549,126.959381
서대문구,160, 북아현동 가구거리,202001,440,240,680,37.557549,126.959381
서대문구,160, 북아현동 가구거리,202002,452,232,684,37.557549,126.959381
서대문구,160, 북아현동 가구거리,202003,742,458,1200,37.557549,126.959381
서대문구,160, 북아현동 가구거리,202004,858,648,1506,37.557549,126.959381
서대문구,160, 북아현동 가구거리,202005,700,610,1310,37.557549,126.959381
서대문구,160, 북아현동 가구거리,202006,657,523,1180,37.557549,126.959381
서대문구,161, 무악재역1번 출구,201901,206,144,350,37.582245,126.950645
서대문구,161, 무악재역1번 출구,201902,163,116,279,37.582245,126.950645
서대문구,161, 무악재역1번 출구,201903,250,185,435,37.582245,126.950645
서대문구,161, 무악재역1번 출구,201904,398,316,714,37.582245,126.950645
서대문구,161, 무악재역1번 출구,201905,546,468,1014,37.582245,126.950645
서대문구,161, 무악재역1번 출구,201906,540,470,1010,37.582245,126.950645
서대문구,161, 무악재역1번 출구,201907,583,458,1041,37.582245,126.950645
서대문구,161, 무악재역1번 출구,201908,506,415,921,37.582245,126.950645
서대문구,161, 무악재역1번 출구,201909,467,393,860,37.582245,126.950645
서대문구,161, 무악재역1번 출구,201910,378,363,741,37.582245,126.950645
서대문구,161, 무악재역1번 출구,201911,324,262,586,37.582245,126.950645
서대문구,161, 무악재역1번 출구,201912,175,123,298,37.582245,126.950645
서대문구,161, 무악재역1번 출구,202001,219,146,365,37.582245,126.950645
서대문구,161, 무악재역1번 출구,202002,220,147,367,37.582245,126.950645
서대문구,161, 무악재역1번 출구,202003,390,369,759,37.582245,126.950645
서대문구,161, 무악재역1번 출구,202004,598,586,1184,37.582245,126.950645
서대문구,161, 무악재역1번 출구,202005,573,566,1139,37.582245,126.950645
서대문구,161, 무악재역1번 출구,202006,554,511,1065,37.582245,126.950645
서대문구,162, 봉원고가차도 밑,201901,474,142,616,37.565269,126.946243
서대문구,162, 봉원고가차도 밑,201902,454,120,574,37.565269,126.946243
서대문구,162, 봉원고가차도 밑,201903,802,315,1117,37.565269,126.946243
서대문구,162, 봉원고가차도 밑,201904,1074,440,1514,37.565269,126.946243
서대문구,162, 봉원고가차도 밑,201905,1528,584,2112,37.565269,126.946243
서대문구,162, 봉원고가차도 밑,201906,1556,644,2200,37.565269,126.946243
서대문구,162, 봉원고가차도 밑,201907,1608,592,2200,37.565269,126.946243
서대문구,162, 봉원고가차도 밑,201908,1494,509,2003,37.565269,126.946243
서대문구,162, 봉원고가차도 밑,201909,1127,422,1549,37.565269,126.946243
서대문구,162, 봉원고가차도 밑,201910,1446,474,1920,37.565269,126.946243
서대문구,162, 봉원고가차도 밑,201911,1105,347,1452,37.565269,126.946243
서대문구,162, 봉원고가차도 밑,201912,729,235,964,37.565269,126.946243
서대문구,162, 봉원고가차도 밑,202001,570,157,727,37.565269,126.946243
서대문구,162, 봉원고가차도 밑,202002,504,154,658,37.565269,126.946243
서대문구,162, 봉원고가차도 밑,202003,730,320,1050,37.565269,126.946243
서대문구,162, 봉원고가차도 밑,202004,770,442,1212,37.565269,126.946243
서대문구,162, 봉원고가차도 밑,202005,671,420,1091,37.565269,126.946243
서대문구,162, 봉원고가차도 밑,202006,906,463,1369,37.565269,126.946243
서대문구,163, 명지전문대학교 정문 앞,201901,145,98,243,37.583698,126.924965
서대문구,163, 명지전문대학교 정문 앞,201902,176,109,285,37.583698,126.924965
서대문구,163, 명지전문대학교 정문 앞,201903,406,258,664,37.583698,126.924965
서대문구,163, 명지전문대학교 정문 앞,201904,530,425,955,37.583698,126.924965
서대문구,163, 명지전문대학교 정문 앞,201905,856,749,1605,37.583698,126.924965
서대문구,163, 명지전문대학교 정문 앞,201906,690,621,1311,37.583698,126.924965
서대문구,163, 명지전문대학교 정문 앞,201907,578,490,1068,37.583698,126.924965
서대문구,163, 명지전문대학교 정문 앞,201908,502,422,924,37.583698,126.924965
서대문구,163, 명지전문대학교 정문 앞,201909,517,476,993,37.583698,126.924965
서대문구,163, 명지전문대학교 정문 앞,201910,596,579,1175,37.583698,126.924965
서대문구,163, 명지전문대학교 정문 앞,201911,417,375,792,37.583698,126.924965
서대문구,163, 명지전문대학교 정문 앞,201912,294,239,533,37.583698,126.924965
서대문구,163, 명지전문대학교 정문 앞,202001,213,182,395,37.583698,126.924965
서대문구,163, 명지전문대학교 정문 앞,202002,185,150,335,37.583698,126.924965
서대문구,163, 명지전문대학교 정문 앞,202003,308,264,572,37.583698,126.924965
서대문구,163, 명지전문대학교 정문 앞,202004,460,396,856,37.583698,126.924965
서대문구,163, 명지전문대학교 정문 앞,202005,433,424,857,37.583698,126.924965
서대문구,163, 명지전문대학교 정문 앞,202006,490,455,945,37.583698,126.924965
서대문구,164, 북가좌1동 주민센터,201901,299,219,518,37.574478,126.910049
서대문구,164, 북가좌1동 주민센터,201902,237,185,422,37.574478,126.910049
서대문구,164, 북가좌1동 주민센터,201903,391,278,669,37.574478,126.910049
서대문구,164, 북가좌1동 주민센터,201904,530,388,918,37.574478,126.910049
서대문구,164, 북가좌1동 주민센터,201905,751,622,1373,37.574478,126.910049
서대문구,164, 북가좌1동 주민센터,201906,814,696,1510,37.574478,126.910049
서대문구,164, 북가좌1동 주민센터,201907,765,608,1373,37.574478,126.910049
서대문구,164, 북가좌1동 주민센터,201908,716,599,1315,37.574478,126.910049
서대문구,164, 북가좌1동 주민센터,201909,597,472,1069,37.574478,126.910049
서대문구,164, 북가좌1동 주민센터,201910,666,581,1247,37.574478,126.910049
서대문구,164, 북가좌1동 주민센터,201911,531,410,941,37.574478,126.910049
서대문구,164, 북가좌1동 주민센터,201912,316,241,557,37.574478,126.910049
서대문구,164, 북가좌1동 주민센터,202001,358,252,610,37.574478,126.910049
서대문구,164, 북가좌1동 주민센터,202002,332,228,560,37.574478,126.910049
서대문구,164, 북가좌1동 주민센터,202003,577,495,1072,37.574478,126.910049
서대문구,164, 북가좌1동 주민센터,202004,633,590,1223,37.574478,126.910049
서대문구,164, 북가좌1동 주민센터,202005,601,547,1148,37.574478,126.910049
서대문구,164, 북가좌1동 주민센터,202006,691,610,1301,37.574478,126.910049
서대문구,165, 중앙근린공원,201901,416,330,746,37.575138,126.91394
서대문구,165, 중앙근린공원,201902,335,274,609,37.575138,126.91394
서대문구,165, 중앙근린공원,201903,683,528,1211,37.575138,126.91394
서대문구,165, 중앙근린공원,201904,986,803,1789,37.575138,126.91394
서대문구,165, 중앙근린공원,201905,1418,1158,2576,37.575138,126.91394
서대문구,165, 중앙근린공원,201906,1582,1338,2920,37.575138,126.91394
서대문구,165, 중앙근린공원,201907,1801,1530,3331,37.575138,126.91394
서대문구,165, 중앙근린공원,201908,1507,1363,2870,37.575138,126.91394
서대문구,165, 중앙근린공원,201909,1441,1230,2671,37.575138,126.91394
서대문구,165, 중앙근린공원,201910,1680,1396,3076,37.575138,126.91394
서대문구,165, 중앙근린공원,201911,1180,974,2154,37.575138,126.91394
서대문구,165, 중앙근린공원,201912,730,574,1304,37.575138,126.91394
서대문구,165, 중앙근린공원,202001,628,520,1148,37.575138,126.91394
서대문구,165, 중앙근린공원,202002,622,516,1138,37.575138,126.91394
서대문구,165, 중앙근린공원,202003,1217,1092,2309,37.575138,126.91394
서대문구,165, 중앙근린공원,202004,1707,1587,3294,37.575138,126.91394
서대문구,165, 중앙근린공원,202005,1931,1824,3755,37.575138,126.91394
서대문구,165, 중앙근린공원,202006,2050,1806,3856,37.575138,126.91394
서대문구,166, 가재울 초등학교,201901,666,585,1251,37.573277,126.919678
서대문구,166, 가재울 초등학교,201902,596,564,1160,37.573277,126.919678
서대문구,166, 가재울 초등학교,201903,1090,983,2073,37.573277,126.919678
서대문구,166, 가재울 초등학교,201904,1406,1329,2735,37.573277,126.919678
서대문구,166, 가재울 초등학교,201905,2008,2002,4010,37.573277,126.919678
서대문구,166, 가재울 초등학교,201906,2258,2255,4513,37.573277,126.919678
서대문구,166, 가재울 초등학교,201907,2237,2251,4488,37.573277,126.919678
서대문구,166, 가재울 초등학교,201908,2167,2185,4352,37.573277,126.919678
서대문구,166, 가재울 초등학교,201909,1951,2044,3995,37.573277,126.919678
서대문구,166, 가재울 초등학교,201910,2413,2445,4858,37.573277,126.919678
서대문구,166, 가재울 초등학교,201911,1603,1538,3141,37.573277,126.919678
서대문구,166, 가재울 초등학교,201912,1059,1004,2063,37.573277,126.919678
서대문구,166, 가재울 초등학교,202001,971,906,1877,37.573277,126.919678
서대문구,166, 가재울 초등학교,202002,943,907,1850,37.573277,126.919678
서대문구,166, 가재울 초등학교,202003,2079,2108,4187,37.573277,126.919678
서대문구,166, 가재울 초등학교,202004,2905,2839,5744,37.573277,126.919678
서대문구,166, 가재울 초등학교,202005,3457,3456,6913,37.573277,126.919678
서대문구,166, 가재울 초등학교,202006,3457,3467,6924,37.573277,126.919678
서대문구,167, 연가초등학교 옆,201901,266,30,296,37.57946,126.91713
서대문구,167, 연가초등학교 옆,201902,225,36,261,37.57946,126.91713
서대문구,167, 연가초등학교 옆,201903,472,65,537,37.57946,126.91713
서대문구,167, 연가초등학교 옆,201904,581,75,656,37.57946,126.91713
서대문구,167, 연가초등학교 옆,201905,803,159,962,37.57946,126.91713
서대문구,167, 연가초등학교 옆,201906,788,199,987,37.57946,126.91713
서대문구,167, 연가초등학교 옆,201907,828,198,1026,37.57946,126.91713
서대문구,167, 연가초등학교 옆,201908,650,148,798,37.57946,126.91713
서대문구,167, 연가초등학교 옆,201909,689,134,823,37.57946,126.91713
서대문구,167, 연가초등학교 옆,201910,763,154,917,37.57946,126.91713
서대문구,167, 연가초등학교 옆,201911,727,150,877,37.57946,126.91713
서대문구,167, 연가초등학교 옆,201912,524,93,617,37.57946,126.91713
서대문구,167, 연가초등학교 옆,202001,394,102,496,37.57946,126.91713
서대문구,167, 연가초등학교 옆,202002,410,105,515,37.57946,126.91713
서대문구,167, 연가초등학교 옆,202003,536,152,688,37.57946,126.91713
서대문구,167, 연가초등학교 옆,202004,504,169,673,37.57946,126.91713
서대문구,167, 연가초등학교 옆,202005,541,182,723,37.57946,126.91713
서대문구,167, 연가초등학교 옆,202006,796,195,991,37.57946,126.91713
서대문구,169, 북가좌 삼거리,201901,225,202,427,37.573002,126.907799
서대문구,169, 북가좌 삼거리,201902,173,182,355,37.573002,126.907799
서대문구,169, 북가좌 삼거리,201903,395,322,717,37.573002,126.907799
서대문구,169, 북가좌 삼거리,201904,495,419,914,37.573002,126.907799
서대문구,169, 북가좌 삼거리,201905,682,615,1297,37.573002,126.907799
서대문구,169, 북가좌 삼거리,201906,758,638,1396,37.573002,126.907799
서대문구,169, 북가좌 삼거리,201907,703,609,1312,37.573002,126.907799
서대문구,169, 북가좌 삼거리,201908,665,714,1379,37.573002,126.907799
서대문구,169, 북가좌 삼거리,201909,711,618,1329,37.573002,126.907799
서대문구,169, 북가좌 삼거리,201910,748,652,1400,37.573002,126.907799
서대문구,169, 북가좌 삼거리,201911,559,533,1092,37.573002,126.907799
서대문구,169, 북가좌 삼거리,201912,356,330,686,37.573002,126.907799
서대문구,169, 북가좌 삼거리,202001,321,312,633,37.573002,126.907799
서대문구,169, 북가좌 삼거리,202002,317,268,585,37.573002,126.907799
서대문구,169, 북가좌 삼거리,202003,444,427,871,37.573002,126.907799
서대문구,169, 북가좌 삼거리,202004,635,592,1227,37.573002,126.907799
서대문구,169, 북가좌 삼거리,202005,782,726,1508,37.573002,126.907799
서대문구,169, 북가좌 삼거리,202006,915,777,1692,37.573002,126.907799
서대문구,170, 가재울 뉴타운 주유소 옆,201901,401,460,861,37.573112,126.922447
서대문구,170, 가재울 뉴타운 주유소 옆,201902,315,376,691,37.573112,126.922447
서대문구,170, 가재울 뉴타운 주유소 옆,201903,647,686,1333,37.573112,126.922447
서대문구,170, 가재울 뉴타운 주유소 옆,201904,868,870,1738,37.573112,126.922447
서대문구,170, 가재울 뉴타운 주유소 옆,201905,1376,1454,2830,37.573112,126.922447
서대문구,170, 가재울 뉴타운 주유소 옆,201906,1624,1696,3320,37.573112,126.922447
서대문구,170, 가재울 뉴타운 주유소 옆,201907,1409,1547,2956,37.573112,126.922447
서대문구,170, 가재울 뉴타운 주유소 옆,201908,1330,1480,2810,37.573112,126.922447
서대문구,170, 가재울 뉴타운 주유소 옆,201909,1191,1183,2374,37.573112,126.922447
서대문구,170, 가재울 뉴타운 주유소 옆,201910,1316,1380,2696,37.573112,126.922447
서대문구,170, 가재울 뉴타운 주유소 옆,201911,938,956,1894,37.573112,126.922447
서대문구,170, 가재울 뉴타운 주유소 옆,201912,608,616,1224,37.573112,126.922447
서대문구,170, 가재울 뉴타운 주유소 옆,202001,545,570,1115,37.573112,126.922447
서대문구,170, 가재울 뉴타운 주유소 옆,202002,541,524,1065,37.573112,126.922447
서대문구,170, 가재울 뉴타운 주유소 옆,202003,1119,1091,2210,37.573112,126.922447
서대문구,170, 가재울 뉴타운 주유소 옆,202004,1447,1435,2882,37.573112,126.922447
서대문구,170, 가재울 뉴타운 주유소 옆,202005,1482,1460,2942,37.573112,126.922447
서대문구,170, 가재울 뉴타운 주유소 옆,202006,1648,1664,3312,37.573112,126.922447
서대문구,171, 임광빌딩 앞,201901,220,203,423,37.564724,126.967278
서대문구,171, 임광빌딩 앞,201902,194,192,386,37.564724,126.967278
서대문구,171, 임광빌딩 앞,201903,374,353,727,37.564724,126.967278
서대문구,171, 임광빌딩 앞,201904,563,540,1103,37.564724,126.967278
서대문구,171, 임광빌딩 앞,201905,830,722,1552,37.564724,126.967278
서대문구,171, 임광빌딩 앞,201906,867,766,1633,37.564724,126.967278
서대문구,171, 임광빌딩 앞,201907,836,733,1569,37.564724,126.967278
서대문구,171, 임광빌딩 앞,201908,743,667,1410,37.564724,126.967278
서대문구,171, 임광빌딩 앞,201909,748,696,1444,37.564724,126.967278
서대문구,171, 임광빌딩 앞,201910,897,825,1722,37.564724,126.967278
서대문구,171, 임광빌딩 앞,201911,618,578,1196,37.564724,126.967278
서대문구,171, 임광빌딩 앞,201912,350,371,721,37.564724,126.967278
서대문구,171, 임광빌딩 앞,202001,311,313,624,37.564724,126.967278
서대문구,171, 임광빌딩 앞,202002,342,339,681,37.564724,126.967278
서대문구,171, 임광빌딩 앞,202003,619,589,1208,37.564724,126.967278
서대문구,171, 임광빌딩 앞,202004,817,783,1600,37.564724,126.967278
서대문구,171, 임광빌딩 앞,202005,665,669,1334,37.564724,126.967278
서대문구,171, 임광빌딩 앞,202006,781,753,1534,37.564724,126.967278
서대문구,172, 서대문소방서,201901,316,176,492,#N/A,#N/A
서대문구,172, 서대문소방서,201902,286,181,467,#N/A,#N/A
서대문구,172, 서대문소방서,201903,520,402,922,#N/A,#N/A
서대문구,172, 서대문소방서,201904,585,479,1064,#N/A,#N/A
서대문구,172, 서대문소방서,201905,262,223,485,#N/A,#N/A
서대문구,173, 서대문역 8번출구 앞,201901,293,244,537,37.564777,126.966148
서대문구,173, 서대문역 8번출구 앞,201902,234,232,466,37.564777,126.966148
서대문구,173, 서대문역 8번출구 앞,201903,451,396,847,37.564777,126.966148
서대문구,173, 서대문역 8번출구 앞,201904,756,620,1376,37.564777,126.966148
서대문구,173, 서대문역 8번출구 앞,201905,1038,883,1921,37.564777,126.966148
서대문구,173, 서대문역 8번출구 앞,201906,1069,975,2044,37.564777,126.966148
서대문구,173, 서대문역 8번출구 앞,201907,1058,892,1950,37.564777,126.966148
서대문구,173, 서대문역 8번출구 앞,201908,845,773,1618,37.564777,126.966148
서대문구,173, 서대문역 8번출구 앞,201909,789,706,1495,37.564777,126.966148
서대문구,173, 서대문역 8번출구 앞,201910,971,897,1868,37.564777,126.966148
서대문구,173, 서대문역 8번출구 앞,201911,599,535,1134,37.564777,126.966148
서대문구,173, 서대문역 8번출구 앞,201912,325,336,661,37.564777,126.966148
서대문구,173, 서대문역 8번출구 앞,202001,296,284,580,37.564777,126.966148
서대문구,173, 서대문역 8번출구 앞,202002,301,286,587,37.564777,126.966148
서대문구,173, 서대문역 8번출구 앞,202003,522,490,1012,37.564777,126.966148
서대문구,173, 서대문역 8번출구 앞,202004,736,700,1436,37.564777,126.966148
서대문구,173, 서대문역 8번출구 앞,202005,732,724,1456,37.564777,126.966148
서대문구,173, 서대문역 8번출구 앞,202006,882,861,1743,37.564777,126.966148
서대문구,174, 명지대학교 학생회관,201901,50,37,87,#N/A,#N/A
서대문구,175, 홍연2교옆,201901,621,571,1192,37.578072,126.930817
서대문구,175, 홍연2교옆,201902,608,549,1157,37.578072,126.930817
서대문구,175, 홍연2교옆,201903,1099,1069,2168,37.578072,126.930817
서대문구,175, 홍연2교옆,201904,1804,1762,3566,37.578072,126.930817
서대문구,175, 홍연2교옆,201905,2623,2743,5366,37.578072,126.930817
서대문구,175, 홍연2교옆,201906,2994,3103,6097,37.578072,126.930817
서대문구,175, 홍연2교옆,201907,2659,2802,5461,37.578072,126.930817
서대문구,175, 홍연2교옆,201908,2584,2691,5275,37.578072,126.930817
서대문구,175, 홍연2교옆,201909,2549,2573,5122,37.578072,126.930817
서대문구,175, 홍연2교옆,201910,2740,2828,5568,37.578072,126.930817
서대문구,175, 홍연2교옆,201911,1754,1724,3478,37.578072,126.930817
서대문구,175, 홍연2교옆,201912,991,944,1935,37.578072,126.930817
서대문구,175, 홍연2교옆,202001,914,927,1841,37.578072,126.930817
서대문구,175, 홍연2교옆,202002,913,918,1831,37.578072,126.930817
서대문구,175, 홍연2교옆,202003,2050,2094,4144,37.578072,126.930817
서대문구,175, 홍연2교옆,202004,2848,2878,5726,37.578072,126.930817
서대문구,175, 홍연2교옆,202005,3051,3091,6142,37.578072,126.930817
서대문구,175, 홍연2교옆,202006,3197,3313,6510,37.578072,126.930817
서대문구,176, 명지대학교 도서관,201901,357,464,821,37.581097,126.924026
서대문구,176, 명지대학교 도서관,201902,434,478,912,37.581097,126.924026
서대문구,176, 명지대학교 도서관,201903,1103,1276,2379,37.581097,126.924026
서대문구,176, 명지대학교 도서관,201904,1705,1953,3658,37.581097,126.924026
서대문구,176, 명지대학교 도서관,201905,2924,3257,6181,37.581097,126.924026
서대문구,176, 명지대학교 도서관,201906,3038,3234,6272,37.581097,126.924026
서대문구,176, 명지대학교 도서관,201907,2616,3091,5707,37.581097,126.924026
서대문구,176, 명지대학교 도서관,201908,2420,2752,5172,37.581097,126.924026
서대문구,176, 명지대학교 도서관,201909,2411,2763,5174,37.581097,126.924026
서대문구,176, 명지대학교 도서관,201910,2925,3103,6028,37.581097,126.924026
서대문구,176, 명지대학교 도서관,201911,1763,1981,3744,37.581097,126.924026
서대문구,176, 명지대학교 도서관,201912,776,867,1643,37.581097,126.924026
서대문구,176, 명지대학교 도서관,202001,725,756,1481,37.581097,126.924026
서대문구,176, 명지대학교 도서관,202002,697,726,1423,37.581097,126.924026
서대문구,176, 명지대학교 도서관,202003,1429,1502,2931,37.581097,126.924026
서대문구,176, 명지대학교 도서관,202004,2235,2279,4514,37.581097,126.924026
서대문구,176, 명지대학교 도서관,202005,2574,2804,5378,37.581097,126.924026
서대문구,176, 명지대학교 도서관,202006,2550,2755,5305,37.581097,126.924026
서대문구,177, 북가좌 초등학교,201901,153,194,347,37.577675,126.909805
서대문구,177, 북가좌 초등학교,201902,166,177,343,37.577675,126.909805
서대문구,177, 북가좌 초등학교,201903,278,294,572,37.577675,126.909805
서대문구,177, 북가좌 초등학교,201904,443,448,891,37.577675,126.909805
서대문구,177, 북가좌 초등학교,201905,697,672,1369,37.577675,126.909805
서대문구,177, 북가좌 초등학교,201906,796,835,1631,37.577675,126.909805
서대문구,177, 북가좌 초등학교,201907,866,907,1773,37.577675,126.909805
서대문구,177, 북가좌 초등학교,201908,865,868,1733,37.577675,126.909805
서대문구,177, 북가좌 초등학교,201909,661,658,1319,37.577675,126.909805
서대문구,177, 북가좌 초등학교,201910,753,765,1518,37.577675,126.909805
서대문구,177, 북가좌 초등학교,201911,503,541,1044,37.577675,126.909805
서대문구,177, 북가좌 초등학교,201912,275,352,627,37.577675,126.909805
서대문구,177, 북가좌 초등학교,202001,301,367,668,37.577675,126.909805
서대문구,177, 북가좌 초등학교,202002,296,320,616,37.577675,126.909805
서대문구,177, 북가좌 초등학교,202003,487,483,970,37.577675,126.909805
서대문구,177, 북가좌 초등학교,202004,617,609,1226,37.577675,126.909805
서대문구,177, 북가좌 초등학교,202005,752,751,1503,37.577675,126.909805
서대문구,177, 북가좌 초등학교,202006,846,857,1703,37.577675,126.909805
서대문구,178, 증산3교 앞,201901,230,283,513,37.579876,126.906349
서대문구,178, 증산3교 앞,201902,208,219,427,37.579876,126.906349
서대문구,178, 증산3교 앞,201903,468,415,883,37.579876,126.906349
서대문구,178, 증산3교 앞,201904,666,616,1282,37.579876,126.906349
서대문구,178, 증산3교 앞,201905,905,837,1742,37.579876,126.906349
서대문구,178, 증산3교 앞,201906,1127,1075,2202,37.579876,126.906349
서대문구,178, 증산3교 앞,201907,1236,1164,2400,37.579876,126.906349
서대문구,178, 증산3교 앞,201908,1111,1118,2229,37.579876,126.906349
서대문구,178, 증산3교 앞,201909,1119,1042,2161,37.579876,126.906349
서대문구,178, 증산3교 앞,201910,1273,1272,2545,37.579876,126.906349
서대문구,178, 증산3교 앞,201911,850,830,1680,37.579876,126.906349
서대문구,178, 증산3교 앞,201912,561,548,1109,37.579876,126.906349
서대문구,178, 증산3교 앞,202001,492,428,920,37.579876,126.906349
서대문구,178, 증산3교 앞,202002,455,422,877,37.579876,126.906349
서대문구,178, 증산3교 앞,202003,955,915,1870,37.579876,126.906349
서대문구,178, 증산3교 앞,202004,1279,1232,2511,37.579876,126.906349
서대문구,178, 증산3교 앞,202005,1519,1536,3055,37.579876,126.906349
서대문구,178, 증산3교 앞,202006,1680,1671,3351,37.579876,126.906349
서대문구,179, 가좌역 4번출구 앞,201901,689,646,1335,37.569122,126.914795
서대문구,179, 가좌역 4번출구 앞,201902,578,563,1141,37.569122,126.914795
서대문구,179, 가좌역 4번출구 앞,201903,1039,972,2011,37.569122,126.914795
서대문구,179, 가좌역 4번출구 앞,201904,1281,1221,2502,37.569122,126.914795
서대문구,179, 가좌역 4번출구 앞,201905,1818,1706,3524,37.569122,126.914795
서대문구,179, 가좌역 4번출구 앞,201906,1860,1806,3666,37.569122,126.914795
서대문구,179, 가좌역 4번출구 앞,201907,1746,1757,3503,37.569122,126.914795
서대문구,179, 가좌역 4번출구 앞,201908,1641,1620,3261,37.569122,126.914795
서대문구,179, 가좌역 4번출구 앞,201909,1503,1466,2969,37.569122,126.914795
서대문구,179, 가좌역 4번출구 앞,201910,1812,1790,3602,37.569122,126.914795
서대문구,179, 가좌역 4번출구 앞,201911,1353,1414,2767,37.569122,126.914795
서대문구,179, 가좌역 4번출구 앞,201912,937,986,1923,37.569122,126.914795
서대문구,179, 가좌역 4번출구 앞,202001,854,896,1750,37.569122,126.914795
서대문구,179, 가좌역 4번출구 앞,202002,784,814,1598,37.569122,126.914795
서대문구,179, 가좌역 4번출구 앞,202003,1240,1246,2486,37.569122,126.914795
서대문구,179, 가좌역 4번출구 앞,202004,1648,1643,3291,37.569122,126.914795
서대문구,179, 가좌역 4번출구 앞,202005,1820,1797,3617,37.569122,126.914795
서대문구,179, 가좌역 4번출구 앞,202006,2062,2013,4075,37.569122,126.914795
서대문구,180, 충정로역 7번출구 아래,201901,357,202,559,37.559967,126.962463
서대문구,180, 충정로역 7번출구 아래,201902,358,255,613,37.559967,126.962463
서대문구,180, 충정로역 7번출구 아래,201903,632,464,1096,37.559967,126.962463
서대문구,180, 충정로역 7번출구 아래,201904,851,639,1490,37.559967,126.962463
서대문구,180, 충정로역 7번출구 아래,201905,1306,976,2282,37.559967,126.962463
서대문구,180, 충정로역 7번출구 아래,201906,1356,1039,2395,37.559967,126.962463
서대문구,180, 충정로역 7번출구 아래,201907,1093,832,1925,37.559967,126.962463
서대문구,180, 충정로역 7번출구 아래,201908,1073,827,1900,37.559967,126.962463
서대문구,180, 충정로역 7번출구 아래,201909,1028,852,1880,37.559967,126.962463
서대문구,180, 충정로역 7번출구 아래,201910,1170,1000,2170,37.559967,126.962463
서대문구,180, 충정로역 7번출구 아래,201911,845,736,1581,37.559967,126.962463
서대문구,180, 충정로역 7번출구 아래,201912,477,403,880,37.559967,126.962463
서대문구,180, 충정로역 7번출구 아래,202001,444,344,788,37.559967,126.962463
서대문구,180, 충정로역 7번출구 아래,202002,466,351,817,37.559967,126.962463
서대문구,180, 충정로역 7번출구 아래,202003,861,704,1565,37.559967,126.962463
서대문구,180, 충정로역 7번출구 아래,202004,1085,996,2081,37.559967,126.962463
서대문구,180, 충정로역 7번출구 아래,202005,1094,1043,2137,37.559967,126.962463
서대문구,180, 충정로역 7번출구 아래,202006,1052,983,2035,37.559967,126.962463
마포구,181, 망원초록길 입구,201901,48,28,76,37.551342,126.902672
마포구,181, 망원초록길 입구,201902,78,66,144,37.551342,126.902672
마포구,181, 망원초록길 입구,201903,208,166,374,37.551342,126.902672
마포구,181, 망원초록길 입구,201904,410,316,726,37.551342,126.902672
마포구,181, 망원초록길 입구,201905,603,538,1141,37.551342,126.902672
마포구,181, 망원초록길 입구,201906,592,508,1100,37.551342,126.902672
마포구,181, 망원초록길 입구,201907,336,280,616,37.551342,126.902672
마포구,181, 망원초록길 입구,201908,433,376,809,37.551342,126.902672
마포구,181, 망원초록길 입구,201909,367,318,685,37.551342,126.902672
마포구,181, 망원초록길 입구,201910,549,474,1023,37.551342,126.902672
마포구,181, 망원초록길 입구,201911,208,161,369,37.551342,126.902672
마포구,181, 망원초록길 입구,201912,99,60,159,37.551342,126.902672
마포구,181, 망원초록길 입구,202001,122,73,195,37.551342,126.902672
마포구,181, 망원초록길 입구,202002,173,109,282,37.551342,126.902672
마포구,181, 망원초록길 입구,202003,762,685,1447,37.551342,126.902672
마포구,181, 망원초록길 입구,202004,876,827,1703,37.551342,126.902672
마포구,181, 망원초록길 입구,202005,772,747,1519,37.551342,126.902672
마포구,181, 망원초록길 입구,202006,658,608,1266,37.551342,126.902672
마포구,182, 망원2빗물펌프장 앞,201901,406,361,767,37.551567,126.902847
마포구,182, 망원2빗물펌프장 앞,201902,455,401,856,37.551567,126.902847
마포구,182, 망원2빗물펌프장 앞,201903,961,952,1913,37.551567,126.902847
마포구,182, 망원2빗물펌프장 앞,201904,1700,1802,3502,37.551567,126.902847
마포구,182, 망원2빗물펌프장 앞,201905,3113,3264,6377,37.551567,126.902847
마포구,182, 망원2빗물펌프장 앞,201906,3030,3105,6135,37.551567,126.902847
마포구,182, 망원2빗물펌프장 앞,201907,2479,2510,4989,37.551567,126.902847
마포구,182, 망원2빗물펌프장 앞,201908,2763,2873,5636,37.551567,126.902847
마포구,182, 망원2빗물펌프장 앞,201909,2840,2867,5707,37.551567,126.902847
마포구,182, 망원2빗물펌프장 앞,201910,2721,2875,5596,37.551567,126.902847
마포구,182, 망원2빗물펌프장 앞,201911,1180,1152,2332,37.551567,126.902847
마포구,182, 망원2빗물펌프장 앞,201912,547,526,1073,37.551567,126.902847
마포구,182, 망원2빗물펌프장 앞,202001,533,497,1030,37.551567,126.902847
마포구,182, 망원2빗물펌프장 앞,202002,730,702,1432,37.551567,126.902847
마포구,182, 망원2빗물펌프장 앞,202003,2661,2819,5480,37.551567,126.902847
마포구,182, 망원2빗물펌프장 앞,202004,3699,3773,7472,37.551567,126.902847
마포구,182, 망원2빗물펌프장 앞,202005,4290,4354,8644,37.551567,126.902847
마포구,182, 망원2빗물펌프장 앞,202006,3977,4022,7999,37.551567,126.902847
마포구,183, 하늘채코오롱아파트 건너편,201901,1146,1048,2194,37.565166,126.919395
마포구,183, 하늘채코오롱아파트 건너편,201902,1010,1023,2033,37.565166,126.919395
마포구,183, 하늘채코오롱아파트 건너편,201903,1884,1803,3687,37.565166,126.919395
마포구,183, 하늘채코오롱아파트 건너편,201904,2579,2473,5052,37.565166,126.919395
마포구,183, 하늘채코오롱아파트 건너편,201905,3713,3424,7137,37.565166,126.919395
마포구,183, 하늘채코오롱아파트 건너편,201906,3970,3604,7574,37.565166,126.919395
마포구,183, 하늘채코오롱아파트 건너편,201907,3852,3461,7313,37.565166,126.919395
마포구,183, 하늘채코오롱아파트 건너편,201908,3554,3305,6859,37.565166,126.919395
마포구,183, 하늘채코오롱아파트 건너편,201909,3503,3159,6662,37.565166,126.919395
마포구,183, 하늘채코오롱아파트 건너편,201910,3970,3710,7680,37.565166,126.919395
마포구,183, 하늘채코오롱아파트 건너편,201911,2342,2412,4754,37.565166,126.919395
마포구,183, 하늘채코오롱아파트 건너편,201912,1478,1476,2954,37.565166,126.919395
마포구,183, 하늘채코오롱아파트 건너편,202001,1268,1243,2511,37.565166,126.919395
마포구,183, 하늘채코오롱아파트 건너편,202002,1290,1255,2545,37.565166,126.919395
마포구,183, 하늘채코오롱아파트 건너편,202003,2442,2358,4800,37.565166,126.919395
마포구,183, 하늘채코오롱아파트 건너편,202004,2903,2807,5710,37.565166,126.919395
마포구,183, 하늘채코오롱아파트 건너편,202005,3511,3448,6959,37.565166,126.919395
마포구,183, 하늘채코오롱아파트 건너편,202006,3504,3343,6847,37.565166,126.919395
마포구,184, SK망원동주유소 건너편,201901,638,710,1348,37.558949,126.907753
마포구,184, SK망원동주유소 건너편,201902,563,614,1177,37.558949,126.907753
마포구,184, SK망원동주유소 건너편,201903,1098,1189,2287,37.558949,126.907753
마포구,184, SK망원동주유소 건너편,201904,1398,1526,2924,37.558949,126.907753
마포구,184, SK망원동주유소 건너편,201905,2246,2283,4529,37.558949,126.907753
마포구,184, SK망원동주유소 건너편,201906,2461,2559,5020,37.558949,126.907753
마포구,184, SK망원동주유소 건너편,201907,2047,2126,4173,37.558949,126.907753
마포구,184, SK망원동주유소 건너편,201908,2499,2621,5120,37.558949,126.907753
마포구,184, SK망원동주유소 건너편,201909,2223,2196,4419,37.558949,126.907753
마포구,184, SK망원동주유소 건너편,201910,2523,2593,5116,37.558949,126.907753
마포구,184, SK망원동주유소 건너편,201911,1461,1644,3105,37.558949,126.907753
마포구,184, SK망원동주유소 건너편,201912,821,911,1732,37.558949,126.907753
마포구,184, SK망원동주유소 건너편,202001,780,831,1611,37.558949,126.907753
마포구,184, SK망원동주유소 건너편,202002,846,857,1703,37.558949,126.907753
마포구,184, SK망원동주유소 건너편,202003,1559,1537,3096,37.558949,126.907753
마포구,184, SK망원동주유소 건너편,202004,1975,1982,3957,37.558949,126.907753
마포구,184, SK망원동주유소 건너편,202005,2356,2313,4669,37.558949,126.907753
마포구,184, SK망원동주유소 건너편,202006,2660,2661,5321,37.558949,126.907753
마포구,185, 마포 신수공원 앞,201901,430,328,758,37.542545,126.934296
마포구,185, 마포 신수공원 앞,201902,376,286,662,37.542545,126.934296
마포구,185, 마포 신수공원 앞,201903,767,592,1359,37.542545,126.934296
마포구,185, 마포 신수공원 앞,201904,1088,956,2044,37.542545,126.934296
마포구,185, 마포 신수공원 앞,201905,1601,1485,3086,37.542545,126.934296
마포구,185, 마포 신수공원 앞,201906,1777,1681,3458,37.542545,126.934296
마포구,185, 마포 신수공원 앞,201907,1654,1562,3216,37.542545,126.934296
마포구,185, 마포 신수공원 앞,201908,1596,1460,3056,37.542545,126.934296
마포구,185, 마포 신수공원 앞,201909,1491,1318,2809,37.542545,126.934296
마포구,185, 마포 신수공원 앞,201910,1764,1635,3399,37.542545,126.934296
마포구,185, 마포 신수공원 앞,201911,1012,829,1841,37.542545,126.934296
마포구,185, 마포 신수공원 앞,201912,670,484,1154,37.542545,126.934296
마포구,185, 마포 신수공원 앞,202001,609,487,1096,37.542545,126.934296
마포구,185, 마포 신수공원 앞,202002,652,530,1182,37.542545,126.934296
마포구,185, 마포 신수공원 앞,202003,1401,1226,2627,37.542545,126.934296
마포구,185, 마포 신수공원 앞,202004,1687,1500,3187,37.542545,126.934296
마포구,185, 마포 신수공원 앞,202005,1724,1629,3353,37.542545,126.934296
마포구,185, 마포 신수공원 앞,202006,1535,1475,3010,37.542545,126.934296
마포구,186, 월드컵공원,201901,290,319,609,37.563965,126.898209
마포구,186, 월드컵공원,201902,355,370,725,37.563965,126.898209
마포구,186, 월드컵공원,201903,837,875,1712,37.563965,126.898209
마포구,186, 월드컵공원,201904,1654,1750,3404,37.563965,126.898209
마포구,186, 월드컵공원,201905,2460,2593,5053,37.563965,126.898209
마포구,186, 월드컵공원,201906,2598,2712,5310,37.563965,126.898209
마포구,186, 월드컵공원,201907,1742,1857,3599,37.563965,126.898209
마포구,186, 월드컵공원,201908,2094,2069,4163,37.563965,126.898209
마포구,186, 월드컵공원,201909,2629,2569,5198,37.563965,126.898209
마포구,186, 월드컵공원,201910,3532,3465,6997,37.563965,126.898209
마포구,186, 월드컵공원,201911,1247,1329,2576,37.563965,126.898209
마포구,186, 월드컵공원,201912,354,409,763,37.563965,126.898209
마포구,186, 월드컵공원,202001,513,544,1057,37.563965,126.898209
마포구,186, 월드컵공원,202002,618,625,1243,37.563965,126.898209
마포구,186, 월드컵공원,202003,3560,3650,7210,37.563965,126.898209
마포구,186, 월드컵공원,202004,5233,5167,10400,37.563965,126.898209
마포구,186, 월드컵공원,202005,5835,5733,11568,37.563965,126.898209
마포구,186, 월드컵공원,202006,4890,4777,9667,37.563965,126.898209
서대문구,188, 홍은동 정원여중 입구,201901,332,256,588,37.586388,126.935127
서대문구,188, 홍은동 정원여중 입구,201902,358,321,679,37.586388,126.935127
서대문구,188, 홍은동 정원여중 입구,201903,664,618,1282,37.586388,126.935127
서대문구,188, 홍은동 정원여중 입구,201904,817,838,1655,37.586388,126.935127
서대문구,188, 홍은동 정원여중 입구,201905,1308,1335,2643,37.586388,126.935127
서대문구,188, 홍은동 정원여중 입구,201906,1487,1538,3025,37.586388,126.935127
서대문구,188, 홍은동 정원여중 입구,201907,1356,1487,2843,37.586388,126.935127
서대문구,188, 홍은동 정원여중 입구,201908,1171,1424,2595,37.586388,126.935127
서대문구,188, 홍은동 정원여중 입구,201909,1212,1324,2536,37.586388,126.935127
서대문구,188, 홍은동 정원여중 입구,201910,1431,1511,2942,37.586388,126.935127
서대문구,188, 홍은동 정원여중 입구,201911,937,944,1881,37.586388,126.935127
서대문구,188, 홍은동 정원여중 입구,201912,545,578,1123,37.586388,126.935127
서대문구,188, 홍은동 정원여중 입구,202001,511,532,1043,37.586388,126.935127
서대문구,188, 홍은동 정원여중 입구,202002,500,541,1041,37.586388,126.935127
서대문구,188, 홍은동 정원여중 입구,202003,1163,1233,2396,37.586388,126.935127
서대문구,188, 홍은동 정원여중 입구,202004,1575,1594,3169,37.586388,126.935127
서대문구,188, 홍은동 정원여중 입구,202005,1858,1918,3776,37.586388,126.935127
서대문구,188, 홍은동 정원여중 입구,202006,1917,1987,3904,37.586388,126.935127
서대문구,191, 정명학원,201901,297,306,603,37.578892,126.910736
서대문구,191, 정명학원,201902,278,305,583,37.578892,126.910736
서대문구,191, 정명학원,201903,432,515,947,37.578892,126.910736
서대문구,191, 정명학원,201904,584,653,1237,37.578892,126.910736
서대문구,191, 정명학원,201905,964,1009,1973,37.578892,126.910736
서대문구,191, 서우빌딩(바른학원),201906,937,1093,2030,37.578892,126.910736
서대문구,191, 서우빌딩(바른학원),201907,917,1161,2078,37.578892,126.910736
서대문구,191, 서우빌딩(바른학원),201908,875,1044,1919,37.578892,126.910736
서대문구,191, 서우빌딩(바른학원),201909,865,952,1817,37.578892,126.910736
서대문구,191, 서우빌딩(바른학원),201910,1048,1119,2167,37.578892,126.910736
서대문구,191, 서우빌딩(바른학원),201911,633,798,1431,37.578892,126.910736
서대문구,191, 서우빌딩(바른학원),201912,429,458,887,37.578892,126.910736
서대문구,191, 서우빌딩(바른학원),202001,368,402,770,37.578892,126.910736
서대문구,191, 서우빌딩(바른학원),202002,368,420,788,37.578892,126.910736
서대문구,191, 서우빌딩(바른학원),202003,625,660,1285,37.578892,126.910736
서대문구,191, 서우빌딩(바른학원),202004,928,933,1861,37.578892,126.910736
서대문구,191, 서우빌딩(바른학원),202005,1058,1063,2121,37.578892,126.910736
서대문구,191, 서우빌딩(바른학원),202006,1202,1239,2441,37.578892,126.910736
서대문구,192, 연서어린이공원,201901,462,368,830,37.572227,126.923065
서대문구,192, 연서어린이공원,201902,341,268,609,37.572227,126.923065
서대문구,192, 연서어린이공원,201903,569,424,993,37.572227,126.923065
서대문구,192, 연서어린이공원,201904,684,568,1252,37.572227,126.923065
서대문구,192, 연서어린이공원,201905,791,734,1525,37.572227,126.923065
서대문구,192, 연서어린이공원,201906,903,841,1744,37.572227,126.923065
서대문구,192, 연서어린이공원,201907,943,867,1810,37.572227,126.923065
서대문구,192, 연서어린이공원,201908,865,844,1709,37.572227,126.923065
서대문구,192, 연서어린이공원,201909,751,714,1465,37.572227,126.923065
서대문구,192, 연서어린이공원,201910,829,770,1599,37.572227,126.923065
서대문구,192, 연서어린이공원,201911,687,597,1284,37.572227,126.923065
서대문구,192, 연서어린이공원,201912,446,369,815,37.572227,126.923065
서대문구,192, 연서어린이공원,202001,422,356,778,37.572227,126.923065
서대문구,192, 연서어린이공원,202002,336,270,606,37.572227,126.923065
서대문구,192, 연서어린이공원,202003,566,509,1075,37.572227,126.923065
서대문구,192, 연서어린이공원,202004,612,537,1149,37.572227,126.923065
서대문구,192, 연서어린이공원,202005,613,579,1192,37.572227,126.923065
서대문구,192, 연서어린이공원,202006,803,773,1576,37.572227,126.923065
서대문구,194, 증산교 앞,201901,551,547,1098,37.577316,126.902969
서대문구,194, 증산교 앞,201902,478,435,913,37.577316,126.902969
서대문구,194, 증산교 앞,201903,862,859,1721,37.577316,126.902969
서대문구,194, 증산교 앞,201904,1364,1429,2793,37.577316,126.902969
서대문구,194, 증산교 앞,201905,2071,2081,4152,37.577316,126.902969
서대문구,194, 증산교 앞,201906,2073,2051,4124,37.577316,126.902969
서대문구,194, 증산교 앞,201907,1929,1889,3818,37.577316,126.902969
서대문구,194, 증산교 앞,201908,1973,1961,3934,37.577316,126.902969
서대문구,194, 증산교 앞,201909,1958,1923,3881,37.577316,126.902969
서대문구,194, 증산교 앞,201910,1855,1852,3707,37.577316,126.902969
서대문구,194, 증산교 앞,201911,1158,1153,2311,37.577316,126.902969
서대문구,194, 증산교 앞,201912,735,685,1420,37.577316,126.902969
서대문구,194, 증산교 앞,202001,690,672,1362,37.577316,126.902969
서대문구,194, 증산교 앞,202002,563,531,1094,37.577316,126.902969
서대문구,194, 증산교 앞,202003,1504,1444,2948,37.577316,126.902969
서대문구,194, 증산교 앞,202004,2018,1988,4006,37.577316,126.902969
서대문구,194, 증산교 앞,202005,2234,2204,4438,37.577316,126.902969
서대문구,194, 증산교 앞,202006,2442,2415,4857,37.577316,126.902969
서대문구,195, 모래내고가차도,201901,359,234,593,37.567657,126.917809
서대문구,195, 모래내고가차도,201902,304,192,496,37.567657,126.917809
서대문구,195, 모래내고가차도,201903,503,353,856,37.567657,126.917809
서대문구,195, 모래내고가차도,201904,683,517,1200,37.567657,126.917809
서대문구,195, 모래내고가차도,201905,898,692,1590,37.567657,126.917809
서대문구,195, 모래내고가차도,201906,997,737,1734,37.567657,126.917809
서대문구,195, 모래내고가차도,201907,884,659,1543,37.567657,126.917809
서대문구,195, 모래내고가차도,201908,636,511,1147,37.567657,126.917809
서대문구,195, 모래내고가차도,201909,591,538,1129,37.567657,126.917809
서대문구,195, 모래내고가차도,201910,735,647,1382,37.567657,126.917809
서대문구,195, 모래내고가차도,201911,557,448,1005,37.567657,126.917809
서대문구,195, 모래내고가차도,201912,374,310,684,37.567657,126.917809
서대문구,195, 모래내고가차도,202001,326,256,582,37.567657,126.917809
서대문구,195, 모래내고가차도,202002,339,256,595,37.567657,126.917809
서대문구,195, 모래내고가차도,202003,535,500,1035,37.567657,126.917809
서대문구,195, 모래내고가차도,202004,674,667,1341,37.567657,126.917809
서대문구,195, 모래내고가차도,202005,736,743,1479,37.567657,126.917809
서대문구,195, 모래내고가차도,202006,780,765,1545,37.567657,126.917809
서대문구,196, 연희교차로 인근,201901,216,105,321,37.56612,126.925896
서대문구,196, 연희교차로 인근,201902,174,89,263,37.56612,126.925896
서대문구,196, 연희교차로 인근,201903,360,241,601,37.56612,126.925896
서대문구,196, 연희교차로 인근,201904,422,312,734,37.56612,126.925896
서대문구,196, 연희교차로 인근,201905,531,366,897,37.56612,126.925896
서대문구,196, 연희교차로 인근,201906,606,433,1039,37.56612,126.925896
서대문구,196, 연희교차로 인근,201907,590,427,1017,37.56612,126.925896
서대문구,196, 연희교차로 인근,201908,498,380,878,37.56612,126.925896
서대문구,196, 연희교차로 인근,201909,394,339,733,37.56612,126.925896
서대문구,196, 연희교차로 인근,201910,434,345,779,37.56612,126.925896
서대문구,196, 연희교차로 인근,201911,333,219,552,37.56612,126.925896
서대문구,196, 연희교차로 인근,201912,241,167,408,37.56612,126.925896
서대문구,196, 연희교차로 인근,202001,214,143,357,37.56612,126.925896
서대문구,196, 연희교차로 인근,202002,179,111,290,37.56612,126.925896
서대문구,196, 연희교차로 인근,202003,333,254,587,37.56612,126.925896
서대문구,196, 연희교차로 인근,202004,389,343,732,37.56612,126.925896
서대문구,196, 연희교차로 인근,202005,447,434,881,37.56612,126.925896
서대문구,196, 연희교차로 인근,202006,446,378,824,37.56612,126.925896
서대문구,198, 충정2교,201901,270,284,554,37.562138,126.963776
서대문구,198, 충정2교,201902,198,184,382,37.562138,126.963776
서대문구,198, 충정2교,201903,350,300,650,37.562138,126.963776
서대문구,198, 충정2교,201904,639,460,1099,37.562138,126.963776
서대문구,198, 충정2교,201905,1049,617,1666,37.562138,126.963776
서대문구,198, 충정2교,201906,1098,584,1682,37.562138,126.963776
서대문구,198, 충정2교,201907,962,592,1554,37.562138,126.963776
서대문구,198, 충정2교,201908,923,589,1512,37.562138,126.963776
서대문구,198, 충정2교,201909,907,647,1554,37.562138,126.963776
서대문구,198, 충정2교,201910,1099,775,1874,37.562138,126.963776
서대문구,198, 충정2교,201911,667,480,1147,37.562138,126.963776
서대문구,198, 충정2교,201912,387,327,714,37.562138,126.963776
서대문구,198, 충정2교,202001,356,257,613,37.562138,126.963776
서대문구,198, 충정2교,202002,381,257,638,37.562138,126.963776
서대문구,198, 충정2교,202003,655,463,1118,37.562138,126.963776
서대문구,198, 충정2교,202004,910,763,1673,37.562138,126.963776
서대문구,198, 충정2교,202005,883,793,1676,37.562138,126.963776
서대문구,198, 충정2교,202006,881,785,1666,37.562138,126.963776
마포구,199, 서울 월드컵 경기장,201901,199,169,368,37.566845,126.896446
마포구,199, 서울 월드컵 경기장,201902,234,188,422,37.566845,126.896446
마포구,199, 서울 월드컵 경기장,201903,468,377,845,37.566845,126.896446
마포구,199, 서울 월드컵 경기장,201904,733,576,1309,37.566845,126.896446
마포구,199, 서울 월드컵 경기장,201905,1208,835,2043,37.566845,126.896446
마포구,199, 서울 월드컵 경기장,201906,1288,836,2124,37.566845,126.896446
마포구,199, 서울 월드컵 경기장,201907,1268,867,2135,37.566845,126.896446
마포구,199, 서울 월드컵 경기장,201908,1251,814,2065,37.566845,126.896446
마포구,199, 서울 월드컵 경기장,201909,1302,957,2259,37.566845,126.896446
마포구,199, 서울 월드컵 경기장,201910,1954,1330,3284,37.566845,126.896446
마포구,199, 서울 월드컵 경기장,201911,881,555,1436,37.566845,126.896446
마포구,199, 서울 월드컵 경기장,201912,341,269,610,37.566845,126.896446
마포구,199, 서울 월드컵 경기장,202001,293,206,499,37.566845,126.896446
마포구,199, 서울 월드컵 경기장,202002,286,193,479,37.566845,126.896446
마포구,199, 서울 월드컵 경기장,202003,794,579,1373,37.566845,126.896446
마포구,199, 서울 월드컵 경기장,202004,1071,674,1745,37.566845,126.896446
마포구,199, 서울 월드컵 경기장,202005,1150,836,1986,37.566845,126.896446
마포구,199, 서울 월드컵 경기장,202006,1280,835,2115,37.566845,126.896446
영등포구,200, 국회의원회관,201901,279,296,575,37.528416,126.913918
영등포구,200, 국회의원회관,201902,229,228,457,37.528416,126.913918
영등포구,200, 국회의원회관,201903,458,429,887,37.528416,126.913918
영등포구,200, 국회의원회관,201904,816,832,1648,37.528416,126.913918
영등포구,200, 국회의원회관,201905,859,863,1722,37.528416,126.913918
영등포구,200, 국회의원회관,201906,852,809,1661,37.528416,126.913918
영등포구,200, 국회의원회관,201907,900,896,1796,37.528416,126.913918
영등포구,200, 국회의원회관,201908,805,785,1590,37.528416,126.913918
영등포구,200, 국회의원회관,201909,857,857,1714,37.528416,126.913918
영등포구,200, 국회의원회관,201910,969,971,1940,37.528416,126.913918
영등포구,200, 국회의원회관,201911,619,620,1239,37.528416,126.913918
영등포구,200, 국회의원회관,201912,356,351,707,37.528416,126.913918
영등포구,200, 국회의원회관,202001,312,306,618,37.528416,126.913918
영등포구,200, 국회의원회관,202002,307,311,618,37.528416,126.913918
영등포구,200, 국회의원회관,202003,541,487,1028,37.528416,126.913918
영등포구,200, 국회의원회관,202004,583,564,1147,37.528416,126.913918
영등포구,200, 국회의원회관,202005,638,638,1276,37.528416,126.913918
영등포구,200, 국회의원회관,202006,744,738,1482,37.528416,126.913918
영등포구,201, 진미파라곤 앞,201901,451,434,885,37.531239,126.921333
영등포구,201, 진미파라곤 앞,201902,383,368,751,37.531239,126.921333
영등포구,201, 진미파라곤 앞,201903,711,813,1524,37.531239,126.921333
영등포구,201, 진미파라곤 앞,201904,1990,2202,4192,37.531239,126.921333
영등포구,201, 진미파라곤 앞,201905,1942,1940,3882,37.531239,126.921333
영등포구,201, 진미파라곤 앞,201906,1853,1874,3727,37.531239,126.921333
영등포구,201, 진미파라곤 앞,201907,1720,1645,3365,37.531239,126.921333
영등포구,201, 진미파라곤 앞,201908,1693,1684,3377,37.531239,126.921333
영등포구,201, 진미파라곤 앞,201909,1696,1688,3384,37.531239,126.921333
영등포구,201, 진미파라곤 앞,201910,1922,1946,3868,37.531239,126.921333
영등포구,201, 진미파라곤 앞,201911,1169,1158,2327,37.531239,126.921333
영등포구,201, 진미파라곤 앞,201912,625,625,1250,37.531239,126.921333
영등포구,201, 진미파라곤 앞,202001,607,619,1226,37.531239,126.921333
영등포구,201, 진미파라곤 앞,202002,600,601,1201,37.531239,126.921333
영등포구,201, 진미파라곤 앞,202003,1542,1557,3099,37.531239,126.921333
영등포구,201, 진미파라곤 앞,202004,2106,2102,4208,37.531239,126.921333
영등포구,201, 진미파라곤 앞,202005,2199,2174,4373,37.531239,126.921333
영등포구,201, 진미파라곤 앞,202006,2336,2326,4662,37.531239,126.921333
영등포구,202, 국민일보 앞,201901,803,807,1610,37.528816,126.92453
영등포구,202, 국민일보 앞,201902,729,690,1419,37.528816,126.92453
영등포구,202, 국민일보 앞,201903,1826,1785,3611,37.528816,126.92453
영등포구,202, 국민일보 앞,201904,3224,3487,6711,37.528816,126.92453
영등포구,202, 국민일보 앞,201905,4558,4704,9262,37.528816,126.92453
영등포구,202, 국민일보 앞,201906,4141,4168,8309,37.528816,126.92453
영등포구,202, 국민일보 앞,201907,3754,3706,7460,37.528816,126.92453
영등포구,202, 국민일보 앞,201908,4127,4095,8222,37.528816,126.92453
영등포구,202, 국민일보 앞,201909,4381,4477,8858,37.528816,126.92453
영등포구,202, 국민일보 앞,201910,4720,4858,9578,37.528816,126.92453
영등포구,202, 국민일보 앞,201911,2469,2459,4928,37.528816,126.92453
영등포구,202, 국민일보 앞,201912,1243,1233,2476,37.528816,126.92453
영등포구,202, 국민일보 앞,202001,1046,1083,2129,37.528816,126.92453
영등포구,202, 국민일보 앞,202002,1132,1165,2297,37.528816,126.92453
영등포구,202, 국민일보 앞,202003,3462,3497,6959,37.528816,126.92453
영등포구,202, 국민일보 앞,202004,4491,4493,8984,37.528816,126.92453
영등포구,202, 국민일보 앞,202005,5155,5136,10291,37.528816,126.92453
영등포구,202, 국민일보 앞,202006,4729,4673,9402,37.528816,126.92453
영등포구,203, 국회의사당역 3번출구 옆,201901,776,810,1586,37.528057,126.918701
영등포구,203, 국회의사당역 3번출구 옆,201902,519,537,1056,37.528057,126.918701
영등포구,203, 국회의사당역 3번출구 옆,201903,392,572,964,37.528057,126.918701
영등포구,203, 국회의사당역 3번출구 옆,201904,472,522,994,37.528057,126.918701
영등포구,203, 국회의사당역 3번출구 옆,201905,718,773,1491,37.528057,126.918701
영등포구,203, 국회의사당역 3번출구 옆,201906,1828,1827,3655,37.528057,126.918701
영등포구,203, 국회의사당역 3번출구 옆,201907,2136,2156,4292,37.528057,126.918701
영등포구,203, 국회의사당역 3번출구 옆,201908,1933,1916,3849,37.528057,126.918701
영등포구,203, 국회의사당역 3번출구 옆,201909,2061,2073,4134,37.528057,126.918701
영등포구,203, 국회의사당역 3번출구 옆,201910,2415,2564,4979,37.528057,126.918701
영등포구,203, 국회의사당역 3번출구 옆,201911,1678,1761,3439,37.528057,126.918701
영등포구,203, 국회의사당역 3번출구 옆,201912,1086,1076,2162,37.528057,126.918701
영등포구,203, 국회의사당역 3번출구 옆,202001,955,931,1886,37.528057,126.918701
영등포구,203, 국회의사당역 3번출구 옆,202002,832,884,1716,37.528057,126.918701
영등포구,203, 국회의사당역 3번출구 옆,202003,1397,1387,2784,37.528057,126.918701
영등포구,203, 국회의사당역 3번출구 옆,202004,1770,1789,3559,37.528057,126.918701
영등포구,203, 국회의사당역 3번출구 옆,202005,2015,2009,4024,37.528057,126.918701
영등포구,203, 국회의사당역 3번출구 옆,202006,2316,2288,4604,37.528057,126.918701
영등포구,204, 국회의사당역 5번출구 옆,201901,397,365,762,37.528164,126.917023
영등포구,204, 국회의사당역 5번출구 옆,201902,337,311,648,37.528164,126.917023
영등포구,204, 국회의사당역 5번출구 옆,201903,928,1054,1982,37.528164,126.917023
영등포구,204, 국회의사당역 5번출구 옆,201904,1891,2089,3980,37.528164,126.917023
영등포구,204, 국회의사당역 5번출구 옆,201905,2278,2369,4647,37.528164,126.917023
영등포구,204, 국회의사당역 5번출구 옆,201906,1778,1671,3449,37.528164,126.917023
영등포구,204, 국회의사당역 5번출구 옆,201907,1717,1552,3269,37.528164,126.917023
영등포구,204, 국회의사당역 5번출구 옆,201908,1448,1394,2842,37.528164,126.917023
영등포구,204, 국회의사당역 5번출구 옆,201909,1503,1525,3028,37.528164,126.917023
영등포구,204, 국회의사당역 5번출구 옆,201910,1872,1884,3756,37.528164,126.917023
영등포구,204, 국회의사당역 5번출구 옆,201911,1200,1205,2405,37.528164,126.917023
영등포구,204, 국회의사당역 5번출구 옆,201912,606,612,1218,37.528164,126.917023
영등포구,204, 국회의사당역 5번출구 옆,202001,511,491,1002,37.528164,126.917023
영등포구,204, 국회의사당역 5번출구 옆,202002,519,499,1018,37.528164,126.917023
영등포구,204, 국회의사당역 5번출구 옆,202003,1142,1133,2275,37.528164,126.917023
영등포구,204, 국회의사당역 5번출구 옆,202004,1421,1420,2841,37.528164,126.917023
영등포구,204, 국회의사당역 5번출구 옆,202005,1503,1458,2961,37.528164,126.917023
영등포구,204, 국회의사당역 5번출구 옆,202006,1617,1615,3232,37.528164,126.917023
영등포구,205, 산업은행 앞,201901,500,448,948,37.526264,126.920509
영등포구,205, 산업은행 앞,201902,479,451,930,37.526264,126.920509
영등포구,205, 산업은행 앞,201903,1384,1224,2608,37.526264,126.920509
영등포구,205, 산업은행 앞,201904,2011,2104,4115,37.526264,126.920509
영등포구,205, 산업은행 앞,201905,2502,2508,5010,37.526264,126.920509
영등포구,205, 산업은행 앞,201906,2023,1951,3974,37.526264,126.920509
영등포구,205, 산업은행 앞,201907,1498,1438,2936,37.526264,126.920509
영등포구,205, 산업은행 앞,201908,1496,1343,2839,37.526264,126.920509
영등포구,205, 산업은행 앞,201909,1706,1644,3350,37.526264,126.920509
영등포구,205, 산업은행 앞,201910,1940,1960,3900,37.526264,126.920509
영등포구,205, 산업은행 앞,201911,1137,1144,2281,37.526264,126.920509
영등포구,205, 산업은행 앞,201912,436,431,867,37.526264,126.920509
영등포구,205, 산업은행 앞,202001,450,448,898,37.526264,126.920509
영등포구,205, 산업은행 앞,202002,432,433,865,37.526264,126.920509
영등포구,205, 산업은행 앞,202003,1621,1631,3252,37.526264,126.920509
영등포구,205, 산업은행 앞,202004,1948,1986,3934,37.526264,126.920509
영등포구,205, 산업은행 앞,202005,2827,2832,5659,37.526264,126.920509
영등포구,205, 산업은행 앞,202006,2225,2267,4492,37.526264,126.920509
영등포구,206, KBS 앞,201901,650,606,1256,37.524666,126.918022
영등포구,206, KBS 앞,201902,591,553,1144,37.524666,126.918022
영등포구,206, KBS 앞,201903,1195,1116,2311,37.524666,126.918022
영등포구,206, KBS 앞,201904,2026,1936,3962,37.524666,126.918022
영등포구,206, KBS 앞,201905,2537,2302,4839,37.524666,126.918022
영등포구,206, KBS 앞,201906,2304,2098,4402,37.524666,126.918022
영등포구,206, KBS 앞,201907,2168,1932,4100,37.524666,126.918022
영등포구,206, KBS 앞,201908,2258,1999,4257,37.524666,126.918022
영등포구,206, KBS 앞,201909,2411,2147,4558,37.524666,126.918022
영등포구,206, KBS 앞,201910,2831,2666,5497,37.524666,126.918022
영등포구,206, KBS 앞,201911,1832,1690,3522,37.524666,126.918022
영등포구,206, KBS 앞,201912,1104,976,2080,37.524666,126.918022
영등포구,206, KBS 앞,202001,931,825,1756,37.524666,126.918022
영등포구,206, KBS 앞,202002,929,785,1714,37.524666,126.918022
영등포구,206, KBS 앞,202003,2155,1891,4046,37.524666,126.918022
영등포구,206, KBS 앞,202004,2738,2627,5365,37.524666,126.918022
영등포구,206, KBS 앞,202005,2712,2620,5332,37.524666,126.918022
영등포구,206, KBS 앞,202006,2705,2554,5259,37.524666,126.918022
영등포구,207, 여의나루역 1번출구 앞,201901,1162,1003,2165,37.526989,126.932098
영등포구,207, 여의나루역 1번출구 앞,201902,1583,1574,3157,37.526989,126.932098
영등포구,207, 여의나루역 1번출구 앞,201903,4572,4589,9161,37.526989,126.932098
영등포구,207, 여의나루역 1번출구 앞,201904,9996,9463,19459,37.526989,126.932098
영등포구,207, 여의나루역 1번출구 앞,201905,16080,14856,30936,37.526989,126.932098
영등포구,207, 여의나루역 1번출구 앞,201906,11938,11687,23625,37.526989,126.932098
영등포구,207, 여의나루역 1번출구 앞,201907,10304,9823,20127,37.526989,126.932098
영등포구,207, 여의나루역 1번출구 앞,201908,13302,13055,26357,37.526989,126.932098
영등포구,207, 여의나루역 1번출구 앞,201909,14025,13716,27741,37.526989,126.932098
영등포구,207, 여의나루역 1번출구 앞,201910,12345,12239,24584,37.526989,126.932098
영등포구,207, 여의나루역 1번출구 앞,201911,5112,4643,9755,37.526989,126.932098
영등포구,207, 여의나루역 1번출구 앞,201912,1909,1677,3586,37.526989,126.932098
영등포구,207, 여의나루역 1번출구 앞,202001,2050,1824,3874,37.526989,126.932098
영등포구,207, 여의나루역 1번출구 앞,202002,3019,2658,5677,37.526989,126.932098
영등포구,207, 여의나루역 1번출구 앞,202003,15080,15781,30861,37.526989,126.932098
영등포구,207, 여의나루역 1번출구 앞,202004,16546,17062,33608,37.526989,126.932098
영등포구,207, 여의나루역 1번출구 앞,202005,20641,21073,41714,37.526989,126.932098
영등포구,207, 여의나루역 1번출구 앞,202006,16167,16134,32301,37.526989,126.932098
영등포구,209, 유진투자증권빌딩 앞,201901,499,535,1034,37.524612,126.927834
영등포구,209, 유진투자증권빌딩 앞,201902,415,480,895,37.524612,126.927834
영등포구,209, 유진투자증권빌딩 앞,201903,743,880,1623,37.524612,126.927834
영등포구,209, 유진투자증권빌딩 앞,201904,1183,1267,2450,37.524612,126.927834
영등포구,209, 유진투자증권빌딩 앞,201905,1560,1588,3148,37.524612,126.927834
영등포구,209, 유진투자증권빌딩 앞,201906,1592,1569,3161,37.524612,126.927834
영등포구,209, 유진투자증권빌딩 앞,201907,1601,1614,3215,37.524612,126.927834
영등포구,209, 유진투자증권빌딩 앞,201908,1391,1482,2873,37.524612,126.927834
영등포구,209, 유진투자증권빌딩 앞,201909,221,233,454,37.524612,126.927834
영등포구,209, 유진투자증권빌딩 앞,201910,306,324,630,37.524612,126.927834
영등포구,209, 유진투자증권빌딩 앞,201911,825,845,1670,37.524612,126.927834
영등포구,209, 유진투자증권빌딩 앞,201912,631,641,1272,37.524612,126.927834
영등포구,209, 유진투자증권빌딩 앞,202001,610,588,1198,37.524612,126.927834
영등포구,209, 유진투자증권빌딩 앞,202002,476,499,975,37.524612,126.927834
영등포구,209, 유진투자증권빌딩 앞,202003,969,939,1908,37.524612,126.927834
영등포구,209, 유진투자증권빌딩 앞,202004,1266,1270,2536,37.524612,126.927834
영등포구,209, 유진투자증권빌딩 앞,202005,1452,1471,2923,37.524612,126.927834
영등포구,209, 유진투자증권빌딩 앞,202006,1697,1695,3392,37.524612,126.927834
영등포구,210, IFC몰,201901,1189,1113,2302,37.526066,126.925537
영등포구,210, IFC몰,201902,1007,1021,2028,37.526066,126.925537
영등포구,210, IFC몰,201903,2068,2202,4270,37.526066,126.925537
영등포구,210, IFC몰,201904,4110,4239,8349,37.526066,126.925537
영등포구,210, IFC몰,201905,5857,5900,11757,37.526066,126.925537
영등포구,210, IFC몰,201906,5633,5697,11330,37.526066,126.925537
영등포구,210, IFC몰,201907,4565,4599,9164,37.526066,126.925537
영등포구,210, IFC몰,201908,4691,4748,9439,37.526066,126.925537
영등포구,210, IFC몰,201909,6056,6161,12217,37.526066,126.925537
영등포구,210, IFC몰,201910,6684,6853,13537,37.526066,126.925537
영등포구,210, IFC몰,201911,3502,3559,7061,37.526066,126.925537
영등포구,210, IFC몰,201912,1704,1723,3427,37.526066,126.925537
영등포구,210, IFC몰,202001,1507,1570,3077,37.526066,126.925537
영등포구,210, IFC몰,202002,1400,1474,2874,37.526066,126.925537
영등포구,210, IFC몰,202003,4005,4112,8117,37.526066,126.925537
영등포구,210, IFC몰,202004,5691,5730,11421,37.526066,126.925537
영등포구,210, IFC몰,202005,6641,6660,13301,37.526066,126.925537
영등포구,210, IFC몰,202006,6265,6309,12574,37.526066,126.925537
영등포구,211, 여의도역 4번출구 옆,201901,954,951,1905,37.522228,126.924637
영등포구,211, 여의도역 4번출구 옆,201902,758,716,1474,37.522228,126.924637
영등포구,211, 여의도역 4번출구 옆,201903,1626,1465,3091,37.522228,126.924637
영등포구,211, 여의도역 4번출구 옆,201904,2768,2387,5155,37.522228,126.924637
영등포구,211, 여의도역 4번출구 옆,201905,3306,2944,6250,37.522228,126.924637
영등포구,211, 여의도역 4번출구 옆,201906,3187,2946,6133,37.522228,126.924637
영등포구,211, 여의도역 4번출구 옆,201907,3210,2978,6188,37.522228,126.924637
영등포구,211, 여의도역 4번출구 옆,201908,3010,2857,5867,37.522228,126.924637
영등포구,211, 여의도역 4번출구 옆,201909,3034,2848,5882,37.522228,126.924637
영등포구,211, 여의도역 4번출구 옆,201910,3439,3179,6618,37.522228,126.924637
영등포구,211, 여의도역 4번출구 옆,201911,2601,2360,4961,37.522228,126.924637
영등포구,211, 여의도역 4번출구 옆,201912,1417,1367,2784,37.522228,126.924637
영등포구,211, 여의도역 4번출구 옆,202001,1354,1295,2649,37.522228,126.924637
영등포구,211, 여의도역 4번출구 옆,202002,1110,1031,2141,37.522228,126.924637
영등포구,211, 여의도역 4번출구 옆,202003,2047,1876,3923,37.522228,126.924637
영등포구,211, 여의도역 4번출구 옆,202004,2930,2609,5539,37.522228,126.924637
영등포구,211, 여의도역 4번출구 옆,202005,3205,3020,6225,37.522228,126.924637
영등포구,211, 여의도역 4번출구 옆,202006,3474,3225,6699,37.522228,126.924637
영등포구,212, 여의도역 1번출구 옆,201901,1080,508,1588,37.521362,126.923462
영등포구,212, 여의도역 1번출구 옆,201902,824,393,1217,37.521362,126.923462
영등포구,212, 여의도역 1번출구 옆,201903,1767,828,2595,37.521362,126.923462
영등포구,212, 여의도역 1번출구 옆,201904,2884,1246,4130,37.521362,126.923462
영등포구,212, 여의도역 1번출구 옆,201905,4043,1593,5636,37.521362,126.923462
영등포구,212, 여의도역 1번출구 옆,201906,2959,1453,4412,37.521362,126.923462
영등포구,212, 여의도역 1번출구 옆,201907,3220,1604,4824,37.521362,126.923462
영등포구,212, 여의도역 1번출구 옆,201908,2961,1424,4385,37.521362,126.923462
영등포구,212, 여의도역 1번출구 옆,201909,2702,1436,4138,37.521362,126.923462
영등포구,212, 여의도역 1번출구 옆,201910,3181,1533,4714,37.521362,126.923462
영등포구,212, 여의도역 1번출구 옆,201911,2158,1020,3178,37.521362,126.923462
영등포구,212, 여의도역 1번출구 옆,201912,994,582,1576,37.521362,126.923462
영등포구,212, 여의도역 1번출구 옆,202001,915,489,1404,37.521362,126.923462
영등포구,212, 여의도역 1번출구 옆,202002,1047,498,1545,37.521362,126.923462
영등포구,212, 여의도역 1번출구 옆,202003,1876,928,2804,37.521362,126.923462
영등포구,212, 여의도역 1번출구 옆,202004,2116,1228,3344,37.521362,126.923462
영등포구,212, 여의도역 1번출구 옆,202005,1988,1215,3203,37.521362,126.923462
영등포구,212, 여의도역 1번출구 옆,202006,2298,1339,3637,37.521362,126.923462
영등포구,213, KT앞,201901,88,78,166,37.521908,126.918953
영등포구,213, KT앞,201902,504,400,904,37.521908,126.918953
영등포구,213, KT앞,201903,965,863,1828,37.521908,126.918953
영등포구,213, KT앞,201904,1737,1492,3229,37.521908,126.918953
영등포구,213, KT앞,201905,2081,1949,4030,37.521908,126.918953
영등포구,213, KT앞,201906,1888,1745,3633,37.521908,126.918953
영등포구,213, KT앞,201907,2019,1760,3779,37.521908,126.918953
영등포구,213, KT앞,201908,1921,1733,3654,37.521908,126.918953
영등포구,213, KT앞,201909,1822,1711,3533,37.521908,126.918953
영등포구,213, KT앞,201910,2162,2078,4240,37.521908,126.918953
영등포구,213, KT앞,201911,1460,1331,2791,37.521908,126.918953
영등포구,213, KT앞,201912,828,757,1585,37.521908,126.918953
영등포구,213, KT앞,202001,785,712,1497,37.521908,126.918953
영등포구,213, KT앞,202002,705,680,1385,37.521908,126.918953
영등포구,213, KT앞,202003,1384,1271,2655,37.521908,126.918953
영등포구,213, KT앞,202004,1735,1666,3401,37.521908,126.918953
영등포구,213, KT앞,202005,1792,1673,3465,37.521908,126.918953
영등포구,213, KT앞,202006,1889,1681,3570,37.521908,126.918953
영등포구,214, 금융감독원 앞,201901,858,823,1681,37.523022,126.920837
영등포구,214, 금융감독원 앞,201902,484,341,825,37.523022,126.920837
영등포구,214, 금융감독원 앞,201903,754,556,1310,37.523022,126.920837
영등포구,214, 금융감독원 앞,201904,1158,981,2139,37.523022,126.920837
영등포구,214, 금융감독원 앞,201905,1409,1122,2531,37.523022,126.920837
영등포구,214, 금융감독원 앞,201906,1395,1087,2482,37.523022,126.920837
영등포구,214, 금융감독원 앞,201907,1494,1169,2663,37.523022,126.920837
영등포구,214, 금융감독원 앞,201908,1403,1110,2513,37.523022,126.920837
영등포구,214, 금융감독원 앞,201909,1366,1208,2574,37.523022,126.920837
영등포구,214, 금융감독원 앞,201910,1533,1309,2842,37.523022,126.920837
영등포구,214, 금융감독원 앞,201911,1140,889,2029,37.523022,126.920837
영등포구,214, 금융감독원 앞,201912,674,505,1179,37.523022,126.920837
영등포구,214, 금융감독원 앞,202001,579,445,1024,37.523022,126.920837
영등포구,214, 금융감독원 앞,202002,557,462,1019,37.523022,126.920837
영등포구,214, 금융감독원 앞,202003,1042,809,1851,37.523022,126.920837
영등포구,214, 금융감독원 앞,202004,1212,1080,2292,37.523022,126.920837
영등포구,214, 금융감독원 앞,202005,1350,1316,2666,37.523022,126.920837
영등포구,214, 금융감독원 앞,202006,1642,1500,3142,37.523022,126.920837
영등포구,215, 여의도고교 앞,201901,135,145,280,37.524837,126.934906
영등포구,215, 여의도고교 앞,201902,119,136,255,37.524837,126.934906
영등포구,215, 여의도고교 앞,201903,294,386,680,37.524837,126.934906
영등포구,215, 여의도고교 앞,201904,1094,1327,2421,37.524837,126.934906
영등포구,215, 여의도고교 앞,201905,1620,1782,3402,37.524837,126.934906
영등포구,215, 여의도고교 앞,201906,1337,1448,2785,37.524837,126.934906
영등포구,215, 여의도고교 앞,201907,1075,1080,2155,37.524837,126.934906
영등포구,215, 여의도고교 앞,201908,1558,1703,3261,37.524837,126.934906
영등포구,215, 여의도고교 앞,201909,1626,1707,3333,37.524837,126.934906
영등포구,215, 여의도고교 앞,201910,1393,1401,2794,37.524837,126.934906
영등포구,215, 여의도고교 앞,201911,665,657,1322,37.524837,126.934906
영등포구,215, 여의도고교 앞,201912,252,250,502,37.524837,126.934906
영등포구,215, 여의도고교 앞,202001,205,212,417,37.524837,126.934906
영등포구,215, 여의도고교 앞,202002,316,320,636,37.524837,126.934906
영등포구,215, 여의도고교 앞,202003,1480,1555,3035,37.524837,126.934906
영등포구,215, 여의도고교 앞,202004,1691,1756,3447,37.524837,126.934906
영등포구,215, 여의도고교 앞,202005,2414,2453,4867,37.524837,126.934906
영등포구,215, 여의도고교 앞,202006,1739,1788,3527,37.524837,126.934906
영등포구,216, 삼부아파트1동 앞,201901,511,558,1069,#N/A,#N/A
영등포구,216, 삼부아파트1동 앞,201902,373,397,770,#N/A,#N/A
영등포구,216, 삼부아파트1동 앞,201903,715,774,1489,#N/A,#N/A
영등포구,216, 삼부아파트1동 앞,201904,1034,1020,2054,#N/A,#N/A
영등포구,216, 삼부아파트1동 앞,201905,1551,1542,3093,#N/A,#N/A
영등포구,216, 삼부아파트1동 앞,201906,1555,1570,3125,#N/A,#N/A
영등포구,216, 삼부아파트1동 앞,201907,1593,1594,3187,#N/A,#N/A
영등포구,216, 삼부아파트1동 앞,201908,1516,1563,3079,#N/A,#N/A
영등포구,216, 삼부아파트1동 앞,201909,1379,1388,2767,#N/A,#N/A
영등포구,216, 삼부아파트1동 앞,201910,1529,1570,3099,#N/A,#N/A
영등포구,216, 삼부아파트1동 앞,201911,1069,1092,2161,#N/A,#N/A
영등포구,216, 삼부아파트1동 앞,201912,650,661,1311,#N/A,#N/A
영등포구,216, 삼부아파트1동 앞,202001,571,571,1142,#N/A,#N/A
영등포구,216, 삼부아파트1동 앞,202002,529,514,1043,#N/A,#N/A
영등포구,216, 삼부아파트1동 앞,202003,1177,1178,2355,#N/A,#N/A
영등포구,216, 삼부아파트1동 앞,202004,1233,1241,2474,#N/A,#N/A
영등포구,216, 삼부아파트1동 앞,202005,1541,1536,3077,#N/A,#N/A
영등포구,216, 삼부아파트1동 앞,202006,1468,1473,2941,#N/A,#N/A
영등포구,217, NH농협은행 앞,201901,682,768,1450,37.522079,126.930367
영등포구,217, NH농협은행 앞,201902,435,514,949,37.522079,126.930367
영등포구,217, NH농협은행 앞,201903,859,979,1838,37.522079,126.930367
영등포구,217, NH농협은행 앞,201904,1408,1452,2860,37.522079,126.930367
영등포구,217, NH농협은행 앞,201905,1926,1957,3883,37.522079,126.930367
영등포구,217, NH농협은행 앞,201906,1629,1740,3369,37.522079,126.930367
영등포구,217, NH농협은행 앞,201907,1995,2039,4034,37.522079,126.930367
영등포구,217, NH농협은행 앞,201908,1869,1918,3787,37.522079,126.930367
영등포구,217, NH농협은행 앞,201909,1663,1894,3557,37.522079,126.930367
영등포구,217, NH농협은행 앞,201910,2153,2231,4384,37.522079,126.930367
영등포구,217, NH농협은행 앞,201911,1462,1573,3035,37.522079,126.930367
영등포구,217, NH농협은행 앞,201912,822,856,1678,37.522079,126.930367
영등포구,217, NH농협은행 앞,202001,814,826,1640,37.522079,126.930367
영등포구,217, NH농협은행 앞,202002,491,558,1049,37.522079,126.930367
영등포구,217, NH농협은행 앞,202003,367,375,742,37.522079,126.930367
영등포구,217, NH농협은행 앞,202004,1606,1601,3207,37.522079,126.930367
영등포구,217, NH농협은행 앞,202005,491,494,985,37.522079,126.930367
영등포구,217, NH농협은행 앞,202006,1973,1967,3940,37.522079,126.930367
영등포구,218, 증권거래소 앞,201901,322,266,588,37.523277,126.929237
영등포구,218, 증권거래소 앞,201902,262,182,444,37.523277,126.929237
영등포구,218, 증권거래소 앞,201903,460,341,801,37.523277,126.929237
영등포구,218, 증권거래소 앞,201904,769,647,1416,37.523277,126.929237
영등포구,218, 증권거래소 앞,201905,889,725,1614,37.523277,126.929237
영등포구,218, 증권거래소 앞,201906,917,744,1661,37.523277,126.929237
영등포구,218, 증권거래소 앞,201907,930,818,1748,37.523277,126.929237
영등포구,218, 증권거래소 앞,201908,908,754,1662,37.523277,126.929237
영등포구,218, 증권거래소 앞,201909,1186,1085,2271,37.523277,126.929237
영등포구,218, 증권거래소 앞,201910,1403,1258,2661,37.523277,126.929237
영등포구,218, 증권거래소 앞,201911,905,749,1654,37.523277,126.929237
영등포구,218, 증권거래소 앞,201912,482,442,924,37.523277,126.929237
영등포구,218, 증권거래소 앞,202001,420,418,838,37.523277,126.929237
영등포구,218, 증권거래소 앞,202002,450,470,920,37.523277,126.929237
영등포구,218, 증권거래소 앞,202003,1098,999,2097,37.523277,126.929237
영등포구,218, 증권거래소 앞,202004,994,855,1849,37.523277,126.929237
영등포구,218, 증권거래소 앞,202005,1478,1371,2849,37.523277,126.929237
영등포구,218, 증권거래소 앞,202006,1146,1088,2234,37.523277,126.929237
영등포구,219, 롯데캐슬엠파이어 옆,201901,435,433,868,37.520695,126.925835
영등포구,219, 롯데캐슬엠파이어 옆,201902,327,299,626,37.520695,126.925835
영등포구,219, 롯데캐슬엠파이어 옆,201903,597,591,1188,37.520695,126.925835
영등포구,219, 롯데캐슬엠파이어 옆,201904,953,924,1877,37.520695,126.925835
영등포구,219, 롯데캐슬엠파이어 옆,201905,1201,1140,2341,37.520695,126.925835
영등포구,219, 롯데캐슬엠파이어 옆,201906,1237,1230,2467,37.520695,126.925835
영등포구,219, 롯데캐슬엠파이어 옆,201907,1301,1297,2598,37.520695,126.925835
영등포구,219, 롯데캐슬엠파이어 옆,201908,1268,1264,2532,37.520695,126.925835
영등포구,219, 롯데캐슬엠파이어 옆,201909,1175,1168,2343,37.520695,126.925835
영등포구,219, 롯데캐슬엠파이어 옆,201910,1295,1300,2595,37.520695,126.925835
영등포구,219, 롯데캐슬엠파이어 옆,201911,1008,1005,2013,37.520695,126.925835
영등포구,219, 롯데캐슬엠파이어 옆,201912,591,590,1181,37.520695,126.925835
영등포구,219, 롯데캐슬엠파이어 옆,202001,497,491,988,37.520695,126.925835
영등포구,219, 롯데캐슬엠파이어 옆,202002,502,499,1001,37.520695,126.925835
영등포구,219, 롯데캐슬엠파이어 옆,202003,885,876,1761,37.520695,126.925835
영등포구,219, 롯데캐슬엠파이어 옆,202004,1188,1185,2373,37.520695,126.925835
영등포구,219, 롯데캐슬엠파이어 옆,202005,1368,1369,2737,37.520695,126.925835
영등포구,219, 롯데캐슬엠파이어 옆,202006,1465,1431,2896,37.520695,126.925835
영등포구,220, 미성아파트 A동 앞,201901,454,313,767,37.519363,126.926048
영등포구,220, 미성아파트 A동 앞,201902,413,266,679,37.519363,126.926048
영등포구,220, 미성아파트 A동 앞,201903,625,452,1077,37.519363,126.926048
영등포구,220, 미성아파트 A동 앞,201904,1194,757,1951,37.519363,126.926048
영등포구,220, 미성아파트 A동 앞,201905,1729,1163,2892,37.519363,126.926048
영등포구,220, 미성아파트 A동 앞,201906,1291,1057,2348,37.519363,126.926048
영등포구,220, 미성아파트 A동 앞,201907,1230,954,2184,37.519363,126.926048
영등포구,220, 미성아파트 A동 앞,201908,1331,1100,2431,37.519363,126.926048
영등포구,220, 미성아파트 A동 앞,201909,1123,977,2100,37.519363,126.926048
영등포구,220, 미성아파트 A동 앞,201910,1440,1177,2617,37.519363,126.926048
영등포구,220, 미성아파트 A동 앞,201911,930,704,1634,37.519363,126.926048
영등포구,220, 미성아파트 A동 앞,201912,407,366,773,37.519363,126.926048
영등포구,220, 미성아파트 A동 앞,202001,375,285,660,37.519363,126.926048
영등포구,220, 미성아파트 A동 앞,202002,489,389,878,37.519363,126.926048
영등포구,220, 미성아파트 A동 앞,202003,1115,836,1951,37.519363,126.926048
영등포구,220, 미성아파트 A동 앞,202004,1654,1166,2820,37.519363,126.926048
영등포구,220, 미성아파트 A동 앞,202005,1378,1118,2496,37.519363,126.926048
영등포구,220, 미성아파트 A동 앞,202006,1600,1203,2803,37.519363,126.926048
영등포구,221, 여의도초교 앞,201901,415,454,869,37.522675,126.93779
영등포구,221, 여의도초교 앞,201902,383,432,815,37.522675,126.93779
영등포구,221, 여의도초교 앞,201903,772,806,1578,37.522675,126.93779
영등포구,221, 여의도초교 앞,201904,1394,1683,3077,37.522675,126.93779
영등포구,221, 여의도초교 앞,201905,1931,2109,4040,37.522675,126.93779
영등포구,221, 여의도초교 앞,201906,2014,2062,4076,37.522675,126.93779
영등포구,221, 여의도초교 앞,201907,1853,1842,3695,37.522675,126.93779
영등포구,221, 여의도초교 앞,201908,2045,2166,4211,37.522675,126.93779
영등포구,221, 여의도초교 앞,201909,2075,2085,4160,37.522675,126.93779
영등포구,221, 여의도초교 앞,201910,1931,2016,3947,37.522675,126.93779
영등포구,221, 여의도초교 앞,201911,1031,1067,2098,37.522675,126.93779
영등포구,221, 여의도초교 앞,201912,593,599,1192,37.522675,126.93779
영등포구,221, 여의도초교 앞,202001,565,595,1160,37.522675,126.93779
영등포구,221, 여의도초교 앞,202002,611,643,1254,37.522675,126.93779
영등포구,221, 여의도초교 앞,202003,2037,2172,4209,37.522675,126.93779
영등포구,221, 여의도초교 앞,202004,2651,2712,5363,37.522675,126.93779
영등포구,221, 여의도초교 앞,202005,3272,3336,6608,37.522675,126.93779
영등포구,221, 여의도초교 앞,202006,2804,2859,5663,37.522675,126.93779
영등포구,222, 시범아파트버스정류장 옆,201901,837,976,1813,37.519436,126.937599
영등포구,222, 시범아파트버스정류장 옆,201902,679,766,1445,37.519436,126.937599
영등포구,222, 시범아파트버스정류장 옆,201903,1405,1648,3053,37.519436,126.937599
영등포구,222, 시범아파트버스정류장 옆,201904,2506,2785,5291,37.519436,126.937599
영등포구,222, 시범아파트버스정류장 옆,201905,3436,3670,7106,37.519436,126.937599
영등포구,222, 시범아파트버스정류장 옆,201906,3615,3687,7302,37.519436,126.937599
영등포구,222, 시범아파트버스정류장 옆,201907,3326,3552,6878,37.519436,126.937599
영등포구,222, 시범아파트버스정류장 옆,201908,3206,3363,6569,37.519436,126.937599
영등포구,222, 시범아파트버스정류장 옆,201909,2948,2966,5914,37.519436,126.937599
영등포구,222, 시범아파트버스정류장 옆,201910,3505,3924,7429,37.519436,126.937599
영등포구,222, 시범아파트버스정류장 옆,201911,2430,2741,5171,37.519436,126.937599
영등포구,222, 시범아파트버스정류장 옆,201912,1394,1550,2944,37.519436,126.937599
영등포구,222, 시범아파트버스정류장 옆,202001,1214,1413,2627,37.519436,126.937599
영등포구,222, 시범아파트버스정류장 옆,202002,1200,1341,2541,37.519436,126.937599
영등포구,222, 시범아파트버스정류장 옆,202003,2422,2610,5032,37.519436,126.937599
영등포구,222, 시범아파트버스정류장 옆,202004,3463,3764,7227,37.519436,126.937599
영등포구,222, 시범아파트버스정류장 옆,202005,3662,3980,7642,37.519436,126.937599
영등포구,222, 시범아파트버스정류장 옆,202006,3848,4154,8002,37.519436,126.937599
영등포구,223, 진주아파트상가 앞,201901,511,433,944,37.519314,126.933167
영등포구,223, 진주아파트상가 앞,201902,409,366,775,37.519314,126.933167
영등포구,223, 진주아파트상가 앞,201903,674,669,1343,37.519314,126.933167
영등포구,223, 진주아파트상가 앞,201904,1037,968,2005,37.519314,126.933167
영등포구,223, 진주아파트상가 앞,201905,1443,1297,2740,37.519314,126.933167
영등포구,223, 진주아파트상가 앞,201906,1508,1432,2940,37.519314,126.933167
영등포구,223, 진주아파트상가 앞,201907,1614,1495,3109,37.519314,126.933167
영등포구,223, 진주아파트상가 앞,201908,1542,1479,3021,37.519314,126.933167
영등포구,223, 진주아파트상가 앞,201909,1317,1275,2592,37.519314,126.933167
영등포구,223, 진주아파트상가 앞,201910,1825,1770,3595,37.519314,126.933167
영등포구,223, 진주아파트상가 앞,201911,1145,1117,2262,37.519314,126.933167
영등포구,223, 진주아파트상가 앞,201912,623,629,1252,37.519314,126.933167
영등포구,223, 진주아파트상가 앞,202001,654,691,1345,37.519314,126.933167
영등포구,223, 진주아파트상가 앞,202002,550,528,1078,37.519314,126.933167
영등포구,223, 진주아파트상가 앞,202003,934,901,1835,37.519314,126.933167
영등포구,223, 진주아파트상가 앞,202004,1489,1401,2890,37.519314,126.933167
영등포구,223, 진주아파트상가 앞,202005,1483,1424,2907,37.519314,126.933167
영등포구,223, 진주아파트상가 앞,202006,1682,1619,3301,37.519314,126.933167
영등포구,224, 롯데캐슬 앞,201901,621,680,1301,37.520088,126.932365
영등포구,224, 롯데캐슬 앞,201902,506,544,1050,37.520088,126.932365
영등포구,224, 롯데캐슬 앞,201903,926,914,1840,37.520088,126.932365
영등포구,224, 롯데캐슬 앞,201904,1251,1225,2476,37.520088,126.932365
영등포구,224, 롯데캐슬 앞,201905,1868,1774,3642,37.520088,126.932365
영등포구,224, 롯데캐슬 앞,201906,1901,1856,3757,37.520088,126.932365
영등포구,224, 롯데캐슬 앞,201907,1945,1870,3815,37.520088,126.932365
영등포구,224, 롯데캐슬 앞,201908,2005,2001,4006,37.520088,126.932365
영등포구,224, 롯데캐슬 앞,201909,1484,1616,3100,37.520088,126.932365
영등포구,224, 롯데캐슬 앞,201910,2349,2309,4658,37.520088,126.932365
영등포구,224, 롯데캐슬 앞,201911,1432,1458,2890,37.520088,126.932365
영등포구,224, 롯데캐슬 앞,201912,845,874,1719,37.520088,126.932365
영등포구,224, 롯데캐슬 앞,202001,718,751,1469,37.520088,126.932365
영등포구,224, 롯데캐슬 앞,202002,713,716,1429,37.520088,126.932365
영등포구,224, 롯데캐슬 앞,202003,1398,1360,2758,37.520088,126.932365
영등포구,224, 롯데캐슬 앞,202004,1910,1844,3754,37.520088,126.932365
영등포구,224, 롯데캐슬 앞,202005,2449,2431,4880,37.520088,126.932365
영등포구,224, 롯데캐슬 앞,202006,2187,2140,4327,37.520088,126.932365
영등포구,225, 앙카라공원 앞,201901,418,310,728,37.517368,126.929253
영등포구,225, 앙카라공원 앞,201902,346,253,599,37.517368,126.929253
영등포구,225, 앙카라공원 앞,201903,757,568,1325,37.517368,126.929253
영등포구,225, 앙카라공원 앞,201904,1004,714,1718,37.517368,126.929253
영등포구,225, 앙카라공원 앞,201905,1394,931,2325,37.517368,126.929253
영등포구,225, 앙카라공원 앞,201906,1141,930,2071,37.517368,126.929253
영등포구,225, 앙카라공원 앞,201907,1250,959,2209,37.517368,126.929253
영등포구,225, 앙카라공원 앞,201908,1251,1046,2297,37.517368,126.929253
영등포구,225, 앙카라공원 앞,201909,1286,1027,2313,37.517368,126.929253
영등포구,225, 앙카라공원 앞,201910,1440,1070,2510,37.517368,126.929253
영등포구,225, 앙카라공원 앞,201911,1036,813,1849,37.517368,126.929253
영등포구,225, 앙카라공원 앞,201912,529,491,1020,37.517368,126.929253
영등포구,225, 앙카라공원 앞,202001,495,456,951,37.517368,126.929253
영등포구,225, 앙카라공원 앞,202002,511,405,916,37.517368,126.929253
영등포구,225, 앙카라공원 앞,202003,1014,840,1854,37.517368,126.929253
영등포구,225, 앙카라공원 앞,202004,1770,1277,3047,37.517368,126.929253
영등포구,225, 앙카라공원 앞,202005,1567,1227,2794,37.517368,126.929253
영등포구,225, 앙카라공원 앞,202006,1806,1406,3212,37.517368,126.929253
영등포구,226, 샛강역 1번출구 앞,201901,478,376,854,37.517765,126.928413
영등포구,226, 샛강역 1번출구 앞,201902,433,386,819,37.517765,126.928413
영등포구,226, 샛강역 1번출구 앞,201903,768,740,1508,37.517765,126.928413
영등포구,226, 샛강역 1번출구 앞,201904,1302,1111,2413,37.517765,126.928413
영등포구,226, 샛강역 1번출구 앞,201905,1911,1527,3438,37.517765,126.928413
영등포구,226, 샛강역 1번출구 앞,201906,1804,1442,3246,37.517765,126.928413
영등포구,226, 샛강역 1번출구 앞,201907,1598,1226,2824,37.517765,126.928413
영등포구,226, 샛강역 1번출구 앞,201908,1580,1170,2750,37.517765,126.928413
영등포구,226, 샛강역 1번출구 앞,201909,1510,1116,2626,37.517765,126.928413
영등포구,226, 샛강역 1번출구 앞,201910,1855,1503,3358,37.517765,126.928413
영등포구,226, 샛강역 1번출구 앞,201911,1245,986,2231,37.517765,126.928413
영등포구,226, 샛강역 1번출구 앞,201912,705,621,1326,37.517765,126.928413
영등포구,226, 샛강역 1번출구 앞,202001,616,553,1169,37.517765,126.928413
영등포구,226, 샛강역 1번출구 앞,202002,654,541,1195,37.517765,126.928413
영등포구,226, 샛강역 1번출구 앞,202003,1453,1221,2674,37.517765,126.928413
영등포구,226, 샛강역 1번출구 앞,202004,2087,1646,3733,37.517765,126.928413
영등포구,226, 샛강역 1번출구 앞,202005,2001,1572,3573,37.517765,126.928413
영등포구,226, 샛강역 1번출구 앞,202006,2205,1720,3925,37.517765,126.928413
영등포구,227, 양평2나들목 보행통로 입구,201901,241,321,562,37.544666,126.888359
영등포구,227, 양평2나들목 보행통로 입구,201902,265,338,603,37.544666,126.888359
영등포구,227, 양평2나들목 보행통로 입구,201903,536,614,1150,37.544666,126.888359
영등포구,227, 양평2나들목 보행통로 입구,201904,1135,1332,2467,37.544666,126.888359
영등포구,227, 양평2나들목 보행통로 입구,201905,1805,2233,4038,37.544666,126.888359
영등포구,227, 양평2나들목 보행통로 입구,201906,2007,2399,4406,37.544666,126.888359
영등포구,227, 양평2나들목 보행통로 입구,201907,1779,2236,4015,37.544666,126.888359
영등포구,227, 양평2나들목 보행통로 입구,201908,2054,2399,4453,37.544666,126.888359
영등포구,227, 양평2나들목 보행통로 입구,201909,2056,2449,4505,37.544666,126.888359
영등포구,227, 양평2나들목 보행통로 입구,201910,2108,2578,4686,37.544666,126.888359
영등포구,227, 양평2나들목 보행통로 입구,201911,811,1079,1890,37.544666,126.888359
영등포구,227, 양평2나들목 보행통로 입구,201912,365,540,905,37.544666,126.888359
영등포구,227, 양평2나들목 보행통로 입구,202001,408,540,948,37.544666,126.888359
영등포구,227, 양평2나들목 보행통로 입구,202002,589,673,1262,37.544666,126.888359
영등포구,227, 양평2나들목 보행통로 입구,202003,2151,2358,4509,37.544666,126.888359
영등포구,227, 양평2나들목 보행통로 입구,202004,3008,3333,6341,37.544666,126.888359
영등포구,227, 양평2나들목 보행통로 입구,202005,3757,4037,7794,37.544666,126.888359
영등포구,227, 양평2나들목 보행통로 입구,202006,3561,3847,7408,37.544666,126.888359
영등포구,228, 선유도역 3번출구 앞,201901,510,480,990,37.53846,126.894508
영등포구,228, 선유도역 3번출구 앞,201902,436,446,882,37.53846,126.894508
영등포구,228, 선유도역 3번출구 앞,201903,1041,1092,2133,37.53846,126.894508
영등포구,228, 선유도역 3번출구 앞,201904,2001,2109,4110,37.53846,126.894508
영등포구,228, 선유도역 3번출구 앞,201905,3221,3386,6607,37.53846,126.894508
영등포구,228, 선유도역 3번출구 앞,201906,3361,3391,6752,37.53846,126.894508
영등포구,228, 선유도역 3번출구 앞,201907,3086,3091,6177,37.53846,126.894508
영등포구,228, 선유도역 3번출구 앞,201908,3112,3281,6393,37.53846,126.894508
영등포구,228, 선유도역 3번출구 앞,201909,3249,3427,6676,37.53846,126.894508
영등포구,228, 선유도역 3번출구 앞,201910,3988,4051,8039,37.53846,126.894508
영등포구,228, 선유도역 3번출구 앞,201911,1975,2008,3983,37.53846,126.894508
영등포구,228, 선유도역 3번출구 앞,201912,948,967,1915,37.53846,126.894508
영등포구,228, 선유도역 3번출구 앞,202001,827,814,1641,37.53846,126.894508
영등포구,228, 선유도역 3번출구 앞,202002,1028,1059,2087,37.53846,126.894508
영등포구,228, 선유도역 3번출구 앞,202003,3057,3130,6187,37.53846,126.894508
영등포구,228, 선유도역 3번출구 앞,202004,4412,4453,8865,37.53846,126.894508
영등포구,228, 선유도역 3번출구 앞,202005,4750,4815,9565,37.53846,126.894508
영등포구,228, 선유도역 3번출구 앞,202006,5203,5274,10477,37.53846,126.894508
영등포구,229, 양평1 보행육교 앞,201901,283,292,575,37.535873,126.892181
영등포구,229, 양평1 보행육교 앞,201902,256,251,507,37.535873,126.892181
영등포구,229, 양평1 보행육교 앞,201903,642,668,1310,37.535873,126.892181
영등포구,229, 양평1 보행육교 앞,201904,1175,1211,2386,37.535873,126.892181
영등포구,229, 양평1 보행육교 앞,201905,1830,1829,3659,37.535873,126.892181
영등포구,229, 양평1 보행육교 앞,201906,2020,2026,4046,37.535873,126.892181
영등포구,229, 양평1 보행육교 앞,201907,1709,1718,3427,37.535873,126.892181
영등포구,229, 양평1 보행육교 앞,201908,1615,1585,3200,37.535873,126.892181
영등포구,229, 양평1 보행육교 앞,201909,1846,1851,3697,37.535873,126.892181
영등포구,229, 양평1 보행육교 앞,201910,2055,2085,4140,37.535873,126.892181
영등포구,229, 양평1 보행육교 앞,201911,1218,1213,2431,37.535873,126.892181
영등포구,229, 양평1 보행육교 앞,201912,673,698,1371,37.535873,126.892181
영등포구,229, 양평1 보행육교 앞,202001,616,617,1233,37.535873,126.892181
영등포구,229, 양평1 보행육교 앞,202002,698,717,1415,37.535873,126.892181
영등포구,229, 양평1 보행육교 앞,202003,1762,1796,3558,37.535873,126.892181
영등포구,229, 양평1 보행육교 앞,202004,2609,2630,5239,37.535873,126.892181
영등포구,229, 양평1 보행육교 앞,202005,2571,2629,5200,37.535873,126.892181
영등포구,229, 양평1 보행육교 앞,202006,2798,2799,5597,37.535873,126.892181
영등포구,230, 영등포구청역 1번출구,201901,1223,1274,2497,37.524635,126.896217
영등포구,230, 영등포구청역 1번출구,201902,945,1028,1973,37.524635,126.896217
영등포구,230, 영등포구청역 1번출구,201903,1773,1873,3646,37.524635,126.896217
영등포구,230, 영등포구청역 1번출구,201904,2524,2550,5074,37.524635,126.896217
영등포구,230, 영등포구청역 1번출구,201905,4128,4162,8290,37.524635,126.896217
영등포구,230, 영등포구청역 1번출구,201906,4405,4426,8831,37.524635,126.896217
영등포구,230, 영등포구청역 1번출구,201907,4225,4234,8459,37.524635,126.896217
영등포구,230, 영등포구청역 1번출구,201908,4394,4380,8774,37.524635,126.896217
영등포구,230, 영등포구청역 1번출구,201909,4078,4037,8115,37.524635,126.896217
영등포구,230, 영등포구청역 1번출구,201910,4969,4935,9904,37.524635,126.896217
영등포구,230, 영등포구청역 1번출구,201911,3574,3572,7146,37.524635,126.896217
영등포구,230, 영등포구청역 1번출구,201912,2220,2256,4476,37.524635,126.896217
영등포구,230, 영등포구청역 1번출구,202001,1714,1718,3432,37.524635,126.896217
영등포구,230, 영등포구청역 1번출구,202002,1595,1616,3211,37.524635,126.896217
영등포구,230, 영등포구청역 1번출구,202003,2635,2640,5275,37.524635,126.896217
영등포구,230, 영등포구청역 1번출구,202004,3782,3768,7550,37.524635,126.896217
영등포구,230, 영등포구청역 1번출구,202005,4464,4485,8949,37.524635,126.896217
영등포구,230, 영등포구청역 1번출구,202006,5114,5096,10210,37.524635,126.896217
영등포구,231, 남부고용노동지청 남측,201901,392,383,775,37.524506,126.891823
영등포구,231, 남부고용노동지청 남측,201902,298,293,591,37.524506,126.891823
영등포구,231, 남부고용노동지청 남측,201903,545,517,1062,37.524506,126.891823
영등포구,231, 남부고용노동지청 남측,201904,669,620,1289,37.524506,126.891823
영등포구,231, 남부고용노동지청 남측,201905,1035,998,2033,37.524506,126.891823
영등포구,231, 남부고용노동지청 남측,201906,1132,1086,2218,37.524506,126.891823
영등포구,231, 남부고용노동지청 남측,201907,1142,1122,2264,37.524506,126.891823
영등포구,231, 남부고용노동지청 남측,201908,1247,1194,2441,37.524506,126.891823
영등포구,231, 남부고용노동지청 남측,201909,1062,1014,2076,37.524506,126.891823
영등포구,231, 남부고용노동지청 남측,201910,1257,1222,2479,37.524506,126.891823
영등포구,231, 남부고용노동지청 남측,201911,858,812,1670,37.524506,126.891823
영등포구,231, 남부고용노동지청 남측,201912,524,496,1020,37.524506,126.891823
영등포구,231, 남부고용노동지청 남측,202001,465,466,931,37.524506,126.891823
영등포구,231, 남부고용노동지청 남측,202002,482,440,922,37.524506,126.891823
영등포구,231, 남부고용노동지청 남측,202003,712,668,1380,37.524506,126.891823
영등포구,231, 남부고용노동지청 남측,202004,871,853,1724,37.524506,126.891823
영등포구,231, 남부고용노동지청 남측,202005,1036,1020,2056,37.524506,126.891823
영등포구,231, 남부고용노동지청 남측,202006,1131,1125,2256,37.524506,126.891823
영등포구,232, 양평우림 이비즈센타 앞,201901,900,911,1811,37.52565,126.887817
영등포구,232, 양평우림 이비즈센타 앞,201902,746,735,1481,37.52565,126.887817
영등포구,232, 양평우림 이비즈센타 앞,201903,1424,1390,2814,37.52565,126.887817
영등포구,232, 양평우림 이비즈센타 앞,201904,2255,2320,4575,37.52565,126.887817
영등포구,232, 양평우림 이비즈센타 앞,201905,3065,3138,6203,37.52565,126.887817
영등포구,232, 양평우림 이비즈센타 앞,201906,3568,3634,7202,37.52565,126.887817
영등포구,232, 양평우림 이비즈센타 앞,201907,3509,3518,7027,37.52565,126.887817
영등포구,232, 양평우림 이비즈센타 앞,201908,3404,3471,6875,37.52565,126.887817
영등포구,232, 양평우림 이비즈센타 앞,201909,3167,3181,6348,37.52565,126.887817
영등포구,232, 양평우림 이비즈센타 앞,201910,3940,3896,7836,37.52565,126.887817
영등포구,232, 양평우림 이비즈센타 앞,201911,2624,2627,5251,37.52565,126.887817
영등포구,232, 양평우림 이비즈센타 앞,201912,1746,1726,3472,37.52565,126.887817
영등포구,232, 양평우림 이비즈센타 앞,202001,1315,1287,2602,37.52565,126.887817
영등포구,232, 양평우림 이비즈센타 앞,202002,1273,1237,2510,37.52565,126.887817
영등포구,232, 양평우림 이비즈센타 앞,202003,2653,2568,5221,37.52565,126.887817
영등포구,232, 양평우림 이비즈센타 앞,202004,3320,3232,6552,37.52565,126.887817
영등포구,232, 양평우림 이비즈센타 앞,202005,3577,3566,7143,37.52565,126.887817
영등포구,232, 양평우림 이비즈센타 앞,202006,4174,4104,8278,37.52565,126.887817
영등포구,233, YP 센터 앞,201901,101,103,204,37.528488,126.891647
영등포구,233, YP 센터 앞,201902,107,82,189,37.528488,126.891647
영등포구,233, YP 센터 앞,201903,201,192,393,37.528488,126.891647
영등포구,233, YP 센터 앞,201904,280,256,536,37.528488,126.891647
영등포구,233, YP 센터 앞,201905,370,338,708,37.528488,126.891647
영등포구,233, YP 센터 앞,201906,377,377,754,37.528488,126.891647
영등포구,233, YP 센터 앞,201907,367,328,695,37.528488,126.891647
영등포구,233, YP 센터 앞,201908,364,361,725,37.528488,126.891647
영등포구,233, YP 센터 앞,201909,353,342,695,37.528488,126.891647
영등포구,233, YP 센터 앞,201910,376,372,748,37.528488,126.891647
영등포구,233, YP 센터 앞,201911,271,260,531,37.528488,126.891647
영등포구,233, YP 센터 앞,201912,158,153,311,37.528488,126.891647
영등포구,233, YP 센터 앞,202001,124,119,243,37.528488,126.891647
영등포구,233, YP 센터 앞,202002,145,147,292,37.528488,126.891647
영등포구,233, YP 센터 앞,202003,338,338,676,37.528488,126.891647
영등포구,233, YP 센터 앞,202004,486,483,969,37.528488,126.891647
영등포구,233, YP 센터 앞,202005,496,497,993,37.528488,126.891647
영등포구,233, YP 센터 앞,202006,588,584,1172,37.528488,126.891647
영등포구,234, 영등포구민체육센터 앞,201901,144,124,268,37.500462,126.905846
영등포구,234, 영등포구민체육센터 앞,201902,139,147,286,37.500462,126.905846
영등포구,234, 영등포구민체육센터 앞,201903,292,309,601,37.500462,126.905846
영등포구,234, 영등포구민체육센터 앞,201904,563,645,1208,37.500462,126.905846
영등포구,234, 영등포구민체육센터 앞,201905,1026,991,2017,37.500462,126.905846
영등포구,234, 영등포구민체육센터 앞,201906,1029,1039,2068,37.500462,126.905846
영등포구,234, 영등포구민체육센터 앞,201907,1183,1206,2389,37.500462,126.905846
영등포구,234, 영등포구민체육센터 앞,201908,1074,1061,2135,37.500462,126.905846
영등포구,234, 영등포구민체육센터 앞,201909,913,912,1825,37.500462,126.905846
영등포구,234, 영등포구민체육센터 앞,201910,1179,1168,2347,37.500462,126.905846
영등포구,234, 영등포구민체육센터 앞,201911,760,782,1542,37.500462,126.905846
영등포구,234, 영등포구민체육센터 앞,201912,467,498,965,37.500462,126.905846
영등포구,234, 영등포구민체육센터 앞,202001,402,380,782,37.500462,126.905846
영등포구,234, 영등포구민체육센터 앞,202002,377,292,669,37.500462,126.905846
영등포구,234, 영등포구민체육센터 앞,202003,572,493,1065,37.500462,126.905846
영등포구,234, 영등포구민체육센터 앞,202004,833,786,1619,37.500462,126.905846
영등포구,234, 영등포구민체육센터 앞,202005,898,876,1774,37.500462,126.905846
영등포구,234, 영등포구민체육센터 앞,202006,1022,986,2008,37.500462,126.905846
영등포구,235, 신길동 우리은행 옆,201901,191,173,364,37.504566,126.910233
영등포구,235, 신길동 우리은행 옆,201902,160,165,325,37.504566,126.910233
영등포구,235, 신길동 우리은행 옆,201903,342,340,682,37.504566,126.910233
영등포구,235, 신길동 우리은행 옆,201904,538,520,1058,37.504566,126.910233
영등포구,235, 신길동 우리은행 옆,201905,765,760,1525,37.504566,126.910233
영등포구,235, 신길동 우리은행 옆,201906,981,961,1942,37.504566,126.910233
영등포구,235, 신길동 우리은행 옆,201907,937,1004,1941,37.504566,126.910233
영등포구,235, 신길동 우리은행 옆,201908,864,913,1777,37.504566,126.910233
영등포구,235, 신길동 우리은행 옆,201909,951,994,1945,37.504566,126.910233
영등포구,235, 신길동 우리은행 옆,201910,1068,1080,2148,37.504566,126.910233
영등포구,235, 신길동 우리은행 옆,201911,675,664,1339,37.504566,126.910233
영등포구,235, 신길동 우리은행 옆,201912,476,458,934,37.504566,126.910233
영등포구,235, 신길동 우리은행 옆,202001,380,372,752,37.504566,126.910233
영등포구,235, 신길동 우리은행 옆,202002,337,346,683,37.504566,126.910233
영등포구,235, 신길동 우리은행 옆,202003,601,597,1198,37.504566,126.910233
영등포구,235, 신길동 우리은행 옆,202004,1017,1003,2020,37.504566,126.910233
영등포구,235, 신길동 우리은행 옆,202005,1129,1121,2250,37.504566,126.910233
영등포구,235, 신길동 우리은행 옆,202006,1146,1125,2271,37.504566,126.910233
영등포구,236, 문래동자이아파트 앞,201901,343,371,714,37.516155,126.894615
영등포구,236, 문래동자이아파트 앞,201902,303,321,624,37.516155,126.894615
영등포구,236, 문래동자이아파트 앞,201903,587,576,1163,37.516155,126.894615
영등포구,236, 문래동자이아파트 앞,201904,1017,977,1994,37.516155,126.894615
영등포구,236, 문래동자이아파트 앞,201905,1424,1392,2816,37.516155,126.894615
영등포구,236, 문래동자이아파트 앞,201906,1762,1706,3468,37.516155,126.894615
영등포구,236, 문래동자이아파트 앞,201907,1750,1621,3371,37.516155,126.894615
영등포구,236, 문래동자이아파트 앞,201908,1667,1524,3191,37.516155,126.894615
영등포구,236, 문래동자이아파트 앞,201909,1459,1392,2851,37.516155,126.894615
영등포구,236, 문래동자이아파트 앞,201910,1877,1823,3700,37.516155,126.894615
영등포구,236, 문래동자이아파트 앞,201911,1212,1183,2395,37.516155,126.894615
영등포구,236, 문래동자이아파트 앞,201912,726,708,1434,37.516155,126.894615
영등포구,236, 문래동자이아파트 앞,202001,670,649,1319,37.516155,126.894615
영등포구,236, 문래동자이아파트 앞,202002,619,602,1221,37.516155,126.894615
영등포구,236, 문래동자이아파트 앞,202003,1074,1014,2088,37.516155,126.894615
영등포구,236, 문래동자이아파트 앞,202004,1701,1591,3292,37.516155,126.894615
영등포구,236, 문래동자이아파트 앞,202005,2061,2042,4103,37.516155,126.894615
영등포구,236, 문래동자이아파트 앞,202006,2229,2198,4427,37.516155,126.894615
동작구,237, 보라매 두산위브 건너편,201901,383,365,748,37.496513,126.914803
동작구,237, 보라매 두산위브 건너편,201902,343,319,662,37.496513,126.914803
동작구,237, 보라매 두산위브 건너편,201903,655,622,1277,37.496513,126.914803
동작구,237, 보라매 두산위브 건너편,201904,948,956,1904,37.496513,126.914803
동작구,237, 보라매 두산위브 건너편,201905,1341,1406,2747,37.496513,126.914803
동작구,237, 보라매 두산위브 건너편,201906,1617,1669,3286,37.496513,126.914803
동작구,237, 보라매 두산위브 건너편,201907,1678,1698,3376,37.496513,126.914803
동작구,237, 보라매 두산위브 건너편,201908,1591,1559,3150,37.496513,126.914803
동작구,237, 보라매 두산위브 건너편,201909,1497,1474,2971,37.496513,126.914803
동작구,237, 보라매 두산위브 건너편,201910,2019,1994,4013,37.496513,126.914803
동작구,237, 보라매 두산위브 건너편,201911,1297,1283,2580,37.496513,126.914803
동작구,237, 보라매 두산위브 건너편,201912,784,759,1543,37.496513,126.914803
동작구,237, 보라매 두산위브 건너편,202001,581,554,1135,37.496513,126.914803
동작구,237, 보라매 두산위브 건너편,202002,538,538,1076,37.496513,126.914803
동작구,237, 보라매 두산위브 건너편,202003,867,871,1738,37.496513,126.914803
동작구,237, 보라매 두산위브 건너편,202004,1401,1410,2811,37.496513,126.914803
동작구,237, 보라매 두산위브 건너편,202005,1591,1595,3186,37.496513,126.914803
동작구,237, 보라매 두산위브 건너편,202006,1750,1770,3520,37.496513,126.914803
영등포구,238, 제2구민체육센타 앞,201901,899,935,1834,37.526386,126.902756
영등포구,238, 제2구민체육센타 앞,201902,642,698,1340,37.526386,126.902756
영등포구,238, 제2구민체육센타 앞,201903,1192,1214,2406,37.526386,126.902756
영등포구,238, 제2구민체육센타 앞,201904,1552,1553,3105,37.526386,126.902756
영등포구,238, 제2구민체육센타 앞,201905,2039,2002,4041,37.526386,126.902756
영등포구,238, 제2구민체육센타 앞,201906,2111,2117,4228,37.526386,126.902756
영등포구,238, 제2구민체육센타 앞,201907,2381,2416,4797,37.526386,126.902756
영등포구,238, 제2구민체육센타 앞,201908,2260,2250,4510,37.526386,126.902756
영등포구,238, 제2구민체육센타 앞,201909,1883,1888,3771,37.526386,126.902756
영등포구,238, 제2구민체육센타 앞,201910,2367,2350,4717,37.526386,126.902756
영등포구,238, 제2구민체육센타 앞,201911,1809,1787,3596,37.526386,126.902756
영등포구,238, 제2구민체육센타 앞,201912,1070,1082,2152,37.526386,126.902756
영등포구,238, 제2구민체육센타 앞,202001,869,876,1745,37.526386,126.902756
영등포구,238, 제2구민체육센타 앞,202002,687,643,1330,37.526386,126.902756
영등포구,238, 제2구민체육센타 앞,202003,1142,1123,2265,37.526386,126.902756
영등포구,238, 제2구민체육센타 앞,202004,1620,1616,3236,37.526386,126.902756
영등포구,238, 제2구민체육센타 앞,202005,1583,1572,3155,37.526386,126.902756
영등포구,238, 제2구민체육센타 앞,202006,1411,1406,2817,37.526386,126.902756
영등포구,239, 유스호스텔 앞,201901,462,376,838,37.525852,126.903282
영등포구,239, 유스호스텔 앞,201902,372,344,716,37.525852,126.903282
영등포구,239, 유스호스텔 앞,201903,606,605,1211,37.525852,126.903282
영등포구,239, 유스호스텔 앞,201904,963,886,1849,37.525852,126.903282
영등포구,239, 유스호스텔 앞,201905,1245,1156,2401,37.525852,126.903282
영등포구,239, 유스호스텔 앞,201906,1478,1260,2738,37.525852,126.903282
영등포구,239, 유스호스텔 앞,201907,1482,1353,2835,37.525852,126.903282
영등포구,239, 유스호스텔 앞,201908,1420,1335,2755,37.525852,126.903282
영등포구,239, 유스호스텔 앞,201909,1378,1292,2670,37.525852,126.903282
영등포구,239, 유스호스텔 앞,201910,1710,1608,3318,37.525852,126.903282
영등포구,239, 유스호스텔 앞,201911,1221,1115,2336,37.525852,126.903282
영등포구,239, 유스호스텔 앞,201912,799,732,1531,37.525852,126.903282
영등포구,239, 유스호스텔 앞,202001,710,648,1358,37.525852,126.903282
영등포구,239, 유스호스텔 앞,202002,581,533,1114,37.525852,126.903282
영등포구,239, 유스호스텔 앞,202003,991,849,1840,37.525852,126.903282
영등포구,239, 유스호스텔 앞,202004,1135,1033,2168,37.525852,126.903282
영등포구,239, 유스호스텔 앞,202005,1221,1097,2318,37.525852,126.903282
영등포구,239, 유스호스텔 앞,202006,1350,1209,2559,37.525852,126.903282
영등포구,240, 문래역 4번출구 앞,201901,725,659,1384,37.518738,126.895576
영등포구,240, 문래역 4번출구 앞,201902,580,523,1103,37.518738,126.895576
영등포구,240, 문래역 4번출구 앞,201903,1132,1101,2233,37.518738,126.895576
영등포구,240, 문래역 4번출구 앞,201904,1564,1494,3058,37.518738,126.895576
영등포구,240, 문래역 4번출구 앞,201905,2200,2101,4301,37.518738,126.895576
영등포구,240, 문래역 4번출구 앞,201906,2398,2340,4738,37.518738,126.895576
영등포구,240, 문래역 4번출구 앞,201907,2426,2377,4803,37.518738,126.895576
영등포구,240, 문래역 4번출구 앞,201908,2384,2314,4698,37.518738,126.895576
영등포구,240, 문래역 4번출구 앞,201909,2227,2172,4399,37.518738,126.895576
영등포구,240, 문래역 4번출구 앞,201910,2642,2593,5235,37.518738,126.895576
영등포구,240, 문래역 4번출구 앞,201911,1880,1801,3681,37.518738,126.895576
영등포구,240, 문래역 4번출구 앞,201912,1222,1169,2391,37.518738,126.895576
영등포구,240, 문래역 4번출구 앞,202001,1080,1055,2135,37.518738,126.895576
영등포구,240, 문래역 4번출구 앞,202002,902,854,1756,37.518738,126.895576
영등포구,240, 문래역 4번출구 앞,202003,1331,1303,2634,37.518738,126.895576
영등포구,240, 문래역 4번출구 앞,202004,1880,1833,3713,37.518738,126.895576
영등포구,240, 문래역 4번출구 앞,202005,2154,2151,4305,37.518738,126.895576
영등포구,240, 문래역 4번출구 앞,202006,2390,2372,4762,37.518738,126.895576
영등포구,241, 신길우성1차아파트 앞 공원,201901,413,402,815,37.505329,126.898483
영등포구,241, 신길우성1차아파트 앞 공원,201902,336,313,649,37.505329,126.898483
영등포구,241, 신길우성1차아파트 앞 공원,201903,618,546,1164,37.505329,126.898483
영등포구,241, 신길우성1차아파트 앞 공원,201904,959,925,1884,37.505329,126.898483
영등포구,241, 신길우성1차아파트 앞 공원,201905,1454,1409,2863,37.505329,126.898483
영등포구,241, 신길우성1차아파트 앞 공원,201906,1579,1555,3134,37.505329,126.898483
영등포구,241, 신길우성1차아파트 앞 공원,201907,1687,1638,3325,37.505329,126.898483
영등포구,241, 신길우성1차아파트 앞 공원,201908,1681,1612,3293,37.505329,126.898483
영등포구,241, 신길우성1차아파트 앞 공원,201909,1411,1384,2795,37.505329,126.898483
영등포구,241, 신길우성1차아파트 앞 공원,201910,1610,1609,3219,37.505329,126.898483
영등포구,241, 신길우성1차아파트 앞 공원,201911,1129,1101,2230,37.505329,126.898483
영등포구,241, 신길우성1차아파트 앞 공원,201912,632,622,1254,37.505329,126.898483
영등포구,241, 신길우성1차아파트 앞 공원,202001,553,535,1088,37.505329,126.898483
영등포구,241, 신길우성1차아파트 앞 공원,202002,454,448,902,37.505329,126.898483
영등포구,241, 신길우성1차아파트 앞 공원,202003,750,744,1494,37.505329,126.898483
영등포구,241, 신길우성1차아파트 앞 공원,202004,1171,1167,2338,37.505329,126.898483
영등포구,241, 신길우성1차아파트 앞 공원,202005,1255,1257,2512,37.505329,126.898483
영등포구,241, 신길우성1차아파트 앞 공원,202006,1485,1496,2981,37.505329,126.898483
영등포구,242, 신길선원가와인아파트 앞,201901,249,163,412,37.510933,126.910225
영등포구,242, 신길선원가와인아파트 앞,201902,241,188,429,37.510933,126.910225
영등포구,242, 신길선원가와인아파트 앞,201903,436,319,755,37.510933,126.910225
영등포구,242, 신길선원가와인아파트 앞,201904,722,534,1256,37.510933,126.910225
영등포구,242, 신길선원가와인아파트 앞,201905,979,828,1807,37.510933,126.910225
영등포구,242, 신길선원가와인아파트 앞,201906,1184,1105,2289,37.510933,126.910225
영등포구,242, 신길선원가와인아파트 앞,201907,1088,995,2083,37.510933,126.910225
영등포구,242, 신길선원가와인아파트 앞,201908,946,883,1829,37.510933,126.910225
영등포구,242, 신길선원가와인아파트 앞,201909,898,860,1758,37.510933,126.910225
영등포구,242, 신길선원가와인아파트 앞,201910,1098,1049,2147,37.510933,126.910225
영등포구,242, 신길선원가와인아파트 앞,201911,505,498,1003,37.510933,126.910225
영등포구,242, 신길선원가와인아파트 앞,201912,388,399,787,37.510933,126.910225
영등포구,242, 신길선원가와인아파트 앞,202001,321,290,611,37.510933,126.910225
영등포구,242, 신길선원가와인아파트 앞,202002,349,304,653,37.510933,126.910225
영등포구,242, 신길선원가와인아파트 앞,202003,599,598,1197,37.510933,126.910225
영등포구,242, 신길선원가와인아파트 앞,202004,953,938,1891,37.510933,126.910225
영등포구,242, 신길선원가와인아파트 앞,202005,1108,1115,2223,37.510933,126.910225
영등포구,242, 신길선원가와인아파트 앞,202006,1154,1132,2286,37.510933,126.910225
영등포구,243, 이앤씨드림타워 앞,201901,455,450,905,37.527084,126.89138
영등포구,243, 이앤씨드림타워 앞,201902,392,412,804,37.527084,126.89138
영등포구,243, 이앤씨드림타워 앞,201903,728,778,1506,37.527084,126.89138
영등포구,243, 이앤씨드림타워 앞,201904,1191,1225,2416,37.527084,126.89138
영등포구,243, 이앤씨드림타워 앞,201905,1674,1707,3381,37.527084,126.89138
영등포구,243, 이앤씨드림타워 앞,201906,1872,1888,3760,37.527084,126.89138
영등포구,243, 이앤씨드림타워 앞,201907,1857,1862,3719,37.527084,126.89138
영등포구,243, 이앤씨드림타워 앞,201908,1710,1720,3430,37.527084,126.89138
영등포구,243, 이앤씨드림타워 앞,201909,1701,1702,3403,37.527084,126.89138
영등포구,243, 이앤씨드림타워 앞,201910,2282,2295,4577,37.527084,126.89138
영등포구,243, 이앤씨드림타워 앞,201911,1605,1596,3201,37.527084,126.89138
영등포구,243, 이앤씨드림타워 앞,201912,958,961,1919,37.527084,126.89138
영등포구,243, 이앤씨드림타워 앞,202001,824,815,1639,37.527084,126.89138
영등포구,243, 이앤씨드림타워 앞,202002,733,703,1436,37.527084,126.89138
영등포구,243, 이앤씨드림타워 앞,202003,1467,1474,2941,37.527084,126.89138
영등포구,243, 이앤씨드림타워 앞,202004,1784,1773,3557,37.527084,126.89138
영등포구,243, 이앤씨드림타워 앞,202005,2128,2126,4254,37.527084,126.89138
영등포구,243, 이앤씨드림타워 앞,202006,2295,2269,4564,37.527084,126.89138
영등포구,244, 영등포삼환아파트 앞,201901,602,573,1175,37.530079,126.905708
영등포구,244, 영등포삼환아파트 앞,201902,452,435,887,37.530079,126.905708
영등포구,244, 영등포삼환아파트 앞,201903,875,841,1716,37.530079,126.905708
영등포구,244, 영등포삼환아파트 앞,201904,1233,1212,2445,37.530079,126.905708
영등포구,244, 영등포삼환아파트 앞,201905,1876,1857,3733,37.530079,126.905708
영등포구,244, 영등포삼환아파트 앞,201906,1932,1891,3823,37.530079,126.905708
영등포구,244, 영등포삼환아파트 앞,201907,1852,1802,3654,37.530079,126.905708
영등포구,244, 영등포삼환아파트 앞,201908,1796,1792,3588,37.530079,126.905708
영등포구,244, 영등포삼환아파트 앞,201909,1695,1589,3284,37.530079,126.905708
영등포구,244, 영등포삼환아파트 앞,201910,1868,1805,3673,37.530079,126.905708
영등포구,244, 영등포삼환아파트 앞,201911,1293,1166,2459,37.530079,126.905708
영등포구,244, 영등포삼환아파트 앞,201912,764,718,1482,37.530079,126.905708
영등포구,244, 영등포삼환아파트 앞,202001,718,666,1384,37.530079,126.905708
영등포구,244, 영등포삼환아파트 앞,202002,699,681,1380,37.530079,126.905708
영등포구,244, 영등포삼환아파트 앞,202003,1176,1077,2253,37.530079,126.905708
영등포구,244, 영등포삼환아파트 앞,202004,1805,1709,3514,37.530079,126.905708
영등포구,244, 영등포삼환아파트 앞,202005,1883,1825,3708,37.530079,126.905708
영등포구,244, 영등포삼환아파트 앞,202006,2095,2002,4097,37.530079,126.905708
영등포구,245, 삼성생명 당산사옥 앞,201901,516,516,1032,37.528263,126.896629
영등포구,245, 삼성생명 당산사옥 앞,201902,408,403,811,37.528263,126.896629
영등포구,245, 삼성생명 당산사옥 앞,201903,815,804,1619,37.528263,126.896629
영등포구,245, 삼성생명 당산사옥 앞,201904,1398,1404,2802,37.528263,126.896629
영등포구,245, 삼성생명 당산사옥 앞,201905,1445,1445,2890,37.528263,126.896629
영등포구,245, 삼성생명 당산사옥 앞,201906,2241,2213,4454,37.528263,126.896629
영등포구,245, 삼성생명 당산사옥 앞,201907,2281,2282,4563,37.528263,126.896629
영등포구,245, 삼성생명 당산사옥 앞,201908,2214,2203,4417,37.528263,126.896629
영등포구,245, 삼성생명 당산사옥 앞,201909,2188,2172,4360,37.528263,126.896629
영등포구,245, 삼성생명 당산사옥 앞,201910,2709,2743,5452,37.528263,126.896629
영등포구,245, 삼성생명 당산사옥 앞,201911,1847,1893,3740,37.528263,126.896629
영등포구,245, 삼성생명 당산사옥 앞,201912,1144,1160,2304,37.528263,126.896629
영등포구,245, 삼성생명 당산사옥 앞,202001,999,1000,1999,37.528263,126.896629
영등포구,245, 삼성생명 당산사옥 앞,202002,946,943,1889,37.528263,126.896629
영등포구,245, 삼성생명 당산사옥 앞,202003,1442,1445,2887,37.528263,126.896629
영등포구,245, 삼성생명 당산사옥 앞,202004,2203,2183,4386,37.528263,126.896629
영등포구,245, 삼성생명 당산사옥 앞,202005,2509,2524,5033,37.528263,126.896629
영등포구,245, 삼성생명 당산사옥 앞,202006,2932,2918,5850,37.528263,126.896629
영등포구,247, 당산역 10번출구 앞,201901,1089,1170,2259,37.533688,126.902107
영등포구,247, 당산역 10번출구 앞,201902,1047,1087,2134,37.533688,126.902107
영등포구,247, 당산역 10번출구 앞,201903,2106,2171,4277,37.533688,126.902107
영등포구,247, 당산역 10번출구 앞,201904,3257,3171,6428,37.533688,126.902107
영등포구,247, 당산역 10번출구 앞,201905,5137,5023,10160,37.533688,126.902107
영등포구,247, 당산역 10번출구 앞,201906,5479,5430,10909,37.533688,126.902107
영등포구,247, 당산역 10번출구 앞,201907,4985,4978,9963,37.533688,126.902107
영등포구,247, 당산역 10번출구 앞,201908,5301,5218,10519,37.533688,126.902107
영등포구,247, 당산역 10번출구 앞,201909,5206,5146,10352,37.533688,126.902107
영등포구,247, 당산역 10번출구 앞,201910,6049,6026,12075,37.533688,126.902107
영등포구,247, 당산역 10번출구 앞,201911,3249,3248,6497,37.533688,126.902107
영등포구,247, 당산역 10번출구 앞,201912,1961,1956,3917,37.533688,126.902107
영등포구,247, 당산역 10번출구 앞,202001,1714,1723,3437,37.533688,126.902107
영등포구,247, 당산역 10번출구 앞,202002,1601,1629,3230,37.533688,126.902107
영등포구,247, 당산역 10번출구 앞,202003,3707,3684,7391,37.533688,126.902107
영등포구,247, 당산역 10번출구 앞,202004,5249,5182,10431,37.533688,126.902107
영등포구,247, 당산역 10번출구 앞,202005,6392,6361,12753,37.533688,126.902107
영등포구,247, 당산역 10번출구 앞,202006,6663,6633,13296,37.533688,126.902107
영등포구,248, 초원아파트 앞,201901,281,292,573,37.531055,126.92421
영등포구,248, 초원아파트 앞,201902,289,330,619,37.531055,126.92421
영등포구,248, 초원아파트 앞,201903,567,723,1290,37.531055,126.92421
영등포구,248, 초원아파트 앞,201904,2315,3027,5342,37.531055,126.92421
영등포구,248, 초원아파트 앞,201905,3313,3864,7177,37.531055,126.92421
영등포구,248, 초원아파트 앞,201906,3077,3240,6317,37.531055,126.92421
영등포구,248, 초원아파트 앞,201907,2328,2426,4754,37.531055,126.92421
영등포구,248, 초원아파트 앞,201908,3549,3756,7305,37.531055,126.92421
영등포구,248, 초원아파트 앞,201909,3262,3508,6770,37.531055,126.92421
영등포구,248, 초원아파트 앞,201910,2798,3056,5854,37.531055,126.92421
영등포구,248, 초원아파트 앞,201911,1017,1017,2034,37.531055,126.92421
영등포구,248, 초원아파트 앞,201912,431,447,878,37.531055,126.92421
영등포구,248, 초원아파트 앞,202001,460,463,923,37.531055,126.92421
영등포구,248, 초원아파트 앞,202002,512,521,1033,37.531055,126.92421
영등포구,248, 초원아파트 앞,202003,3344,3580,6924,37.531055,126.92421
영등포구,248, 초원아파트 앞,202004,3898,4085,7983,37.531055,126.92421
영등포구,248, 초원아파트 앞,202005,5237,5299,10536,37.531055,126.92421
영등포구,248, 초원아파트 앞,202006,3549,3580,7129,37.531055,126.92421
영등포구,249, 여의도중학교 옆,201901,122,139,261,37.52412,126.936546
영등포구,249, 여의도중학교 옆,201902,208,304,512,37.52412,126.936546
영등포구,249, 여의도중학교 옆,201903,559,890,1449,37.52412,126.936546
영등포구,249, 여의도중학교 옆,201904,1647,2281,3928,37.52412,126.936546
영등포구,249, 여의도중학교 옆,201905,2653,3080,5733,37.52412,126.936546
영등포구,249, 여의도중학교 옆,201906,2079,2249,4328,37.52412,126.936546
영등포구,249, 여의도중학교 옆,201907,1704,1788,3492,37.52412,126.936546
영등포구,249, 여의도중학교 옆,201908,2310,2509,4819,37.52412,126.936546
영등포구,249, 여의도중학교 옆,201909,2509,2799,5308,37.52412,126.936546
영등포구,249, 여의도중학교 옆,201910,2104,2338,4442,37.52412,126.936546
영등포구,249, 여의도중학교 옆,201911,824,918,1742,37.52412,126.936546
영등포구,249, 여의도중학교 옆,201912,274,283,557,37.52412,126.936546
영등포구,249, 여의도중학교 옆,202001,283,355,638,37.52412,126.936546
영등포구,249, 여의도중학교 옆,202002,484,557,1041,37.52412,126.936546
영등포구,249, 여의도중학교 옆,202003,3703,4728,8431,37.52412,126.936546
영등포구,249, 여의도중학교 옆,202004,4721,5325,10046,37.52412,126.936546
영등포구,249, 여의도중학교 옆,202005,5081,5503,10584,37.52412,126.936546
영등포구,249, 여의도중학교 옆,202006,3332,3596,6928,37.52412,126.936546
영등포구,250, 대림아파트 사거리,201901,128,106,234,37.507641,126.92308
영등포구,250, 대림아파트 사거리,201902,170,140,310,37.507641,126.92308
영등포구,250, 대림아파트 사거리,201903,342,283,625,37.507641,126.92308
영등포구,250, 대림아파트 사거리,201904,448,427,875,37.507641,126.92308
영등포구,250, 대림아파트 사거리,201905,749,672,1421,37.507641,126.92308
영등포구,250, 대림아파트 사거리,201906,627,594,1221,37.507641,126.92308
영등포구,250, 대림아파트 사거리,201907,685,652,1337,37.507641,126.92308
영등포구,250, 대림아파트 사거리,201908,647,631,1278,37.507641,126.92308
영등포구,250, 대림아파트 사거리,201909,626,617,1243,37.507641,126.92308
영등포구,250, 대림아파트 사거리,201910,923,897,1820,37.507641,126.92308
영등포구,250, 대림아파트 사거리,201911,640,579,1219,37.507641,126.92308
영등포구,250, 대림아파트 사거리,201912,298,276,574,37.507641,126.92308
영등포구,250, 대림아파트 사거리,202001,271,269,540,37.507641,126.92308
영등포구,250, 대림아파트 사거리,202002,328,304,632,37.507641,126.92308
영등포구,250, 대림아파트 사거리,202003,599,603,1202,37.507641,126.92308
영등포구,250, 대림아파트 사거리,202004,946,928,1874,37.507641,126.92308
영등포구,250, 대림아파트 사거리,202005,1042,1048,2090,37.507641,126.92308
영등포구,250, 대림아파트 사거리,202006,1070,1063,2133,37.507641,126.92308
영등포구,251, 서울지방병무청 버스정류장,201901,226,254,480,37.504494,126.921951
영등포구,251, 서울지방병무청 버스정류장,201902,251,240,491,37.504494,126.921951
영등포구,251, 서울지방병무청 버스정류장,201903,535,512,1047,37.504494,126.921951
영등포구,251, 서울지방병무청 버스정류장,201904,736,686,1422,37.504494,126.921951
영등포구,251, 서울지방병무청 버스정류장,201905,1151,1092,2243,37.504494,126.921951
영등포구,251, 서울지방병무청 버스정류장,201906,1183,1147,2330,37.504494,126.921951
영등포구,251, 서울지방병무청 버스정류장,201907,1120,1118,2238,37.504494,126.921951
영등포구,251, 서울지방병무청 버스정류장,201908,928,909,1837,37.504494,126.921951
영등포구,251, 서울지방병무청 버스정류장,201909,885,935,1820,37.504494,126.921951
영등포구,251, 서울지방병무청 버스정류장,201910,1106,1096,2202,37.504494,126.921951
영등포구,251, 서울지방병무청 버스정류장,201911,774,762,1536,37.504494,126.921951
영등포구,251, 서울지방병무청 버스정류장,201912,458,451,909,37.504494,126.921951
영등포구,251, 서울지방병무청 버스정류장,202001,395,383,778,37.504494,126.921951
영등포구,251, 서울지방병무청 버스정류장,202002,449,445,894,37.504494,126.921951
영등포구,251, 서울지방병무청 버스정류장,202003,898,893,1791,37.504494,126.921951
영등포구,251, 서울지방병무청 버스정류장,202004,1398,1383,2781,37.504494,126.921951
영등포구,251, 서울지방병무청 버스정류장,202005,1469,1484,2953,37.504494,126.921951
영등포구,251, 서울지방병무청 버스정류장,202006,1427,1445,2872,37.504494,126.921951
영등포구,252, 보라매역4번출구,201901,430,476,906,37.499828,126.919945
영등포구,252, 보라매역4번출구,201902,346,392,738,37.499828,126.919945
영등포구,252, 보라매역4번출구,201903,652,682,1334,37.499828,126.919945
영등포구,252, 보라매역4번출구,201904,877,867,1744,37.499828,126.919945
영등포구,252, 보라매역4번출구,201905,1448,1441,2889,37.499828,126.919945
영등포구,252, 보라매역4번출구,201906,1695,1714,3409,37.499828,126.919945
영등포구,252, 보라매역4번출구,201907,1732,1739,3471,37.499828,126.919945
영등포구,252, 보라매역4번출구,201908,1513,1519,3032,37.499828,126.919945
영등포구,252, 보라매역4번출구,201909,1449,1480,2929,37.499828,126.919945
영등포구,252, 보라매역4번출구,201910,1773,1805,3578,37.499828,126.919945
영등포구,252, 보라매역4번출구,201911,1120,1085,2205,37.499828,126.919945
영등포구,252, 보라매역4번출구,201912,690,699,1389,37.499828,126.919945
영등포구,252, 보라매역4번출구,202001,569,578,1147,37.499828,126.919945
영등포구,252, 보라매역4번출구,202002,551,555,1106,37.499828,126.919945
영등포구,252, 보라매역4번출구,202003,933,938,1871,37.499828,126.919945
영등포구,252, 보라매역4번출구,202004,1436,1455,2891,37.499828,126.919945
영등포구,252, 보라매역4번출구,202005,1730,1749,3479,37.499828,126.919945
영등포구,252, 보라매역4번출구,202006,2045,2064,4109,37.499828,126.919945
영등포구,253, 신풍역 5번출구 인근,201901,317,277,594,37.500648,126.909515
영등포구,253, 신풍역 5번출구 인근,201902,310,310,620,37.500648,126.909515
영등포구,253, 신풍역 5번출구 인근,201903,607,601,1208,37.500648,126.909515
영등포구,253, 신풍역 5번출구 인근,201904,886,848,1734,37.500648,126.909515
영등포구,253, 신풍역 5번출구 인근,201905,1512,1508,3020,37.500648,126.909515
영등포구,253, 신풍역 5번출구 인근,201906,1654,1656,3310,37.500648,126.909515
영등포구,253, 신풍역 5번출구 인근,201907,1615,1639,3254,37.500648,126.909515
영등포구,253, 신풍역 5번출구 인근,201908,1504,1496,3000,37.500648,126.909515
영등포구,253, 신풍역 5번출구 인근,201909,1402,1430,2832,37.500648,126.909515
영등포구,253, 신풍역 5번출구 인근,201910,1662,1664,3326,37.500648,126.909515
영등포구,253, 신풍역 5번출구 인근,201911,1103,1101,2204,37.500648,126.909515
영등포구,253, 신풍역 5번출구 인근,201912,623,619,1242,37.500648,126.909515
영등포구,253, 신풍역 5번출구 인근,202001,573,588,1161,37.500648,126.909515
영등포구,253, 신풍역 5번출구 인근,202002,530,513,1043,37.500648,126.909515
영등포구,253, 신풍역 5번출구 인근,202003,914,908,1822,37.500648,126.909515
영등포구,253, 신풍역 5번출구 인근,202004,1437,1421,2858,37.500648,126.909515
영등포구,253, 신풍역 5번출구 인근,202005,1423,1421,2844,37.500648,126.909515
영등포구,253, 신풍역 5번출구 인근,202006,1304,1289,2593,37.500648,126.909515
영등포구,254, 도림신협 앞,201901,150,125,275,37.503803,126.903419
영등포구,254, 도림신협 앞,201902,149,143,292,37.503803,126.903419
영등포구,254, 도림신협 앞,201903,326,383,709,37.503803,126.903419
영등포구,254, 도림신협 앞,201904,614,608,1222,37.503803,126.903419
영등포구,254, 도림신협 앞,201905,838,840,1678,37.503803,126.903419
영등포구,254, 도림신협 앞,201906,903,1052,1955,37.503803,126.903419
영등포구,254, 도림신협 앞,201907,1070,1267,2337,37.503803,126.903419
영등포구,254, 도림신협 앞,201908,969,1080,2049,37.503803,126.903419
영등포구,254, 도림신협 앞,201909,1021,1096,2117,37.503803,126.903419
영등포구,254, 도림신협 앞,201910,1184,1259,2443,37.503803,126.903419
영등포구,254, 도림신협 앞,201911,806,836,1642,37.503803,126.903419
영등포구,254, 도림신협 앞,201912,445,479,924,37.503803,126.903419
영등포구,254, 도림신협 앞,202001,416,451,867,37.503803,126.903419
영등포구,254, 도림신협 앞,202002,410,440,850,37.503803,126.903419
영등포구,254, 도림신협 앞,202003,684,718,1402,37.503803,126.903419
영등포구,254, 도림신협 앞,202004,1051,1095,2146,37.503803,126.903419
영등포구,254, 도림신협 앞,202005,1247,1230,2477,37.503803,126.903419
영등포구,254, 도림신협 앞,202006,1435,1460,2895,37.503803,126.903419
영등포구,255, 도림4거리,201901,269,330,599,37.506573,126.901131
영등포구,255, 도림4거리,201902,294,304,598,37.506573,126.901131
영등포구,255, 도림4거리,201903,492,578,1070,37.506573,126.901131
영등포구,255, 도림4거리,201904,719,803,1522,37.506573,126.901131
영등포구,255, 도림4거리,201905,1252,1426,2678,37.506573,126.901131
영등포구,255, 도림4거리,201906,1489,1619,3108,37.506573,126.901131
영등포구,255, 도림4거리,201907,1516,1629,3145,37.506573,126.901131
영등포구,255, 도림4거리,201908,1471,1625,3096,37.506573,126.901131
영등포구,255, 도림4거리,201909,1383,1463,2846,37.506573,126.901131
영등포구,255, 도림4거리,201910,1631,1698,3329,37.506573,126.901131
영등포구,255, 도림4거리,201911,1020,1088,2108,37.506573,126.901131
영등포구,255, 도림4거리,201912,554,626,1180,37.506573,126.901131
영등포구,255, 도림4거리,202001,525,586,1111,37.506573,126.901131
영등포구,255, 도림4거리,202002,444,520,964,37.506573,126.901131
영등포구,255, 도림4거리,202003,766,823,1589,37.506573,126.901131
영등포구,255, 도림4거리,202004,1292,1341,2633,37.506573,126.901131
영등포구,255, 도림4거리,202005,1521,1531,3052,37.506573,126.901131
영등포구,255, 도림4거리,202006,1733,1768,3501,37.506573,126.901131
영등포구,256, 동아에코빌입구,201901,249,261,510,37.509476,126.8993
영등포구,256, 동아에코빌입구,201902,241,254,495,37.509476,126.8993
영등포구,256, 동아에코빌입구,201903,402,428,830,37.509476,126.8993
영등포구,256, 동아에코빌입구,201904,555,558,1113,37.509476,126.8993
영등포구,256, 동아에코빌입구,201905,973,981,1954,37.509476,126.8993
영등포구,256, 동아에코빌입구,201906,1255,1173,2428,37.509476,126.8993
영등포구,256, 동아에코빌입구,201907,1379,1360,2739,37.509476,126.8993
영등포구,256, 동아에코빌입구,201908,1253,1212,2465,37.509476,126.8993
영등포구,256, 동아에코빌입구,201909,1144,1042,2186,37.509476,126.8993
영등포구,256, 동아에코빌입구,201910,1183,1142,2325,37.509476,126.8993
영등포구,256, 동아에코빌입구,201911,751,713,1464,37.509476,126.8993
영등포구,256, 동아에코빌입구,201912,448,432,880,37.509476,126.8993
영등포구,256, 동아에코빌입구,202001,354,355,709,37.509476,126.8993
영등포구,256, 동아에코빌입구,202002,380,383,763,37.509476,126.8993
영등포구,256, 동아에코빌입구,202003,811,793,1604,37.509476,126.8993
영등포구,256, 동아에코빌입구,202004,1125,1104,2229,37.509476,126.8993
영등포구,256, 동아에코빌입구,202005,1281,1283,2564,37.509476,126.8993
영등포구,256, 동아에코빌입구,202006,1425,1410,2835,37.509476,126.8993
영등포구,257, 신길삼거리(우리은행),201901,499,659,1158,37.513844,126.919357
영등포구,257, 신길삼거리(우리은행),201902,459,641,1100,37.513844,126.919357
영등포구,257, 신길삼거리(우리은행),201903,894,1292,2186,37.513844,126.919357
영등포구,257, 신길삼거리(우리은행),201904,1405,1968,3373,37.513844,126.919357
영등포구,257, 신길삼거리(우리은행),201905,2300,2956,5256,37.513844,126.919357
영등포구,257, 신길삼거리(우리은행),201906,2593,3247,5840,37.513844,126.919357
영등포구,257, 신길삼거리(우리은행),201907,2665,3498,6163,37.513844,126.919357
영등포구,257, 신길삼거리(우리은행),201908,2490,3273,5763,37.513844,126.919357
영등포구,257, 신길삼거리(우리은행),201909,2303,3026,5329,37.513844,126.919357
영등포구,257, 신길삼거리(우리은행),201910,2642,3387,6029,37.513844,126.919357
영등포구,257, 신길삼거리(우리은행),201911,1526,2466,3992,37.513844,126.919357
영등포구,257, 신길삼거리(우리은행),201912,958,1309,2267,37.513844,126.919357
영등포구,257, 신길삼거리(우리은행),202001,929,1188,2117,37.513844,126.919357
영등포구,257, 신길삼거리(우리은행),202002,967,1237,2204,37.513844,126.919357
영등포구,257, 신길삼거리(우리은행),202003,2003,2262,4265,37.513844,126.919357
영등포구,257, 신길삼거리(우리은행),202004,2890,3271,6161,37.513844,126.919357
영등포구,257, 신길삼거리(우리은행),202005,3377,3495,6872,37.513844,126.919357
영등포구,257, 신길삼거리(우리은행),202006,3453,3870,7323,37.513844,126.919357
영등포구,258, 신길역3번출구,201901,319,314,633,37.517693,126.914299
영등포구,258, 신길역3번출구,201902,295,295,590,37.517693,126.914299
영등포구,258, 신길역3번출구,201903,579,544,1123,37.517693,126.914299
영등포구,258, 신길역3번출구,201904,1112,994,2106,37.517693,126.914299
영등포구,258, 신길역3번출구,201905,1677,1491,3168,37.517693,126.914299
영등포구,258, 신길역3번출구,201906,1780,1689,3469,37.517693,126.914299
영등포구,258, 신길역3번출구,201907,1589,1414,3003,37.517693,126.914299
영등포구,258, 신길역3번출구,201908,1601,1432,3033,37.517693,126.914299
영등포구,258, 신길역3번출구,201909,1351,1240,2591,37.517693,126.914299
영등포구,258, 신길역3번출구,201910,1532,1500,3032,37.517693,126.914299
영등포구,258, 신길역3번출구,201911,993,927,1920,37.517693,126.914299
영등포구,258, 신길역3번출구,201912,593,538,1131,37.517693,126.914299
영등포구,258, 신길역3번출구,202001,468,427,895,37.517693,126.914299
영등포구,258, 신길역3번출구,202002,491,458,949,37.517693,126.914299
영등포구,258, 신길역3번출구,202003,962,918,1880,37.517693,126.914299
영등포구,258, 신길역3번출구,202004,1326,1314,2640,37.517693,126.914299
영등포구,258, 신길역3번출구,202005,1387,1345,2732,37.517693,126.914299
영등포구,258, 신길역3번출구,202006,1511,1480,2991,37.517693,126.914299
영등포구,259, 대방역6번출구,201901,1113,1126,2239,37.513592,126.925934
영등포구,259, 대방역6번출구,201902,862,935,1797,37.513592,126.925934
영등포구,259, 대방역6번출구,201903,1810,1621,3431,37.513592,126.925934
영등포구,259, 대방역6번출구,201904,2492,2474,4966,37.513592,126.925934
영등포구,259, 대방역6번출구,201905,3467,3354,6821,37.513592,126.925934
영등포구,259, 대방역6번출구,201906,3413,3306,6719,37.513592,126.925934
영등포구,259, 대방역6번출구,201907,3262,3113,6375,37.513592,126.925934
영등포구,259, 대방역6번출구,201908,3099,2930,6029,37.513592,126.925934
영등포구,259, 대방역6번출구,201909,2882,2751,5633,37.513592,126.925934
영등포구,259, 대방역6번출구,201910,3527,3342,6869,37.513592,126.925934
영등포구,259, 대방역6번출구,201911,2427,2268,4695,37.513592,126.925934
영등포구,259, 대방역6번출구,201912,1401,1349,2750,37.513592,126.925934
영등포구,259, 대방역6번출구,202001,1271,1245,2516,37.513592,126.925934
영등포구,259, 대방역6번출구,202002,1094,1108,2202,37.513592,126.925934
영등포구,259, 대방역6번출구,202003,2132,2168,4300,37.513592,126.925934
영등포구,259, 대방역6번출구,202004,3106,3240,6346,37.513592,126.925934
영등포구,259, 대방역6번출구,202005,3305,3331,6636,37.513592,126.925934
영등포구,259, 대방역6번출구,202006,3818,3852,7670,37.513592,126.925934
영등포구,260, 여의도 마리나선착장 앞,201901,150,144,294,37.53368,126.912086
영등포구,260, 여의도 마리나선착장 앞,201902,186,153,339,37.53368,126.912086
영등포구,260, 여의도 마리나선착장 앞,201903,324,279,603,37.53368,126.912086
영등포구,260, 여의도 마리나선착장 앞,201904,760,752,1512,37.53368,126.912086
영등포구,260, 여의도 마리나선착장 앞,201905,919,891,1810,37.53368,126.912086
영등포구,260, 여의도 마리나선착장 앞,201906,1011,974,1985,37.53368,126.912086
영등포구,260, 여의도 마리나선착장 앞,201907,929,892,1821,37.53368,126.912086
영등포구,260, 여의도 마리나선착장 앞,201908,898,839,1737,37.53368,126.912086
영등포구,260, 여의도 마리나선착장 앞,201909,1139,1006,2145,37.53368,126.912086
영등포구,260, 여의도 마리나선착장 앞,201910,1049,1017,2066,37.53368,126.912086
영등포구,260, 여의도 마리나선착장 앞,201911,458,341,799,37.53368,126.912086
영등포구,260, 여의도 마리나선착장 앞,201912,219,186,405,37.53368,126.912086
영등포구,260, 여의도 마리나선착장 앞,202001,220,192,412,37.53368,126.912086
영등포구,260, 여의도 마리나선착장 앞,202002,317,297,614,37.53368,126.912086
영등포구,260, 여의도 마리나선착장 앞,202003,837,856,1693,37.53368,126.912086
영등포구,260, 여의도 마리나선착장 앞,202004,602,606,1208,37.53368,126.912086
영등포구,260, 여의도 마리나선착장 앞,202005,1166,1146,2312,37.53368,126.912086
영등포구,260, 여의도 마리나선착장 앞,202006,951,946,1897,37.53368,126.912086
영등포구,262, 영문초등학교 사거리,201901,667,815,1482,37.519928,126.889183
영등포구,262, 영문초등학교 사거리,201902,526,604,1130,37.519928,126.889183
영등포구,262, 영문초등학교 사거리,201903,1107,1165,2272,37.519928,126.889183
영등포구,262, 영문초등학교 사거리,201904,1735,1735,3470,37.519928,126.889183
영등포구,262, 영문초등학교 사거리,201905,2527,2535,5062,37.519928,126.889183
영등포구,262, 영문초등학교 사거리,201906,3169,3153,6322,37.519928,126.889183
영등포구,262, 영문초등학교 사거리,201907,2943,2955,5898,37.519928,126.889183
영등포구,262, 영문초등학교 사거리,201908,2971,3008,5979,37.519928,126.889183
영등포구,262, 영문초등학교 사거리,201909,2593,2640,5233,37.519928,126.889183
영등포구,262, 영문초등학교 사거리,201910,3448,3497,6945,37.519928,126.889183
영등포구,262, 영문초등학교 사거리,201911,2457,2500,4957,37.519928,126.889183
영등포구,262, 영문초등학교 사거리,201912,1529,1557,3086,37.519928,126.889183
영등포구,262, 영문초등학교 사거리,202001,1142,1165,2307,37.519928,126.889183
영등포구,262, 영문초등학교 사거리,202002,1221,1228,2449,37.519928,126.889183
영등포구,262, 영문초등학교 사거리,202003,1909,1915,3824,37.519928,126.889183
영등포구,262, 영문초등학교 사거리,202004,2512,2484,4996,37.519928,126.889183
영등포구,262, 영문초등학교 사거리,202005,3117,3137,6254,37.519928,126.889183
영등포구,262, 영문초등학교 사거리,202006,3584,3590,7174,37.519928,126.889183
영등포구,263, 근로자회관 사거리,201901,747,792,1539,37.517151,126.888626
영등포구,263, 근로자회관 사거리,201902,596,646,1242,37.517151,126.888626
영등포구,263, 근로자회관 사거리,201903,1122,1100,2222,37.517151,126.888626
영등포구,263, 근로자회관 사거리,201904,1510,1538,3048,37.517151,126.888626
영등포구,263, 근로자회관 사거리,201905,2324,2308,4632,37.517151,126.888626
영등포구,263, 근로자회관 사거리,201906,2251,2239,4490,37.517151,126.888626
영등포구,263, 근로자회관 사거리,201907,2374,2342,4716,37.517151,126.888626
영등포구,263, 근로자회관 사거리,201908,2413,2422,4835,37.517151,126.888626
영등포구,263, 근로자회관 사거리,201909,2265,2287,4552,37.517151,126.888626
영등포구,263, 근로자회관 사거리,201910,2858,2861,5719,37.517151,126.888626
영등포구,263, 근로자회관 사거리,201911,1951,1945,3896,37.517151,126.888626
영등포구,263, 근로자회관 사거리,201912,1319,1326,2645,37.517151,126.888626
영등포구,263, 근로자회관 사거리,202001,1195,1200,2395,37.517151,126.888626
영등포구,263, 근로자회관 사거리,202002,1102,1108,2210,37.517151,126.888626
영등포구,263, 근로자회관 사거리,202003,1679,1679,3358,37.517151,126.888626
영등포구,263, 근로자회관 사거리,202004,2661,2662,5323,37.517151,126.888626
영등포구,263, 근로자회관 사거리,202005,3230,3243,6473,37.517151,126.888626
영등포구,263, 근로자회관 사거리,202006,3661,3687,7348,37.517151,126.888626
영등포구,264, 교보생명보험 앞,201901,446,394,840,37.521931,126.891617
영등포구,264, 교보생명보험 앞,201902,342,296,638,37.521931,126.891617
영등포구,264, 교보생명보험 앞,201903,691,583,1274,37.521931,126.891617
영등포구,264, 교보생명보험 앞,201904,974,825,1799,37.521931,126.891617
영등포구,264, 교보생명보험 앞,201905,1351,1177,2528,37.521931,126.891617
영등포구,264, 교보생명보험 앞,201906,1668,1272,2940,37.521931,126.891617
영등포구,264, 교보생명보험 앞,201907,1620,1311,2931,37.521931,126.891617
영등포구,264, 교보생명보험 앞,201908,1453,1253,2706,37.521931,126.891617
영등포구,264, 교보생명보험 앞,201909,1294,1107,2401,37.521931,126.891617
영등포구,264, 교보생명보험 앞,201910,1582,1447,3029,37.521931,126.891617
영등포구,264, 교보생명보험 앞,201911,1217,1026,2243,37.521931,126.891617
영등포구,264, 교보생명보험 앞,201912,793,712,1505,37.521931,126.891617
영등포구,264, 교보생명보험 앞,202001,688,612,1300,37.521931,126.891617
영등포구,264, 교보생명보험 앞,202002,725,596,1321,37.521931,126.891617
영등포구,264, 교보생명보험 앞,202003,1039,897,1936,37.521931,126.891617
영등포구,264, 교보생명보험 앞,202004,1308,1194,2502,37.521931,126.891617
영등포구,264, 교보생명보험 앞,202005,1450,1345,2795,37.521931,126.891617
영등포구,264, 교보생명보험 앞,202006,1571,1477,3048,37.521931,126.891617
영등포구,265, 영등포유통상가 사거리,201901,368,282,650,37.521133,126.896538
영등포구,265, 영등포유통상가 사거리,201902,293,241,534,37.521133,126.896538
영등포구,265, 영등포유통상가 사거리,201903,471,446,917,37.521133,126.896538
영등포구,265, 영등포유통상가 사거리,201904,794,673,1467,37.521133,126.896538
영등포구,265, 영등포유통상가 사거리,201905,1133,993,2126,37.521133,126.896538
영등포구,265, 영등포유통상가 사거리,201906,1239,1078,2317,37.521133,126.896538
영등포구,265, 영등포유통상가 사거리,201907,1151,1041,2192,37.521133,126.896538
영등포구,265, 영등포유통상가 사거리,201908,1289,1165,2454,37.521133,126.896538
영등포구,265, 영등포유통상가 사거리,201909,1050,949,1999,37.521133,126.896538
영등포구,265, 영등포유통상가 사거리,201910,1299,1195,2494,37.521133,126.896538
영등포구,265, 영등포유통상가 사거리,201911,948,830,1778,37.521133,126.896538
영등포구,265, 영등포유통상가 사거리,201912,544,471,1015,37.521133,126.896538
영등포구,265, 영등포유통상가 사거리,202001,503,427,930,37.521133,126.896538
영등포구,265, 영등포유통상가 사거리,202002,481,404,885,37.521133,126.896538
영등포구,265, 영등포유통상가 사거리,202003,786,728,1514,37.521133,126.896538
영등포구,265, 영등포유통상가 사거리,202004,1154,1112,2266,37.521133,126.896538
영등포구,265, 영등포유통상가 사거리,202005,1343,1337,2680,37.521133,126.896538
영등포구,265, 영등포유통상가 사거리,202006,1557,1503,3060,37.521133,126.896538
영등포구,266, 영등포청과시장 사거리,201901,229,238,467,37.520294,126.901192
영등포구,266, 영등포청과시장 사거리,201902,226,229,455,37.520294,126.901192
영등포구,266, 영등포청과시장 사거리,201903,495,503,998,37.520294,126.901192
영등포구,266, 영등포청과시장 사거리,201904,681,614,1295,37.520294,126.901192
영등포구,266, 영등포청과시장 사거리,201905,1018,896,1914,37.520294,126.901192
영등포구,266, 영등포청과시장 사거리,201906,1127,1035,2162,37.520294,126.901192
영등포구,266, 영등포청과시장 사거리,201907,1048,966,2014,37.520294,126.901192
영등포구,266, 영등포청과시장 사거리,201908,1103,970,2073,37.520294,126.901192
영등포구,266, 영등포청과시장 사거리,201909,903,834,1737,37.520294,126.901192
영등포구,266, 영등포청과시장 사거리,201910,1077,1018,2095,37.520294,126.901192
영등포구,266, 영등포청과시장 사거리,201911,754,735,1489,37.520294,126.901192
영등포구,266, 영등포청과시장 사거리,201912,422,395,817,37.520294,126.901192
영등포구,266, 영등포청과시장 사거리,202001,381,352,733,37.520294,126.901192
영등포구,266, 영등포청과시장 사거리,202002,384,353,737,37.520294,126.901192
영등포구,266, 영등포청과시장 사거리,202003,530,428,958,37.520294,126.901192
영등포구,266, 영등포청과시장 사거리,202004,699,648,1347,37.520294,126.901192
영등포구,266, 영등포청과시장 사거리,202005,732,721,1453,37.520294,126.901192
영등포구,266, 영등포청과시장 사거리,202006,877,818,1695,37.520294,126.901192
영등포구,267, 삼성화재 사옥 옆,201901,299,271,570,37.535961,126.8983
영등포구,267, 삼성화재 사옥 옆,201902,309,271,580,37.535961,126.8983
영등포구,267, 삼성화재 사옥 옆,201903,629,570,1199,37.535961,126.8983
영등포구,267, 삼성화재 사옥 옆,201904,1036,1008,2044,37.535961,126.8983
영등포구,267, 삼성화재 사옥 옆,201905,1537,1531,3068,37.535961,126.8983
영등포구,267, 삼성화재 사옥 옆,201906,1647,1626,3273,37.535961,126.8983
영등포구,267, 삼성화재 사옥 옆,201907,1547,1493,3040,37.535961,126.8983
영등포구,267, 삼성화재 사옥 옆,201908,1470,1438,2908,37.535961,126.8983
영등포구,267, 삼성화재 사옥 옆,201909,1675,1618,3293,37.535961,126.8983
영등포구,267, 삼성화재 사옥 옆,201910,1738,1702,3440,37.535961,126.8983
영등포구,267, 삼성화재 사옥 옆,201911,1099,1091,2190,37.535961,126.8983
영등포구,267, 삼성화재 사옥 옆,201912,525,532,1057,37.535961,126.8983
영등포구,267, 삼성화재 사옥 옆,202001,502,504,1006,37.535961,126.8983
영등포구,267, 삼성화재 사옥 옆,202002,513,473,986,37.535961,126.8983
영등포구,267, 삼성화재 사옥 옆,202003,1346,1311,2657,37.535961,126.8983
영등포구,267, 삼성화재 사옥 옆,202004,1821,1803,3624,37.535961,126.8983
영등포구,267, 삼성화재 사옥 옆,202005,2157,2164,4321,37.535961,126.8983
영등포구,267, 삼성화재 사옥 옆,202006,2067,2011,4078,37.535961,126.8983
영등포구,268, 그랜드컨벤션센터 앞,201901,409,350,759,37.534718,126.900002
영등포구,268, 그랜드컨벤션센터 앞,201902,348,295,643,37.534718,126.900002
영등포구,268, 그랜드컨벤션센터 앞,201903,662,599,1261,37.534718,126.900002
영등포구,268, 그랜드컨벤션센터 앞,201904,1063,997,2060,37.534718,126.900002
영등포구,268, 그랜드컨벤션센터 앞,201905,1662,1628,3290,37.534718,126.900002
영등포구,268, 그랜드컨벤션센터 앞,201906,1968,1945,3913,37.534718,126.900002
영등포구,268, 그랜드컨벤션센터 앞,201907,1865,1862,3727,37.534718,126.900002
영등포구,268, 그랜드컨벤션센터 앞,201908,1715,1707,3422,37.534718,126.900002
영등포구,268, 그랜드컨벤션센터 앞,201909,1629,1685,3314,37.534718,126.900002
영등포구,268, 그랜드컨벤션센터 앞,201910,1980,1977,3957,37.534718,126.900002
영등포구,268, 그랜드컨벤션센터 앞,201911,1322,1349,2671,37.534718,126.900002
영등포구,268, 그랜드컨벤션센터 앞,201912,788,790,1578,37.534718,126.900002
영등포구,268, 그랜드컨벤션센터 앞,202001,662,677,1339,37.534718,126.900002
영등포구,268, 그랜드컨벤션센터 앞,202002,638,654,1292,37.534718,126.900002
영등포구,268, 그랜드컨벤션센터 앞,202003,1228,1247,2475,37.534718,126.900002
영등포구,268, 그랜드컨벤션센터 앞,202004,1718,1721,3439,37.534718,126.900002
영등포구,268, 그랜드컨벤션센터 앞,202005,2057,2049,4106,37.534718,126.900002
영등포구,268, 그랜드컨벤션센터 앞,202006,2266,2262,4528,37.534718,126.900002
영등포구,270, 증권거래소후문교차로,201901,279,291,570,37.522343,126.927101
영등포구,270, 증권거래소후문교차로,201902,199,193,392,37.522343,126.927101
영등포구,270, 증권거래소후문교차로,201903,397,378,775,37.522343,126.927101
영등포구,270, 증권거래소후문교차로,201904,569,554,1123,37.522343,126.927101
영등포구,270, 증권거래소후문교차로,201905,769,735,1504,37.522343,126.927101
영등포구,270, 증권거래소후문교차로,201906,697,700,1397,37.522343,126.927101
영등포구,270, 증권거래소후문교차로,201907,783,766,1549,37.522343,126.927101
영등포구,270, 증권거래소후문교차로,201908,711,699,1410,37.522343,126.927101
영등포구,270, 증권거래소후문교차로,201909,751,748,1499,37.522343,126.927101
영등포구,270, 증권거래소후문교차로,201910,956,961,1917,37.522343,126.927101
영등포구,270, 증권거래소후문교차로,201911,621,622,1243,37.522343,126.927101
영등포구,270, 증권거래소후문교차로,201912,352,355,707,37.522343,126.927101
영등포구,270, 증권거래소후문교차로,202001,317,320,637,37.522343,126.927101
영등포구,270, 증권거래소후문교차로,202002,343,347,690,37.522343,126.927101
영등포구,270, 증권거래소후문교차로,202003,670,635,1305,37.522343,126.927101
영등포구,270, 증권거래소후문교차로,202004,953,940,1893,37.522343,126.927101
영등포구,270, 증권거래소후문교차로,202005,1071,1052,2123,37.522343,126.927101
영등포구,270, 증권거래소후문교차로,202006,1064,1062,2126,37.522343,126.927101
영등포구,271, 샛강생태공원방문자센터 앞,201901,201,193,394,37.518963,126.921616
영등포구,271, 샛강생태공원방문자센터 앞,201902,143,138,281,37.518963,126.921616
영등포구,271, 샛강생태공원방문자센터 앞,201903,308,234,542,37.518963,126.921616
영등포구,271, 샛강생태공원방문자센터 앞,201904,517,468,985,37.518963,126.921616
영등포구,271, 샛강생태공원방문자센터 앞,201905,564,512,1076,37.518963,126.921616
영등포구,271, 샛강생태공원방문자센터 앞,201906,543,532,1075,37.518963,126.921616
영등포구,271, 샛강생태공원방문자센터 앞,201907,472,413,885,37.518963,126.921616
영등포구,271, 샛강생태공원방문자센터 앞,201908,438,438,876,37.518963,126.921616
영등포구,271, 샛강생태공원방문자센터 앞,201909,443,420,863,37.518963,126.921616
영등포구,271, 샛강생태공원방문자센터 앞,201910,518,491,1009,37.518963,126.921616
영등포구,271, 샛강생태공원방문자센터 앞,201911,290,266,556,37.518963,126.921616
영등포구,271, 샛강생태공원방문자센터 앞,201912,168,164,332,37.518963,126.921616
영등포구,271, 샛강생태공원방문자센터 앞,202001,175,169,344,37.518963,126.921616
영등포구,271, 샛강생태공원방문자센터 앞,202002,167,163,330,37.518963,126.921616
영등포구,271, 샛강생태공원방문자센터 앞,202003,540,509,1049,37.518963,126.921616
영등포구,271, 샛강생태공원방문자센터 앞,202004,813,776,1589,37.518963,126.921616
영등포구,271, 샛강생태공원방문자센터 앞,202005,741,738,1479,37.518963,126.921616
영등포구,271, 샛강생태공원방문자센터 앞,202006,757,744,1501,37.518963,126.921616
영등포구,272, 당산육갑문,201901,462,468,930,37.535339,126.903679
영등포구,272, 당산육갑문,201902,540,621,1161,37.535339,126.903679
영등포구,272, 당산육갑문,201903,1444,1679,3123,37.535339,126.903679
영등포구,272, 당산육갑문,201904,3357,3672,7029,37.535339,126.903679
영등포구,272, 당산육갑문,201905,5250,5612,10862,37.535339,126.903679
영등포구,272, 당산육갑문,201906,5453,5520,10973,37.535339,126.903679
영등포구,272, 당산육갑문,201907,4366,4399,8765,37.535339,126.903679
영등포구,272, 당산육갑문,201908,5284,5319,10603,37.535339,126.903679
영등포구,272, 당산육갑문,201909,5567,5607,11174,37.535339,126.903679
영등포구,272, 당산육갑문,201910,5728,5775,11503,37.535339,126.903679
영등포구,272, 당산육갑문,201911,2387,2425,4812,37.535339,126.903679
영등포구,272, 당산육갑문,201912,858,878,1736,37.535339,126.903679
영등포구,272, 당산육갑문,202001,838,870,1708,37.535339,126.903679
영등포구,272, 당산육갑문,202002,1271,1332,2603,37.535339,126.903679
영등포구,272, 당산육갑문,202003,5436,5962,11398,37.535339,126.903679
영등포구,272, 당산육갑문,202004,7678,8058,15736,37.535339,126.903679
영등포구,272, 당산육갑문,202005,9168,9503,18671,37.535339,126.903679
영등포구,272, 당산육갑문,202006,7958,8127,16085,37.535339,126.903679
영등포구,274, 영등포역지하쇼핑센타 5번출구,201901,711,1010,1721,37.516651,126.90799
영등포구,274, 영등포역지하쇼핑센타 5번출구,201902,667,974,1641,37.516651,126.90799
영등포구,274, 영등포역지하쇼핑센타 5번출구,201903,1443,1901,3344,37.516651,126.90799
영등포구,274, 영등포역지하쇼핑센타 5번출구,201904,2386,2898,5284,37.516651,126.90799
영등포구,274, 영등포역지하쇼핑센타 5번출구,201905,3872,4450,8322,37.516651,126.90799
영등포구,274, 영등포역지하쇼핑센타 5번출구,201906,4389,4660,9049,37.516651,126.90799
영등포구,274, 영등포역지하쇼핑센타 5번출구,201907,3830,4168,7998,37.516651,126.90799
영등포구,274, 영등포역지하쇼핑센타 5번출구,201908,3653,3815,7468,37.516651,126.90799
영등포구,274, 영등포역지하쇼핑센타 5번출구,201909,3760,3867,7627,37.516651,126.90799
영등포구,274, 영등포역지하쇼핑센타 5번출구,201910,4769,4976,9745,37.516651,126.90799
영등포구,274, 영등포역지하쇼핑센타 5번출구,201911,2994,3349,6343,37.516651,126.90799
영등포구,274, 영등포역지하쇼핑센타 5번출구,201912,1751,1911,3662,37.516651,126.90799
영등포구,274, 영등포역지하쇼핑센타 5번출구,202001,1499,1726,3225,37.516651,126.90799
영등포구,274, 영등포역지하쇼핑센타 5번출구,202002,1348,1596,2944,37.516651,126.90799
영등포구,274, 영등포역지하쇼핑센타 5번출구,202003,2645,2840,5485,37.516651,126.90799
영등포구,274, 영등포역지하쇼핑센타 5번출구,202004,3998,4180,8178,37.516651,126.90799
영등포구,274, 영등포역지하쇼핑센타 5번출구,202005,4804,4813,9617,37.516651,126.90799
영등포구,274, 영등포역지하쇼핑센타 5번출구,202006,4913,4945,9858,37.516651,126.90799
영등포구,275, 신동아아파트,201901,562,653,1215,37.522816,126.885651
영등포구,275, 신동아아파트,201902,418,518,936,37.522816,126.885651
영등포구,275, 신동아아파트,201903,890,1008,1898,37.522816,126.885651
영등포구,275, 신동아아파트,201904,1361,1459,2820,37.522816,126.885651
영등포구,275, 신동아아파트,201905,2262,2416,4678,37.522816,126.885651
영등포구,275, 신동아아파트,201906,2648,2686,5334,37.522816,126.885651
영등포구,275, 신동아아파트,201907,2561,2587,5148,37.522816,126.885651
영등포구,275, 신동아아파트,201908,2556,2583,5139,37.522816,126.885651
영등포구,275, 신동아아파트,201909,2183,2389,4572,37.522816,126.885651
영등포구,275, 신동아아파트,201910,2901,3084,5985,37.522816,126.885651
영등포구,275, 신동아아파트,201911,1890,1947,3837,37.522816,126.885651
영등포구,275, 신동아아파트,201912,1111,1141,2252,37.522816,126.885651
영등포구,275, 신동아아파트,202001,883,895,1778,37.522816,126.885651
영등포구,275, 신동아아파트,202002,933,948,1881,37.522816,126.885651
영등포구,275, 신동아아파트,202003,1949,1914,3863,37.522816,126.885651
영등포구,275, 신동아아파트,202004,2466,2455,4921,37.522816,126.885651
영등포구,275, 신동아아파트,202005,2912,2926,5838,37.522816,126.885651
영등포구,275, 신동아아파트,202006,2823,2831,5654,37.522816,126.885651
영등포구,276, SK 영등포주유소,201901,389,437,826,37.518284,126.912636
영등포구,276, SK 영등포주유소,201902,348,376,724,37.518284,126.912636
영등포구,276, SK 영등포주유소,201903,765,735,1500,37.518284,126.912636
영등포구,276, SK 영등포주유소,201904,1356,1283,2639,37.518284,126.912636
영등포구,276, SK 영등포주유소,201905,2051,1884,3935,37.518284,126.912636
영등포구,276, SK 영등포주유소,201906,2006,1888,3894,37.518284,126.912636
영등포구,276, SK 영등포주유소,201907,1735,1670,3405,37.518284,126.912636
영등포구,276, SK 영등포주유소,201908,1834,1808,3642,37.518284,126.912636
영등포구,276, SK 영등포주유소,201909,1707,1626,3333,37.518284,126.912636
영등포구,276, SK 영등포주유소,201910,2004,2001,4005,37.518284,126.912636
영등포구,276, SK 영등포주유소,201911,1287,1205,2492,37.518284,126.912636
영등포구,276, SK 영등포주유소,201912,759,703,1462,37.518284,126.912636
영등포구,276, SK 영등포주유소,202001,668,640,1308,37.518284,126.912636
영등포구,276, SK 영등포주유소,202002,674,671,1345,37.518284,126.912636
영등포구,276, SK 영등포주유소,202003,1366,1341,2707,37.518284,126.912636
영등포구,276, SK 영등포주유소,202004,1793,1771,3564,37.518284,126.912636
영등포구,276, SK 영등포주유소,202005,1936,1891,3827,37.518284,126.912636
영등포구,276, SK 영등포주유소,202006,2094,2105,4199,37.518284,126.912636
영등포구,277, 영등포뉴타운지하상가 2번게이트,201901,359,385,744,37.520119,126.905167
영등포구,277, 영등포뉴타운지하상가 2번게이트,201902,351,364,715,37.520119,126.905167
영등포구,277, 영등포뉴타운지하상가 2번게이트,201903,606,612,1218,37.520119,126.905167
영등포구,277, 영등포뉴타운지하상가 2번게이트,201904,984,972,1956,37.520119,126.905167
영등포구,277, 영등포뉴타운지하상가 2번게이트,201905,1644,1609,3253,37.520119,126.905167
영등포구,277, 영등포뉴타운지하상가 2번게이트,201906,1762,1757,3519,37.520119,126.905167
영등포구,277, 영등포뉴타운지하상가 2번게이트,201907,1634,1648,3282,37.520119,126.905167
영등포구,277, 영등포뉴타운지하상가 2번게이트,201908,1564,1539,3103,37.520119,126.905167
영등포구,277, 영등포뉴타운지하상가 2번게이트,201909,1505,1481,2986,37.520119,126.905167
영등포구,277, 영등포뉴타운지하상가 2번게이트,201910,1908,1881,3789,37.520119,126.905167
영등포구,277, 영등포뉴타운지하상가 2번게이트,201911,1252,1231,2483,37.520119,126.905167
영등포구,277, 영등포뉴타운지하상가 2번게이트,201912,818,816,1634,37.520119,126.905167
영등포구,277, 영등포뉴타운지하상가 2번게이트,202001,656,667,1323,37.520119,126.905167
영등포구,277, 영등포뉴타운지하상가 2번게이트,202002,642,685,1327,37.520119,126.905167
영등포구,277, 영등포뉴타운지하상가 2번게이트,202003,1141,1114,2255,37.520119,126.905167
영등포구,277, 영등포뉴타운지하상가 2번게이트,202004,1753,1733,3486,37.520119,126.905167
영등포구,277, 영등포뉴타운지하상가 2번게이트,202005,1913,1910,3823,37.520119,126.905167
영등포구,277, 영등포뉴타운지하상가 2번게이트,202006,2015,2012,4027,37.520119,126.905167
영등포구,278, 쌍용플레티넘오피스텔,201901,445,429,874,37.507931,126.895233
영등포구,278, 쌍용플레티넘오피스텔,201902,349,353,702,37.507931,126.895233
영등포구,278, 쌍용플레티넘오피스텔,201903,684,659,1343,37.507931,126.895233
영등포구,278, 쌍용플레티넘오피스텔,201904,1092,1014,2106,37.507931,126.895233
영등포구,278, 쌍용플레티넘오피스텔,201905,1932,1814,3746,37.507931,126.895233
영등포구,278, 쌍용플레티넘오피스텔,201906,2195,2104,4299,37.507931,126.895233
영등포구,278, 쌍용플레티넘오피스텔,201907,2060,1919,3979,37.507931,126.895233
영등포구,278, 쌍용플레티넘오피스텔,201908,1965,1836,3801,37.507931,126.895233
영등포구,278, 쌍용플레티넘오피스텔,201909,1537,1504,3041,37.507931,126.895233
영등포구,278, 쌍용플레티넘오피스텔,201910,1976,1905,3881,37.507931,126.895233
영등포구,278, 쌍용플레티넘오피스텔,201911,1169,1098,2267,37.507931,126.895233
영등포구,278, 쌍용플레티넘오피스텔,201912,656,621,1277,37.507931,126.895233
영등포구,278, 쌍용플레티넘오피스텔,202001,644,634,1278,37.507931,126.895233
영등포구,278, 쌍용플레티넘오피스텔,202002,733,617,1350,37.507931,126.895233
영등포구,278, 쌍용플레티넘오피스텔,202003,1362,1241,2603,37.507931,126.895233
영등포구,278, 쌍용플레티넘오피스텔,202004,2286,2245,4531,37.507931,126.895233
영등포구,278, 쌍용플레티넘오피스텔,202005,2481,2459,4940,37.507931,126.895233
영등포구,278, 쌍용플레티넘오피스텔,202006,2697,2665,5362,37.507931,126.895233
영등포구,279, 영등포 푸르지오 아파트,201901,381,312,693,37.513229,126.904465
영등포구,279, 영등포 푸르지오 아파트,201902,337,307,644,37.513229,126.904465
영등포구,279, 영등포 푸르지오 아파트,201903,667,593,1260,37.513229,126.904465
영등포구,279, 영등포 푸르지오 아파트,201904,1019,900,1919,37.513229,126.904465
영등포구,279, 영등포 푸르지오 아파트,201905,1807,1656,3463,37.513229,126.904465
영등포구,279, 영등포 푸르지오 아파트,201906,2169,2044,4213,37.513229,126.904465
영등포구,279, 영등포 푸르지오 아파트,201907,2207,2021,4228,37.513229,126.904465
영등포구,279, 영등포 푸르지오 아파트,201908,1918,1777,3695,37.513229,126.904465
영등포구,279, 영등포 푸르지오 아파트,201909,1891,1770,3661,37.513229,126.904465
영등포구,279, 영등포 푸르지오 아파트,201910,2079,2013,4092,37.513229,126.904465
영등포구,279, 영등포 푸르지오 아파트,201911,1403,1382,2785,37.513229,126.904465
영등포구,279, 영등포 푸르지오 아파트,201912,815,795,1610,37.513229,126.904465
영등포구,279, 영등포 푸르지오 아파트,202001,736,711,1447,37.513229,126.904465
영등포구,279, 영등포 푸르지오 아파트,202002,695,664,1359,37.513229,126.904465
영등포구,279, 영등포 푸르지오 아파트,202003,1008,1019,2027,37.513229,126.904465
영등포구,279, 영등포 푸르지오 아파트,202004,1698,1613,3311,37.513229,126.904465
영등포구,279, 영등포 푸르지오 아파트,202005,1924,1862,3786,37.513229,126.904465
영등포구,279, 영등포 푸르지오 아파트,202006,2078,1806,3884,37.513229,126.904465
영등포구,280, 양평동6차현대아파트 앞,201901,472,430,902,37.532101,126.89444
영등포구,280, 양평동6차현대아파트 앞,201902,343,359,702,37.532101,126.89444
영등포구,280, 양평동6차현대아파트 앞,201903,724,720,1444,37.532101,126.89444
영등포구,280, 양평동6차현대아파트 앞,201904,1095,1100,2195,37.532101,126.89444
영등포구,280, 양평동6차현대아파트 앞,201905,1409,1439,2848,37.532101,126.89444
영등포구,280, 양평동6차현대아파트 앞,201906,1671,1650,3321,37.532101,126.89444
영등포구,280, 양평동6차현대아파트 앞,201907,1702,1747,3449,37.532101,126.89444
영등포구,280, 양평동6차현대아파트 앞,201908,1630,1717,3347,37.532101,126.89444
영등포구,280, 양평동6차현대아파트 앞,201909,1524,1593,3117,37.532101,126.89444
영등포구,280, 양평동6차현대아파트 앞,201910,2109,2079,4188,37.532101,126.89444
영등포구,280, 양평동6차현대아파트 앞,201911,1557,1564,3121,37.532101,126.89444
영등포구,280, 양평동6차현대아파트 앞,201912,1016,1010,2026,37.532101,126.89444
영등포구,280, 양평동6차현대아파트 앞,202001,837,843,1680,37.532101,126.89444
영등포구,280, 양평동6차현대아파트 앞,202002,847,831,1678,37.532101,126.89444
영등포구,280, 양평동6차현대아파트 앞,202003,1208,1225,2433,37.532101,126.89444
영등포구,280, 양평동6차현대아파트 앞,202004,1787,1787,3574,37.532101,126.89444
영등포구,280, 양평동6차현대아파트 앞,202005,1937,1960,3897,37.532101,126.89444
영등포구,280, 양평동6차현대아파트 앞,202006,2304,2321,4625,37.532101,126.89444
영등포구,281, 신동아아파트 앞,201901,126,130,256,37.498241,126.893982
영등포구,281, 신동아아파트 앞,201902,125,130,255,37.498241,126.893982
영등포구,281, 신동아아파트 앞,201903,277,297,574,37.498241,126.893982
영등포구,281, 신동아아파트 앞,201904,436,409,845,37.498241,126.893982
영등포구,281, 신동아아파트 앞,201905,706,678,1384,37.498241,126.893982
영등포구,281, 신동아아파트 앞,201906,999,956,1955,37.498241,126.893982
영등포구,281, 신동아아파트 앞,201907,990,961,1951,37.498241,126.893982
영등포구,281, 신동아아파트 앞,201908,854,844,1698,37.498241,126.893982
영등포구,281, 신동아아파트 앞,201909,902,899,1801,37.498241,126.893982
영등포구,281, 신동아아파트 앞,201910,998,970,1968,37.498241,126.893982
영등포구,281, 신동아아파트 앞,201911,679,680,1359,37.498241,126.893982
영등포구,281, 신동아아파트 앞,201912,375,363,738,37.498241,126.893982
영등포구,281, 신동아아파트 앞,202001,391,405,796,37.498241,126.893982
영등포구,281, 신동아아파트 앞,202002,350,346,696,37.498241,126.893982
영등포구,281, 신동아아파트 앞,202003,619,609,1228,37.498241,126.893982
영등포구,281, 신동아아파트 앞,202004,934,937,1871,37.498241,126.893982
영등포구,281, 신동아아파트 앞,202005,967,977,1944,37.498241,126.893982
영등포구,281, 신동아아파트 앞,202006,1299,1296,2595,37.498241,126.893982
영등포구,282, 신한은행,201901,133,152,285,37.48753,126.904877
영등포구,282, 신한은행,201902,117,113,230,37.48753,126.904877
영등포구,282, 신한은행,201903,162,196,358,37.48753,126.904877
영등포구,282, 신한은행,201904,329,286,615,37.48753,126.904877
영등포구,282, 신한은행,201905,490,452,942,37.48753,126.904877
영등포구,282, 신한은행,201906,612,540,1152,37.48753,126.904877
영등포구,282, 신한은행,201907,511,432,943,37.48753,126.904877
영등포구,282, 신한은행,201908,531,468,999,37.48753,126.904877
영등포구,282, 신한은행,201909,468,452,920,37.48753,126.904877
영등포구,282, 신한은행,201910,528,514,1042,37.48753,126.904877
영등포구,282, 신한은행,201911,385,353,738,37.48753,126.904877
영등포구,282, 신한은행,201912,250,209,459,37.48753,126.904877
영등포구,282, 신한은행,202001,227,174,401,37.48753,126.904877
영등포구,282, 신한은행,202002,214,211,425,37.48753,126.904877
영등포구,282, 신한은행,202003,259,263,522,37.48753,126.904877
영등포구,282, 신한은행,202004,468,463,931,37.48753,126.904877
영등포구,282, 신한은행,202005,502,487,989,37.48753,126.904877
영등포구,282, 신한은행,202006,652,662,1314,37.48753,126.904877
영등포구,283, 아크로타워 스퀘어(영등포시장),201901,493,604,1097,37.522518,126.907219
영등포구,283, 아크로타워 스퀘어(영등포시장),201902,463,526,989,37.522518,126.907219
영등포구,283, 아크로타워 스퀘어(영등포시장),201903,897,955,1852,37.522518,126.907219
영등포구,283, 아크로타워 스퀘어(영등포시장),201904,1486,1540,3026,37.522518,126.907219
영등포구,283, 아크로타워 스퀘어(영등포시장),201905,2402,2464,4866,37.522518,126.907219
영등포구,283, 아크로타워 스퀘어(영등포시장),201906,2568,2689,5257,37.522518,126.907219
영등포구,283, 아크로타워 스퀘어(영등포시장),201907,2615,2673,5288,37.522518,126.907219
영등포구,283, 아크로타워 스퀘어(영등포시장),201908,2491,2588,5079,37.522518,126.907219
영등포구,283, 아크로타워 스퀘어(영등포시장),201909,2412,2450,4862,37.522518,126.907219
영등포구,283, 아크로타워 스퀘어(영등포시장),201910,2881,2942,5823,37.522518,126.907219
영등포구,283, 아크로타워 스퀘어(영등포시장),201911,1789,1925,3714,37.522518,126.907219
영등포구,283, 아크로타워 스퀘어(영등포시장),201912,1029,1054,2083,37.522518,126.907219
영등포구,283, 아크로타워 스퀘어(영등포시장),202001,934,903,1837,37.522518,126.907219
영등포구,283, 아크로타워 스퀘어(영등포시장),202002,899,936,1835,37.522518,126.907219
영등포구,283, 아크로타워 스퀘어(영등포시장),202003,1844,1914,3758,37.522518,126.907219
영등포구,283, 아크로타워 스퀘어(영등포시장),202004,2703,2726,5429,37.522518,126.907219
영등포구,283, 아크로타워 스퀘어(영등포시장),202005,3284,3276,6560,37.522518,126.907219
영등포구,283, 아크로타워 스퀘어(영등포시장),202006,3794,3791,7585,37.522518,126.907219
영등포구,284, 센트럴 푸르지오 시티 앞,201901,825,807,1632,37.518211,126.902229
영등포구,284, 센트럴 푸르지오 시티 앞,201902,768,741,1509,37.518211,126.902229
영등포구,284, 센트럴 푸르지오 시티 앞,201903,1376,1363,2739,37.518211,126.902229
영등포구,284, 센트럴 푸르지오 시티 앞,201904,1968,1933,3901,37.518211,126.902229
영등포구,284, 센트럴 푸르지오 시티 앞,201905,3383,3300,6683,37.518211,126.902229
영등포구,284, 센트럴 푸르지오 시티 앞,201906,3839,3802,7641,37.518211,126.902229
영등포구,284, 센트럴 푸르지오 시티 앞,201907,3568,3502,7070,37.518211,126.902229
영등포구,284, 센트럴 푸르지오 시티 앞,201908,3561,3469,7030,37.518211,126.902229
영등포구,284, 센트럴 푸르지오 시티 앞,201909,3568,3534,7102,37.518211,126.902229
영등포구,284, 센트럴 푸르지오 시티 앞,201910,4269,4251,8520,37.518211,126.902229
영등포구,284, 센트럴 푸르지오 시티 앞,201911,2809,2789,5598,37.518211,126.902229
영등포구,284, 센트럴 푸르지오 시티 앞,201912,1673,1668,3341,37.518211,126.902229
영등포구,284, 센트럴 푸르지오 시티 앞,202001,1507,1492,2999,37.518211,126.902229
영등포구,284, 센트럴 푸르지오 시티 앞,202002,1421,1387,2808,37.518211,126.902229
영등포구,284, 센트럴 푸르지오 시티 앞,202003,2283,2257,4540,37.518211,126.902229
영등포구,284, 센트럴 푸르지오 시티 앞,202004,3422,3407,6829,37.518211,126.902229
영등포구,284, 센트럴 푸르지오 시티 앞,202005,3912,3913,7825,37.518211,126.902229
영등포구,284, 센트럴 푸르지오 시티 앞,202006,4391,4343,8734,37.518211,126.902229
영등포구,285, 대림3동사거리(하나은행),201901,145,197,342,37.499859,126.89724
영등포구,285, 대림3동사거리(하나은행),201902,153,180,333,37.499859,126.89724
영등포구,285, 대림3동사거리(하나은행),201903,226,297,523,37.499859,126.89724
영등포구,285, 대림3동사거리(하나은행),201904,321,412,733,37.499859,126.89724
영등포구,285, 대림3동사거리(하나은행),201905,543,571,1114,37.499859,126.89724
영등포구,285, 대림3동사거리(하나은행),201906,578,684,1262,37.499859,126.89724
영등포구,285, 대림3동사거리(하나은행),201907,684,786,1470,37.499859,126.89724
영등포구,285, 대림3동사거리(하나은행),201908,621,774,1395,37.499859,126.89724
영등포구,285, 대림3동사거리(하나은행),201909,582,654,1236,37.499859,126.89724
영등포구,285, 대림3동사거리(하나은행),201910,722,768,1490,37.499859,126.89724
영등포구,285, 대림3동사거리(하나은행),201911,459,606,1065,37.499859,126.89724
영등포구,285, 대림3동사거리(하나은행),201912,356,404,760,37.499859,126.89724
영등포구,285, 대림3동사거리(하나은행),202001,297,351,648,37.499859,126.89724
영등포구,285, 대림3동사거리(하나은행),202002,253,253,506,37.499859,126.89724
영등포구,285, 대림3동사거리(하나은행),202003,337,341,678,37.499859,126.89724
영등포구,285, 대림3동사거리(하나은행),202004,525,563,1088,37.499859,126.89724
영등포구,285, 대림3동사거리(하나은행),202005,645,655,1300,37.499859,126.89724
영등포구,285, 대림3동사거리(하나은행),202006,764,774,1538,37.499859,126.89724
영등포구,286, 우성아파트 교차로,201901,190,283,473,37.494572,126.89975
영등포구,286, 우성아파트 교차로,201902,172,257,429,37.494572,126.89975
영등포구,286, 우성아파트 교차로,201903,310,386,696,37.494572,126.89975
영등포구,286, 우성아파트 교차로,201904,627,616,1243,37.494572,126.89975
영등포구,286, 우성아파트 교차로,201905,1018,1096,2114,37.494572,126.89975
영등포구,286, 우성아파트 교차로,201906,1271,1412,2683,37.494572,126.89975
영등포구,286, 우성아파트 교차로,201907,1252,1445,2697,37.494572,126.89975
영등포구,286, 우성아파트 교차로,201908,1088,1288,2376,37.494572,126.89975
영등포구,286, 우성아파트 교차로,201909,1166,1316,2482,37.494572,126.89975
영등포구,286, 우성아파트 교차로,201910,1546,1669,3215,37.494572,126.89975
영등포구,286, 우성아파트 교차로,201911,950,1100,2050,37.494572,126.89975
영등포구,286, 우성아파트 교차로,201912,504,657,1161,37.494572,126.89975
영등포구,286, 우성아파트 교차로,202001,460,609,1069,37.494572,126.89975
영등포구,286, 우성아파트 교차로,202002,353,396,749,37.494572,126.89975
영등포구,286, 우성아파트 교차로,202003,581,607,1188,37.494572,126.89975
영등포구,286, 우성아파트 교차로,202004,976,1033,2009,37.494572,126.89975
영등포구,286, 우성아파트 교차로,202005,1356,1382,2738,37.494572,126.89975
영등포구,286, 우성아파트 교차로,202006,1532,1632,3164,37.494572,126.89975
영등포구,287, 영등포전화국사거리 (서강어린이공원),201901,451,460,911,37.525768,126.905739
영등포구,287, 영등포전화국사거리 (서강어린이공원),201902,364,423,787,37.525768,126.905739
영등포구,287, 영등포전화국사거리 (서강어린이공원),201903,764,851,1615,37.525768,126.905739
영등포구,287, 영등포전화국사거리 (서강어린이공원),201904,1266,1368,2634,37.525768,126.905739
영등포구,287, 영등포전화국사거리 (서강어린이공원),201905,2026,2185,4211,37.525768,126.905739
영등포구,287, 영등포전화국사거리 (서강어린이공원),201906,2341,2397,4738,37.525768,126.905739
영등포구,287, 영등포전화국사거리 (서강어린이공원),201907,2425,2457,4882,37.525768,126.905739
영등포구,287, 영등포전화국사거리 (서강어린이공원),201908,2067,2091,4158,37.525768,126.905739
영등포구,287, 영등포전화국사거리 (서강어린이공원),201909,1776,1758,3534,37.525768,126.905739
영등포구,287, 영등포전화국사거리 (서강어린이공원),201910,2281,2265,4546,37.525768,126.905739
영등포구,287, 영등포전화국사거리 (서강어린이공원),201911,1537,1519,3056,37.525768,126.905739
영등포구,287, 영등포전화국사거리 (서강어린이공원),201912,870,867,1737,37.525768,126.905739
영등포구,287, 영등포전화국사거리 (서강어린이공원),202001,696,707,1403,37.525768,126.905739
영등포구,287, 영등포전화국사거리 (서강어린이공원),202002,651,644,1295,37.525768,126.905739
영등포구,287, 영등포전화국사거리 (서강어린이공원),202003,1335,1319,2654,37.525768,126.905739
영등포구,287, 영등포전화국사거리 (서강어린이공원),202004,1844,1813,3657,37.525768,126.905739
영등포구,287, 영등포전화국사거리 (서강어린이공원),202005,2092,2098,4190,37.525768,126.905739
영등포구,287, 영등포전화국사거리 (서강어린이공원),202006,1934,1913,3847,37.525768,126.905739
영등포구,288, 쌍용예가(구청별관),201901,117,133,250,37.528099,126.893387
영등포구,288, 쌍용예가(구청별관),201902,102,116,218,37.528099,126.893387
영등포구,288, 쌍용예가(구청별관),201903,189,204,393,37.528099,126.893387
영등포구,288, 쌍용예가(구청별관),201904,387,377,764,37.528099,126.893387
영등포구,288, 쌍용예가(구청별관),201905,594,575,1169,37.528099,126.893387
영등포구,288, 쌍용예가(구청별관),201906,623,609,1232,37.528099,126.893387
영등포구,288, 쌍용예가(구청별관),201907,702,689,1391,37.528099,126.893387
영등포구,288, 쌍용예가(구청별관),201908,635,623,1258,37.528099,126.893387
영등포구,288, 쌍용예가(구청별관),201909,589,584,1173,37.528099,126.893387
영등포구,288, 쌍용예가(구청별관),201910,920,916,1836,37.528099,126.893387
영등포구,288, 쌍용예가(구청별관),201911,613,632,1245,37.528099,126.893387
영등포구,288, 쌍용예가(구청별관),201912,441,471,912,37.528099,126.893387
영등포구,288, 쌍용예가(구청별관),202001,370,395,765,37.528099,126.893387
영등포구,288, 쌍용예가(구청별관),202002,321,321,642,37.528099,126.893387
영등포구,288, 쌍용예가(구청별관),202003,483,484,967,37.528099,126.893387
영등포구,288, 쌍용예가(구청별관),202004,693,688,1381,37.528099,126.893387
영등포구,288, 쌍용예가(구청별관),202005,750,762,1512,37.528099,126.893387
영등포구,288, 쌍용예가(구청별관),202006,1014,1003,2017,37.528099,126.893387
영등포구,289, 대림3동사거리,201901,107,135,242,37.499809,126.898003
영등포구,289, 대림3동사거리,201902,135,156,291,37.499809,126.898003
영등포구,289, 대림3동사거리,201903,196,257,453,37.499809,126.898003
영등포구,289, 대림3동사거리,201904,407,467,874,37.499809,126.898003
영등포구,289, 대림3동사거리,201905,810,857,1667,37.499809,126.898003
영등포구,289, 대림3동사거리,201906,1059,1172,2231,37.499809,126.898003
영등포구,289, 대림3동사거리,201907,1091,1238,2329,37.499809,126.898003
영등포구,289, 대림3동사거리,201908,964,1062,2026,37.499809,126.898003
영등포구,289, 대림3동사거리,201909,893,902,1795,37.499809,126.898003
영등포구,289, 대림3동사거리,201910,1090,1100,2190,37.499809,126.898003
영등포구,289, 대림3동사거리,201911,702,730,1432,37.499809,126.898003
영등포구,289, 대림3동사거리,201912,444,468,912,37.499809,126.898003
영등포구,289, 대림3동사거리,202001,266,284,550,37.499809,126.898003
영등포구,289, 대림3동사거리,202002,312,332,644,37.499809,126.898003
영등포구,289, 대림3동사거리,202003,496,490,986,37.499809,126.898003
영등포구,289, 대림3동사거리,202004,725,713,1438,37.499809,126.898003
영등포구,289, 대림3동사거리,202005,905,917,1822,37.499809,126.898003
영등포구,289, 대림3동사거리,202006,1137,1134,2271,37.499809,126.898003
영등포구,290, 당산동 SK V1 빌딩,201901,355,297,652,37.531509,126.897827
영등포구,290, 당산동 SK V1 빌딩,201902,322,268,590,37.531509,126.897827
영등포구,290, 당산동 SK V1 빌딩,201903,649,548,1197,37.531509,126.897827
영등포구,290, 당산동 SK V1 빌딩,201904,890,847,1737,37.531509,126.897827
영등포구,290, 당산동 SK V1 빌딩,201905,1324,1266,2590,37.531509,126.897827
영등포구,290, 당산동 SK V1 빌딩,201906,1465,1422,2887,37.531509,126.897827
영등포구,290, 당산동 SK V1 빌딩,201907,1421,1396,2817,37.531509,126.897827
영등포구,290, 당산동 SK V1 빌딩,201908,1376,1377,2753,37.531509,126.897827
영등포구,290, 당산동 SK V1 빌딩,201909,1356,1384,2740,37.531509,126.897827
영등포구,290, 당산동 SK V1 빌딩,201910,1644,1637,3281,37.531509,126.897827
영등포구,290, 당산동 SK V1 빌딩,201911,1153,1145,2298,37.531509,126.897827
영등포구,290, 당산동 SK V1 빌딩,201912,731,731,1462,37.531509,126.897827
영등포구,290, 당산동 SK V1 빌딩,202001,637,643,1280,37.531509,126.897827
영등포구,290, 당산동 SK V1 빌딩,202002,617,593,1210,37.531509,126.897827
영등포구,290, 당산동 SK V1 빌딩,202003,1118,1119,2237,37.531509,126.897827
영등포구,290, 당산동 SK V1 빌딩,202004,1577,1581,3158,37.531509,126.897827
영등포구,290, 당산동 SK V1 빌딩,202005,1723,1724,3447,37.531509,126.897827
영등포구,290, 당산동 SK V1 빌딩,202006,1883,1897,3780,37.531509,126.897827
영등포구,291, 문래동 하이테크 시티,201901,382,349,731,37.513851,126.89888
영등포구,291, 문래동 하이테크 시티,201902,416,376,792,37.513851,126.89888
영등포구,291, 문래동 하이테크 시티,201903,637,657,1294,37.513851,126.89888
영등포구,291, 문래동 하이테크 시티,201904,1001,1094,2095,37.513851,126.89888
영등포구,291, 문래동 하이테크 시티,201905,1599,1717,3316,37.513851,126.89888
영등포구,291, 문래동 하이테크 시티,201906,1613,1692,3305,37.513851,126.89888
영등포구,291, 문래동 하이테크 시티,201907,1666,1699,3365,37.513851,126.89888
영등포구,291, 문래동 하이테크 시티,201908,1734,1744,3478,37.513851,126.89888
영등포구,291, 문래동 하이테크 시티,201909,1590,1630,3220,37.513851,126.89888
영등포구,291, 문래동 하이테크 시티,201910,1962,2024,3986,37.513851,126.89888
영등포구,291, 문래동 하이테크 시티,201911,1408,1395,2803,37.513851,126.89888
영등포구,291, 문래동 하이테크 시티,201912,832,818,1650,37.513851,126.89888
영등포구,291, 문래동 하이테크 시티,202001,797,811,1608,37.513851,126.89888
영등포구,291, 문래동 하이테크 시티,202002,798,813,1611,37.513851,126.89888
영등포구,291, 문래동 하이테크 시티,202003,1396,1419,2815,37.513851,126.89888
영등포구,291, 문래동 하이테크 시티,202004,2030,2094,4124,37.513851,126.89888
영등포구,291, 문래동 하이테크 시티,202005,2322,2318,4640,37.513851,126.89888
영등포구,291, 문래동 하이테크 시티,202006,2701,2678,5379,37.513851,126.89888
영등포구,292, 영일 어린이공원,201901,144,129,273,37.51012,126.904068
영등포구,292, 영일 어린이공원,201902,160,140,300,37.51012,126.904068
영등포구,292, 영일 어린이공원,201903,282,279,561,37.51012,126.904068
영등포구,292, 영일 어린이공원,201904,402,386,788,37.51012,126.904068
영등포구,292, 영일 어린이공원,201905,668,635,1303,37.51012,126.904068
영등포구,292, 영일 어린이공원,201906,758,757,1515,37.51012,126.904068
영등포구,292, 영일 어린이공원,201907,733,676,1409,37.51012,126.904068
영등포구,292, 영일 어린이공원,201908,741,694,1435,37.51012,126.904068
영등포구,292, 영일 어린이공원,201909,727,686,1413,37.51012,126.904068
영등포구,292, 영일 어린이공원,201910,858,799,1657,37.51012,126.904068
영등포구,292, 영일 어린이공원,201911,656,586,1242,37.51012,126.904068
영등포구,292, 영일 어린이공원,201912,316,293,609,37.51012,126.904068
영등포구,292, 영일 어린이공원,202001,272,259,531,37.51012,126.904068
영등포구,292, 영일 어린이공원,202002,267,255,522,37.51012,126.904068
영등포구,292, 영일 어린이공원,202003,401,394,795,37.51012,126.904068
영등포구,292, 영일 어린이공원,202004,733,720,1453,37.51012,126.904068
영등포구,292, 영일 어린이공원,202005,972,962,1934,37.51012,126.904068
영등포구,292, 영일 어린이공원,202006,998,999,1997,37.51012,126.904068
영등포구,293, 충북 미래관,201901,323,273,596,37.529171,126.907578
영등포구,293, 충북 미래관,201902,293,277,570,37.529171,126.907578
영등포구,293, 충북 미래관,201903,682,735,1417,37.529171,126.907578
영등포구,293, 충북 미래관,201904,1096,1215,2311,37.529171,126.907578
영등포구,293, 충북 미래관,201905,1929,2182,4111,37.529171,126.907578
영등포구,293, 충북 미래관,201906,2391,2615,5006,37.529171,126.907578
영등포구,293, 충북 미래관,201907,2555,2614,5169,37.529171,126.907578
영등포구,293, 충북 미래관,201908,2508,2691,5199,37.529171,126.907578
영등포구,293, 충북 미래관,201909,2516,2564,5080,37.529171,126.907578
영등포구,293, 충북 미래관,201910,2844,2952,5796,37.529171,126.907578
영등포구,293, 충북 미래관,201911,1791,1787,3578,37.529171,126.907578
영등포구,293, 충북 미래관,201912,870,870,1740,37.529171,126.907578
영등포구,293, 충북 미래관,202001,737,722,1459,37.529171,126.907578
영등포구,293, 충북 미래관,202002,864,777,1641,37.529171,126.907578
영등포구,293, 충북 미래관,202003,1884,1878,3762,37.529171,126.907578
영등포구,293, 충북 미래관,202004,2693,2694,5387,37.529171,126.907578
영등포구,293, 충북 미래관,202005,3085,3089,6174,37.529171,126.907578
영등포구,293, 충북 미래관,202006,2978,2955,5933,37.529171,126.907578
영등포구,295,영등포공원 분수대 앞,202006,1,1,2,37.514824,126.911881
영등포구,296,KT플라자 영등포점,202003,1,1,2,37.526302,126.90538
영등포구,296,KT플라자 영등포점,202004,2,2,4,37.526302,126.90538
영등포구,296,KT플라자 영등포점,202005,83,84,167,37.526302,126.90538
영등포구,296,KT플라자 영등포점,202006,855,849,1704,37.526302,126.90538
영등포구,297,국회3문,202003,1,1,2,37.528637,126.912674
영등포구,297,국회3문,202005,46,43,89,37.528637,126.912674
영등포구,297,국회3문,202006,165,163,328,37.528637,126.912674
영등포구,298,KBS 연구동 건너편,202003,1,1,2,37.527508,126.914299
영등포구,298,KBS 연구동 건너편,202005,39,36,75,37.527508,126.914299
영등포구,298,KBS 연구동 건너편,202006,93,93,186,37.527508,126.914299
영등포구,299,여의도 순복음교회,202003,1,1,2,37.531792,126.922455
영등포구,299,여의도 순복음교회,202005,196,193,389,37.531792,126.922455
영등포구,299,여의도 순복음교회,202006,574,569,1143,37.531792,126.922455
중구,300, 정동사거리,201901,552,427,979,37.56805,126.969231
중구,300, 정동사거리,201902,451,367,818,37.56805,126.969231
중구,300, 정동사거리,201903,706,621,1327,37.56805,126.969231
중구,300, 정동사거리,201904,1158,933,2091,37.56805,126.969231
중구,300, 정동사거리,201905,1143,1089,2232,37.56805,126.969231
중구,300, 정동사거리,201906,1117,1087,2204,37.56805,126.969231
중구,300, 정동사거리,201907,1134,1128,2262,37.56805,126.969231
중구,300, 정동사거리,201908,1075,1047,2122,37.56805,126.969231
중구,300, 정동사거리,201909,1058,1046,2104,37.56805,126.969231
중구,300, 정동사거리,201910,1276,1212,2488,37.56805,126.969231
중구,300, 정동사거리,201911,989,946,1935,37.56805,126.969231
중구,300, 정동사거리,201912,630,596,1226,37.56805,126.969231
중구,300, 정동사거리,202001,532,509,1041,37.56805,126.969231
중구,300, 정동사거리,202002,449,428,877,37.56805,126.969231
중구,300, 정동사거리,202003,786,747,1533,37.56805,126.969231
중구,300, 정동사거리,202004,997,957,1954,37.56805,126.969231
중구,300, 정동사거리,202005,1162,1100,2262,37.56805,126.969231
중구,300, 정동사거리,202006,1273,1173,2446,37.56805,126.969231
종로구,301, 경복궁역 7번출구 앞,201901,513,364,877,37.575794,126.971451
종로구,301, 경복궁역 7번출구 앞,201902,362,270,632,37.575794,126.971451
종로구,301, 경복궁역 7번출구 앞,201903,757,568,1325,37.575794,126.971451
종로구,301, 경복궁역 7번출구 앞,201904,1137,793,1930,37.575794,126.971451
종로구,301, 경복궁역 7번출구 앞,201905,1377,871,2248,37.575794,126.971451
종로구,301, 경복궁역 7번출구 앞,201906,1312,885,2197,37.575794,126.971451
종로구,301, 경복궁역 7번출구 앞,201907,1178,866,2044,37.575794,126.971451
종로구,301, 경복궁역 7번출구 앞,201908,1051,810,1861,37.575794,126.971451
종로구,301, 경복궁역 7번출구 앞,201909,1065,849,1914,37.575794,126.971451
종로구,301, 경복궁역 7번출구 앞,201910,1313,1052,2365,37.575794,126.971451
종로구,301, 경복궁역 7번출구 앞,201911,1166,970,2136,37.575794,126.971451
종로구,301, 경복궁역 7번출구 앞,201912,771,556,1327,37.575794,126.971451
종로구,301, 경복궁역 7번출구 앞,202001,655,473,1128,37.575794,126.971451
종로구,301, 경복궁역 7번출구 앞,202002,613,490,1103,37.575794,126.971451
종로구,301, 경복궁역 7번출구 앞,202003,971,708,1679,37.575794,126.971451
종로구,301, 경복궁역 7번출구 앞,202004,1218,990,2208,37.575794,126.971451
종로구,301, 경복궁역 7번출구 앞,202005,1170,893,2063,37.575794,126.971451
종로구,301, 경복궁역 7번출구 앞,202006,1612,1101,2713,37.575794,126.971451
종로구,302, 경복궁역 4번출구 뒤,201901,782,759,1541,37.575947,126.97406
종로구,302, 경복궁역 4번출구 뒤,201902,669,640,1309,37.575947,126.97406
종로구,302, 경복궁역 4번출구 뒤,201903,1269,1084,2353,37.575947,126.97406
종로구,302, 경복궁역 4번출구 뒤,201904,1778,1675,3453,37.575947,126.97406
종로구,302, 경복궁역 4번출구 뒤,201905,2597,2240,4837,37.575947,126.97406
종로구,302, 경복궁역 4번출구 뒤,201906,2446,2101,4547,37.575947,126.97406
종로구,302, 경복궁역 4번출구 뒤,201907,2374,2001,4375,37.575947,126.97406
종로구,302, 경복궁역 4번출구 뒤,201908,2195,1917,4112,37.575947,126.97406
종로구,302, 경복궁역 4번출구 뒤,201909,2357,2219,4576,37.575947,126.97406
종로구,302, 경복궁역 4번출구 뒤,201910,2668,2471,5139,37.575947,126.97406
종로구,302, 경복궁역 4번출구 뒤,201911,1773,1731,3504,37.575947,126.97406
종로구,302, 경복궁역 4번출구 뒤,201912,1085,1064,2149,37.575947,126.97406
종로구,302, 경복궁역 4번출구 뒤,202001,1025,1053,2078,37.575947,126.97406
종로구,302, 경복궁역 4번출구 뒤,202002,970,920,1890,37.575947,126.97406
종로구,302, 경복궁역 4번출구 뒤,202003,1530,1388,2918,37.575947,126.97406
종로구,302, 경복궁역 4번출구 뒤,202004,2208,2018,4226,37.575947,126.97406
종로구,302, 경복궁역 4번출구 뒤,202005,2390,2160,4550,37.575947,126.97406
종로구,302, 경복궁역 4번출구 뒤,202006,2499,2159,4658,37.575947,126.97406
종로구,303, 광화문역 1번출구 앞,201901,669,680,1349,37.57177,126.974663
종로구,303, 광화문역 1번출구 앞,201902,599,555,1154,37.57177,126.974663
종로구,303, 광화문역 1번출구 앞,201903,951,940,1891,37.57177,126.974663
종로구,303, 광화문역 1번출구 앞,201904,1289,1191,2480,37.57177,126.974663
종로구,303, 광화문역 1번출구 앞,201905,1491,1351,2842,37.57177,126.974663
종로구,303, 광화문역 1번출구 앞,201906,1386,1286,2672,37.57177,126.974663
종로구,303, 광화문역 1번출구 앞,201907,1507,1446,2953,37.57177,126.974663
종로구,303, 광화문역 1번출구 앞,201908,1469,1323,2792,37.57177,126.974663
종로구,303, 광화문역 1번출구 앞,201909,1663,1383,3046,37.57177,126.974663
종로구,303, 광화문역 1번출구 앞,201910,1925,1575,3500,37.57177,126.974663
종로구,303, 광화문역 1번출구 앞,201911,1402,1225,2627,37.57177,126.974663
종로구,303, 광화문역 1번출구 앞,201912,898,832,1730,37.57177,126.974663
종로구,303, 광화문역 1번출구 앞,202001,667,655,1322,37.57177,126.974663
종로구,303, 광화문역 1번출구 앞,202002,607,579,1186,37.57177,126.974663
종로구,303, 광화문역 1번출구 앞,202003,915,827,1742,37.57177,126.974663
종로구,303, 광화문역 1번출구 앞,202004,1282,1077,2359,37.57177,126.974663
종로구,303, 광화문역 1번출구 앞,202005,1481,1207,2688,37.57177,126.974663
종로구,303, 광화문역 1번출구 앞,202006,1876,1521,3397,37.57177,126.974663
종로구,304, 광화문역 2번출구 앞,201901,359,390,749,37.572113,126.977577
종로구,304, 광화문역 2번출구 앞,201902,337,325,662,37.572113,126.977577
종로구,304, 광화문역 2번출구 앞,201903,587,594,1181,37.572113,126.977577
종로구,304, 광화문역 2번출구 앞,201904,759,771,1530,37.572113,126.977577
종로구,304, 광화문역 2번출구 앞,201905,952,915,1867,37.572113,126.977577
종로구,304, 광화문역 2번출구 앞,201906,1010,975,1985,37.572113,126.977577
종로구,304, 광화문역 2번출구 앞,201907,908,898,1806,37.572113,126.977577
종로구,304, 광화문역 2번출구 앞,201908,890,823,1713,37.572113,126.977577
종로구,304, 광화문역 2번출구 앞,201909,1055,890,1945,37.572113,126.977577
종로구,304, 광화문역 2번출구 앞,201910,1098,928,2026,37.572113,126.977577
종로구,304, 광화문역 2번출구 앞,201911,741,672,1413,37.572113,126.977577
종로구,304, 광화문역 2번출구 앞,201912,481,448,929,37.572113,126.977577
종로구,304, 광화문역 2번출구 앞,202001,389,395,784,37.572113,126.977577
종로구,304, 광화문역 2번출구 앞,202002,291,281,572,37.572113,126.977577
종로구,304, 광화문역 2번출구 앞,202003,644,634,1278,37.572113,126.977577
종로구,304, 광화문역 2번출구 앞,202004,1035,881,1916,37.572113,126.977577
종로구,304, 광화문역 2번출구 앞,202005,1089,881,1970,37.572113,126.977577
종로구,304, 광화문역 2번출구 앞,202006,1179,940,2119,37.572113,126.977577
종로구,305, 종로구청 옆,201901,536,746,1282,37.572582,126.978355
종로구,305, 종로구청 옆,201902,500,593,1093,37.572582,126.978355
종로구,305, 종로구청 옆,201903,898,1175,2073,37.572582,126.978355
종로구,305, 종로구청 옆,201904,1428,1651,3079,37.572582,126.978355
종로구,305, 종로구청 옆,201905,1942,1877,3819,37.572582,126.978355
종로구,305, 종로구청 옆,201906,2018,1781,3799,37.572582,126.978355
종로구,305, 종로구청 옆,201907,1852,1710,3562,37.572582,126.978355
종로구,305, 종로구청 옆,201908,1829,1543,3372,37.572582,126.978355
종로구,305, 종로구청 옆,201909,1767,1579,3346,37.572582,126.978355
종로구,305, 종로구청 옆,201910,2054,1922,3976,37.572582,126.978355
종로구,305, 종로구청 옆,201911,1446,1522,2968,37.572582,126.978355
종로구,305, 종로구청 옆,201912,805,955,1760,37.572582,126.978355
종로구,305, 종로구청 옆,202001,778,925,1703,37.572582,126.978355
종로구,305, 종로구청 옆,202002,713,818,1531,37.572582,126.978355
종로구,305, 종로구청 옆,202003,1192,1057,2249,37.572582,126.978355
종로구,305, 종로구청 옆,202004,1268,1198,2466,37.572582,126.978355
종로구,305, 종로구청 옆,202005,1541,1329,2870,37.572582,126.978355
종로구,305, 종로구청 옆,202006,1762,1588,3350,37.572582,126.978355
종로구,306, 광화문역 7번출구 앞,201901,439,436,875,37.570808,126.976433
종로구,306, 광화문역 7번출구 앞,201902,455,449,904,37.570808,126.976433
종로구,306, 광화문역 7번출구 앞,201903,692,672,1364,37.570808,126.976433
종로구,306, 광화문역 7번출구 앞,201904,866,763,1629,37.570808,126.976433
종로구,306, 광화문역 7번출구 앞,201905,1095,1070,2165,37.570808,126.976433
종로구,306, 광화문역 7번출구 앞,201906,1159,1136,2295,37.570808,126.976433
종로구,306, 광화문역 7번출구 앞,201907,1155,1133,2288,37.570808,126.976433
종로구,306, 광화문역 7번출구 앞,201908,1059,974,2033,37.570808,126.976433
종로구,306, 광화문역 7번출구 앞,201909,1455,1118,2573,37.570808,126.976433
종로구,306, 광화문역 7번출구 앞,201910,1706,1251,2957,37.570808,126.976433
종로구,306, 광화문역 7번출구 앞,201911,1195,965,2160,37.570808,126.976433
종로구,306, 광화문역 7번출구 앞,201912,742,635,1377,37.570808,126.976433
종로구,306, 광화문역 7번출구 앞,202001,670,575,1245,37.570808,126.976433
종로구,306, 광화문역 7번출구 앞,202002,634,499,1133,37.570808,126.976433
종로구,306, 광화문역 7번출구 앞,202003,952,721,1673,37.570808,126.976433
종로구,306, 광화문역 7번출구 앞,202004,1425,1028,2453,37.570808,126.976433
종로구,306, 광화문역 7번출구 앞,202005,1634,1098,2732,37.570808,126.976433
종로구,306, 광화문역 7번출구 앞,202006,1898,1246,3144,37.570808,126.976433
종로구,307, 서울역사박물관 앞,201901,564,506,1070,37.57,126.9711
종로구,307, 서울역사박물관 앞,201902,483,415,898,37.57,126.9711
종로구,307, 서울역사박물관 앞,201903,728,747,1475,37.57,126.9711
종로구,307, 서울역사박물관 앞,201904,1109,1003,2112,37.57,126.9711
종로구,307, 서울역사박물관 앞,201905,1412,1306,2718,37.57,126.9711
종로구,307, 서울역사박물관 앞,201906,1335,1210,2545,37.57,126.9711
종로구,307, 서울역사박물관 앞,201907,1340,1358,2698,37.57,126.9711
종로구,307, 서울역사박물관 앞,201908,1089,1046,2135,37.57,126.9711
종로구,307, 서울역사박물관 앞,201909,1112,1120,2232,37.57,126.9711
종로구,307, 서울역사박물관 앞,201910,1362,1344,2706,37.57,126.9711
종로구,307, 서울역사박물관 앞,201911,1154,1059,2213,37.57,126.9711
종로구,307, 서울역사박물관 앞,201912,680,663,1343,37.57,126.9711
종로구,307, 서울역사박물관 앞,202001,635,591,1226,37.57,126.9711
종로구,307, 서울역사박물관 앞,202002,539,538,1077,37.57,126.9711
종로구,307, 서울역사박물관 앞,202003,671,643,1314,37.57,126.9711
종로구,307, 서울역사박물관 앞,202004,801,743,1544,37.57,126.9711
종로구,307, 서울역사박물관 앞,202005,887,822,1709,37.57,126.9711
종로구,307, 서울역사박물관 앞,202006,1195,1060,2255,37.57,126.9711
종로구,308, 광화문 S타워 앞,201901,722,731,1453,37.569969,126.973938
종로구,308, 광화문 S타워 앞,201902,612,584,1196,37.569969,126.973938
종로구,308, 광화문 S타워 앞,201903,869,891,1760,37.569969,126.973938
종로구,308, 광화문 S타워 앞,201904,1164,1144,2308,37.569969,126.973938
종로구,308, 광화문 S타워 앞,201905,1386,1413,2799,37.569969,126.973938
종로구,308, 광화문 S타워 앞,201906,1561,1470,3031,37.569969,126.973938
종로구,308, 광화문 S타워 앞,201907,1706,1667,3373,37.569969,126.973938
종로구,308, 광화문 S타워 앞,201908,1759,1671,3430,37.569969,126.973938
종로구,308, 광화문 S타워 앞,201909,1814,1694,3508,37.569969,126.973938
종로구,308, 광화문 S타워 앞,201910,2164,1969,4133,37.569969,126.973938
종로구,308, 광화문 S타워 앞,201911,1744,1613,3357,37.569969,126.973938
종로구,308, 광화문 S타워 앞,201912,1204,1138,2342,37.569969,126.973938
종로구,308, 광화문 S타워 앞,202001,972,983,1955,37.569969,126.973938
종로구,308, 광화문 S타워 앞,202002,848,878,1726,37.569969,126.973938
종로구,308, 광화문 S타워 앞,202003,1012,958,1970,37.569969,126.973938
종로구,308, 광화문 S타워 앞,202004,1509,1265,2774,37.569969,126.973938
종로구,308, 광화문 S타워 앞,202005,1719,1553,3272,37.569969,126.973938
종로구,308, 광화문 S타워 앞,202006,2234,2205,4439,37.569969,126.973938
종로구,309, 광화문역 6번출구 옆,201901,447,384,831,37.569889,126.976456
종로구,309, 광화문역 6번출구 옆,201902,308,276,584,37.569889,126.976456
종로구,309, 광화문역 6번출구 옆,201903,584,549,1133,37.569889,126.976456
종로구,309, 광화문역 6번출구 옆,201904,1002,774,1776,37.569889,126.976456
종로구,309, 광화문역 6번출구 옆,201905,1061,912,1973,37.569889,126.976456
종로구,309, 광화문역 6번출구 옆,201906,981,875,1856,37.569889,126.976456
종로구,309, 광화문역 6번출구 옆,201907,899,864,1763,37.569889,126.976456
종로구,309, 광화문역 6번출구 옆,201908,1027,859,1886,37.569889,126.976456
종로구,309, 광화문역 6번출구 옆,201909,944,781,1725,37.569889,126.976456
종로구,309, 광화문역 6번출구 옆,201910,1250,972,2222,37.569889,126.976456
종로구,309, 광화문역 6번출구 옆,201911,969,748,1717,37.569889,126.976456
종로구,309, 광화문역 6번출구 옆,201912,528,423,951,37.569889,126.976456
종로구,309, 광화문역 6번출구 옆,202001,402,319,721,37.569889,126.976456
종로구,309, 광화문역 6번출구 옆,202002,296,270,566,37.569889,126.976456
종로구,309, 광화문역 6번출구 옆,202003,512,469,981,37.569889,126.976456
종로구,309, 광화문역 6번출구 옆,202004,816,557,1373,37.569889,126.976456
종로구,309, 광화문역 6번출구 옆,202005,848,613,1461,37.569889,126.976456
종로구,309, 광화문역 6번출구 옆,202006,1075,706,1781,37.569889,126.976456
중구,310, 청계광장 옆,201901,268,298,566,37.568878,126.97747
중구,310, 청계광장 옆,201902,238,249,487,37.568878,126.97747
중구,310, 청계광장 옆,201903,474,453,927,37.568878,126.97747
중구,310, 청계광장 옆,201904,759,606,1365,37.568878,126.97747
중구,310, 청계광장 옆,201905,882,808,1690,37.568878,126.97747
중구,310, 청계광장 옆,201906,881,786,1667,37.568878,126.97747
중구,310, 청계광장 옆,201907,902,848,1750,37.568878,126.97747
중구,310, 청계광장 옆,201908,999,794,1793,37.568878,126.97747
중구,310, 청계광장 옆,201909,1077,881,1958,37.568878,126.97747
중구,310, 청계광장 옆,201910,1311,1051,2362,37.568878,126.97747
중구,310, 청계광장 옆,201911,842,760,1602,37.568878,126.97747
중구,310, 청계광장 옆,201912,497,503,1000,37.568878,126.97747
중구,310, 청계광장 옆,202001,417,366,783,37.568878,126.97747
중구,310, 청계광장 옆,202002,409,352,761,37.568878,126.97747
중구,310, 청계광장 옆,202003,693,560,1253,37.568878,126.97747
중구,310, 청계광장 옆,202004,909,687,1596,37.568878,126.97747
중구,310, 청계광장 옆,202005,1079,811,1890,37.568878,126.97747
중구,310, 청계광장 옆,202006,1126,924,2050,37.568878,126.97747
중구,311, 서울광장 옆,201901,1008,806,1814,37.566612,126.97747
중구,311, 서울광장 옆,201902,794,675,1469,37.566612,126.97747
중구,311, 서울광장 옆,201903,1541,1127,2668,37.566612,126.97747
중구,311, 서울광장 옆,201904,2187,1596,3783,37.566612,126.97747
중구,311, 서울광장 옆,201905,2878,2031,4909,37.566612,126.97747
중구,311, 서울광장 옆,201906,3004,2145,5149,37.566612,126.97747
중구,311, 서울광장 옆,201907,2891,2038,4929,37.566612,126.97747
중구,311, 서울광장 옆,201908,2780,1943,4723,37.566612,126.97747
중구,311, 서울광장 옆,201909,2790,1901,4691,37.566612,126.97747
중구,311, 서울광장 옆,201910,3532,2601,6133,37.566612,126.97747
중구,311, 서울광장 옆,201911,2346,1725,4071,37.566612,126.97747
중구,311, 서울광장 옆,201912,1437,1088,2525,37.566612,126.97747
중구,311, 서울광장 옆,202001,1335,1134,2469,37.566612,126.97747
중구,311, 서울광장 옆,202002,1063,764,1827,37.566612,126.97747
중구,311, 서울광장 옆,202003,1589,1110,2699,37.566612,126.97747
중구,311, 서울광장 옆,202004,2374,1502,3876,37.566612,126.97747
중구,311, 서울광장 옆,202005,2360,1584,3944,37.566612,126.97747
중구,311, 서울광장 옆,202006,2905,1913,4818,37.566612,126.97747
중구,312, 시청역 1번출구 뒤,201901,739,797,1536,37.564674,126.976738
중구,312, 시청역 1번출구 뒤,201902,617,661,1278,37.564674,126.976738
중구,312, 시청역 1번출구 뒤,201903,1108,1173,2281,37.564674,126.976738
중구,312, 시청역 1번출구 뒤,201904,1648,1652,3300,37.564674,126.976738
중구,312, 시청역 1번출구 뒤,201905,2677,2700,5377,37.564674,126.976738
중구,312, 시청역 1번출구 뒤,201906,2194,2092,4286,37.564674,126.976738
중구,312, 시청역 1번출구 뒤,201907,2263,2097,4360,37.564674,126.976738
중구,312, 시청역 1번출구 뒤,201908,2101,1960,4061,37.564674,126.976738
중구,312, 시청역 1번출구 뒤,201909,2142,1937,4079,37.564674,126.976738
중구,312, 시청역 1번출구 뒤,201910,2676,2422,5098,37.564674,126.976738
중구,312, 시청역 1번출구 뒤,201911,1865,1797,3662,37.564674,126.976738
중구,312, 시청역 1번출구 뒤,201912,1195,1183,2378,37.564674,126.976738
중구,312, 시청역 1번출구 뒤,202001,1017,993,2010,37.564674,126.976738
중구,312, 시청역 1번출구 뒤,202002,911,892,1803,37.564674,126.976738
중구,312, 시청역 1번출구 뒤,202003,1320,1255,2575,37.564674,126.976738
중구,312, 시청역 1번출구 뒤,202004,1938,1693,3631,37.564674,126.976738
중구,312, 시청역 1번출구 뒤,202005,1985,1817,3802,37.564674,126.976738
중구,312, 시청역 1번출구 뒤,202006,2497,2146,4643,37.564674,126.976738
중구,313, 서울역 광장 파출소 옆,201901,195,230,425,#N/A,#N/A
중구,313, 서울역 광장 파출소 옆,201902,197,214,411,#N/A,#N/A
중구,313, 서울역 광장 파출소 옆,201903,324,370,694,#N/A,#N/A
중구,313, 서울역 광장 파출소 옆,201904,535,547,1082,#N/A,#N/A
중구,313, 서울역 광장 파출소 옆,201905,749,747,1496,#N/A,#N/A
중구,313, 서울역 광장 파출소 옆,201906,774,774,1548,#N/A,#N/A
중구,313, 서울역 광장 파출소 옆,201907,756,764,1520,#N/A,#N/A
중구,313, 서울역 광장 파출소 옆,201908,651,647,1298,#N/A,#N/A
중구,313, 서울역 광장 파출소 옆,201909,294,302,596,#N/A,#N/A
종로구,314, 국립현대미술관,201901,620,602,1222,37.579708,126.980858
종로구,314, 국립현대미술관,201902,542,524,1066,37.579708,126.980858
종로구,314, 국립현대미술관,201903,925,921,1846,37.579708,126.980858
종로구,314, 국립현대미술관,201904,1264,1268,2532,37.579708,126.980858
종로구,314, 국립현대미술관,201905,1394,1353,2747,37.579708,126.980858
종로구,314, 국립현대미술관,201906,1393,1316,2709,37.579708,126.980858
종로구,314, 국립현대미술관,201907,1473,1410,2883,37.579708,126.980858
종로구,314, 국립현대미술관,201908,1136,1117,2253,37.579708,126.980858
종로구,314, 국립현대미술관,201909,1099,1109,2208,37.579708,126.980858
종로구,314, 국립현대미술관,201910,1614,1580,3194,37.579708,126.980858
종로구,314, 국립현대미술관,201911,1103,1068,2171,37.579708,126.980858
종로구,314, 국립현대미술관,201912,612,602,1214,37.579708,126.980858
종로구,314, 국립현대미술관,202001,612,550,1162,37.579708,126.980858
종로구,314, 국립현대미술관,202002,413,394,807,37.579708,126.980858
종로구,314, 국립현대미술관,202003,681,650,1331,37.579708,126.980858
종로구,314, 국립현대미술관,202004,891,894,1785,37.579708,126.980858
종로구,314, 국립현대미술관,202005,1217,1191,2408,37.579708,126.980858
종로구,314, 국립현대미술관,202006,919,888,1807,37.579708,126.980858
종로구,315, 신한은행 안국역지점 옆,201901,488,475,963,#N/A,#N/A
종로구,315, 신한은행 안국역지점 옆,201902,500,515,1015,#N/A,#N/A
종로구,315, 신한은행 안국역지점 옆,201903,932,914,1846,#N/A,#N/A
종로구,315, 신한은행 안국역지점 옆,201904,1231,1172,2403,#N/A,#N/A
종로구,315, 신한은행 안국역지점 옆,201905,1572,1507,3079,#N/A,#N/A
종로구,315, 신한은행 안국역지점 옆,201906,1562,1492,3054,#N/A,#N/A
종로구,315, 신한은행 안국역지점 옆,201907,1544,1420,2964,#N/A,#N/A
종로구,315, 신한은행 안국역지점 옆,201908,1330,1254,2584,#N/A,#N/A
종로구,315, 신한은행 안국역지점 옆,201909,1250,1190,2440,#N/A,#N/A
종로구,315, 신한은행 안국역지점 옆,201910,1601,1579,3180,#N/A,#N/A
종로구,315, 신한은행 안국역지점 옆,201911,1223,1188,2411,#N/A,#N/A
종로구,315, 신한은행 안국역지점 옆,201912,772,774,1546,#N/A,#N/A
종로구,315, 신한은행 안국역지점 옆,202001,591,577,1168,#N/A,#N/A
종로구,315, 신한은행 안국역지점 옆,202002,277,287,564,#N/A,#N/A
종로구,316, 종각역 1번출구 앞,201901,941,902,1843,37.570396,126.981789
종로구,316, 종각역 1번출구 앞,201902,818,766,1584,37.570396,126.981789
종로구,316, 종각역 1번출구 앞,201903,1441,1417,2858,37.570396,126.981789
종로구,316, 종각역 1번출구 앞,201904,2039,1901,3940,37.570396,126.981789
종로구,316, 종각역 1번출구 앞,201905,2334,2270,4604,37.570396,126.981789
종로구,316, 종각역 1번출구 앞,201906,2498,2324,4822,37.570396,126.981789
종로구,316, 종각역 1번출구 앞,201907,2387,2294,4681,37.570396,126.981789
종로구,316, 종각역 1번출구 앞,201908,2180,2115,4295,37.570396,126.981789
종로구,316, 종각역 1번출구 앞,201909,2233,2171,4404,37.570396,126.981789
종로구,316, 종각역 1번출구 앞,201910,2715,2657,5372,37.570396,126.981789
종로구,316, 종각역 1번출구 앞,201911,1919,1838,3757,37.570396,126.981789
종로구,316, 종각역 1번출구 앞,201912,1234,1193,2427,37.570396,126.981789
종로구,316, 종각역 1번출구 앞,202001,1186,1145,2331,37.570396,126.981789
종로구,316, 종각역 1번출구 앞,202002,1060,983,2043,37.570396,126.981789
종로구,316, 종각역 1번출구 앞,202003,1432,1271,2703,37.570396,126.981789
종로구,316, 종각역 1번출구 앞,202004,1914,1874,3788,37.570396,126.981789
종로구,316, 종각역 1번출구 앞,202005,1899,1861,3760,37.570396,126.981789
종로구,316, 종각역 1번출구 앞,202006,2401,2279,4680,37.570396,126.981789
중구,318, 광교사거리 남측,201901,206,240,446,37.568527,126.982552
중구,318, 광교사거리 남측,201902,218,227,445,37.568527,126.982552
중구,318, 광교사거리 남측,201903,343,338,681,37.568527,126.982552
중구,318, 광교사거리 남측,201904,543,506,1049,37.568527,126.982552
중구,318, 광교사거리 남측,201905,631,621,1252,37.568527,126.982552
중구,318, 광교사거리 남측,201906,693,683,1376,37.568527,126.982552
중구,318, 광교사거리 남측,201907,644,633,1277,37.568527,126.982552
중구,318, 광교사거리 남측,201908,572,553,1125,37.568527,126.982552
중구,318, 광교사거리 남측,201909,660,649,1309,37.568527,126.982552
중구,318, 광교사거리 남측,201910,786,781,1567,37.568527,126.982552
중구,318, 광교사거리 남측,201911,539,508,1047,37.568527,126.982552
중구,318, 광교사거리 남측,201912,337,342,679,37.568527,126.982552
중구,318, 광교사거리 남측,202001,285,281,566,37.568527,126.982552
중구,318, 광교사거리 남측,202002,293,286,579,37.568527,126.982552
중구,318, 광교사거리 남측,202003,472,460,932,37.568527,126.982552
중구,318, 광교사거리 남측,202004,671,652,1323,37.568527,126.982552
중구,318, 광교사거리 남측,202005,713,704,1417,37.568527,126.982552
중구,318, 광교사거리 남측,202006,806,782,1588,37.568527,126.982552
중구,320, 을지로입구역 4번출구 앞,201901,571,571,1142,37.566223,126.983589
중구,320, 을지로입구역 4번출구 앞,201902,478,479,957,37.566223,126.983589
중구,320, 을지로입구역 4번출구 앞,201903,821,800,1621,37.566223,126.983589
중구,320, 을지로입구역 4번출구 앞,201904,1051,1017,2068,37.566223,126.983589
중구,320, 을지로입구역 4번출구 앞,201905,1432,1315,2747,37.566223,126.983589
중구,320, 을지로입구역 4번출구 앞,201906,1438,1360,2798,37.566223,126.983589
중구,320, 을지로입구역 4번출구 앞,201907,1371,1344,2715,37.566223,126.983589
중구,320, 을지로입구역 4번출구 앞,201908,1123,1101,2224,37.566223,126.983589
중구,320, 을지로입구역 4번출구 앞,201909,1120,1091,2211,37.566223,126.983589
중구,320, 을지로입구역 4번출구 앞,201910,1386,1371,2757,37.566223,126.983589
중구,320, 을지로입구역 4번출구 앞,201911,1121,1107,2228,37.566223,126.983589
중구,320, 을지로입구역 4번출구 앞,201912,700,664,1364,37.566223,126.983589
중구,320, 을지로입구역 4번출구 앞,202001,703,715,1418,37.566223,126.983589
중구,320, 을지로입구역 4번출구 앞,202002,704,705,1409,37.566223,126.983589
중구,320, 을지로입구역 4번출구 앞,202003,919,859,1778,37.566223,126.983589
중구,320, 을지로입구역 4번출구 앞,202004,1259,1226,2485,37.566223,126.983589
중구,320, 을지로입구역 4번출구 앞,202005,1247,1236,2483,37.566223,126.983589
중구,320, 을지로입구역 4번출구 앞,202006,1485,1458,2943,37.566223,126.983589
중구,321, KEB 하나금융그룹 명동사옥 옆,201901,424,391,815,37.565464,126.984138
중구,321, KEB 하나금융그룹 명동사옥 옆,201902,398,359,757,37.565464,126.984138
중구,321, KEB 하나금융그룹 명동사옥 옆,201903,625,557,1182,37.565464,126.984138
중구,321, KEB 하나금융그룹 명동사옥 옆,201904,986,932,1918,37.565464,126.984138
중구,321, KEB 하나금융그룹 명동사옥 옆,201905,1173,1136,2309,37.565464,126.984138
중구,321, KEB 하나금융그룹 명동사옥 옆,201906,1292,1229,2521,37.565464,126.984138
중구,321, KEB 하나금융그룹 명동사옥 옆,201907,1169,1061,2230,37.565464,126.984138
중구,321, KEB 하나금융그룹 명동사옥 옆,201908,1030,979,2009,37.565464,126.984138
중구,321, KEB 하나금융그룹 명동사옥 옆,201909,1063,1033,2096,37.565464,126.984138
중구,321, KEB 하나금융그룹 명동사옥 옆,201910,1330,1315,2645,37.565464,126.984138
중구,321, KEB 하나금융그룹 명동사옥 옆,201911,1042,984,2026,37.565464,126.984138
중구,321, KEB 하나금융그룹 명동사옥 옆,201912,590,551,1141,37.565464,126.984138
중구,321, KEB 하나금융그룹 명동사옥 옆,202001,426,407,833,37.565464,126.984138
중구,321, KEB 하나금융그룹 명동사옥 옆,202002,354,335,689,37.565464,126.984138
중구,321, KEB 하나금융그룹 명동사옥 옆,202003,672,635,1307,37.565464,126.984138
중구,321, KEB 하나금융그룹 명동사옥 옆,202004,975,926,1901,37.565464,126.984138
중구,321, KEB 하나금융그룹 명동사옥 옆,202005,1174,1137,2311,37.565464,126.984138
중구,321, KEB 하나금융그룹 명동사옥 옆,202006,1194,1190,2384,37.565464,126.984138
중구,322, 명동성당 앞,201901,275,224,499,37.564476,126.986969
중구,322, 명동성당 앞,201902,225,183,408,37.564476,126.986969
중구,322, 명동성당 앞,201903,512,400,912,37.564476,126.986969
중구,322, 명동성당 앞,201904,819,636,1455,37.564476,126.986969
중구,322, 명동성당 앞,201905,846,795,1641,37.564476,126.986969
중구,322, 명동성당 앞,201906,833,762,1595,37.564476,126.986969
중구,322, 명동성당 앞,201907,756,604,1360,37.564476,126.986969
중구,322, 명동성당 앞,201908,692,548,1240,37.564476,126.986969
중구,322, 명동성당 앞,201909,796,668,1464,37.564476,126.986969
중구,322, 명동성당 앞,201910,852,832,1684,37.564476,126.986969
중구,322, 명동성당 앞,201911,678,589,1267,37.564476,126.986969
중구,322, 명동성당 앞,201912,371,311,682,37.564476,126.986969
중구,322, 명동성당 앞,202001,306,257,563,37.564476,126.986969
중구,322, 명동성당 앞,202002,228,206,434,37.564476,126.986969
중구,322, 명동성당 앞,202003,403,302,705,37.564476,126.986969
중구,322, 명동성당 앞,202004,506,466,972,37.564476,126.986969
중구,322, 명동성당 앞,202005,598,568,1166,37.564476,126.986969
중구,322, 명동성당 앞,202006,567,567,1134,37.564476,126.986969
중구,324, 신세계백화점 본점 앞,201901,397,450,847,37.56134,126.9804
중구,324, 신세계백화점 본점 앞,201902,367,437,804,37.56134,126.9804
중구,324, 신세계백화점 본점 앞,201903,702,788,1490,37.56134,126.9804
중구,324, 신세계백화점 본점 앞,201904,1103,1207,2310,37.56134,126.9804
중구,324, 신세계백화점 본점 앞,201905,1499,1584,3083,37.56134,126.9804
중구,324, 신세계백화점 본점 앞,201906,1423,1428,2851,37.56134,126.9804
중구,324, 신세계백화점 본점 앞,201907,1247,1255,2502,37.56134,126.9804
중구,324, 신세계백화점 본점 앞,201908,1250,1270,2520,37.56134,126.9804
중구,324, 신세계백화점 본점 앞,201909,1423,1430,2853,37.56134,126.9804
중구,324, 신세계백화점 본점 앞,201910,1786,1817,3603,37.56134,126.9804
중구,324, 신세계백화점 본점 앞,201911,1250,1361,2611,37.56134,126.9804
중구,324, 신세계백화점 본점 앞,201912,750,789,1539,37.56134,126.9804
중구,324, 신세계백화점 본점 앞,202001,644,690,1334,37.56134,126.9804
중구,324, 신세계백화점 본점 앞,202002,500,537,1037,37.56134,126.9804
중구,324, 신세계백화점 본점 앞,202003,981,978,1959,37.56134,126.9804
중구,324, 신세계백화점 본점 앞,202004,1277,1283,2560,37.56134,126.9804
중구,324, 신세계백화점 본점 앞,202005,1085,1103,2188,37.56134,126.9804
중구,324, 신세계백화점 본점 앞,202006,1060,1035,2095,37.56134,126.9804
종로구,326, 안국역 5번출구 앞,201901,557,455,1012,37.576241,126.98616
종로구,326, 안국역 5번출구 앞,201902,464,379,843,37.576241,126.98616
종로구,326, 안국역 5번출구 앞,201903,886,783,1669,37.576241,126.98616
종로구,326, 안국역 5번출구 앞,201904,1319,1076,2395,37.576241,126.98616
종로구,326, 안국역 5번출구 앞,201905,1617,1350,2967,37.576241,126.98616
종로구,326, 안국역 5번출구 앞,201906,1754,1345,3099,37.576241,126.98616
종로구,326, 안국역 5번출구 앞,201907,1907,1458,3365,37.576241,126.98616
종로구,326, 안국역 5번출구 앞,201908,1793,1307,3100,37.576241,126.98616
종로구,326, 안국역 5번출구 앞,201909,1753,1397,3150,37.576241,126.98616
종로구,326, 안국역 5번출구 앞,201910,2047,1746,3793,37.576241,126.98616
종로구,326, 안국역 5번출구 앞,201911,1514,1272,2786,37.576241,126.98616
종로구,326, 안국역 5번출구 앞,201912,872,730,1602,37.576241,126.98616
종로구,326, 안국역 5번출구 앞,202001,846,654,1500,37.576241,126.98616
종로구,326, 안국역 5번출구 앞,202002,825,669,1494,37.576241,126.98616
종로구,326, 안국역 5번출구 앞,202003,1435,1267,2702,37.576241,126.98616
종로구,326, 안국역 5번출구 앞,202004,1686,1572,3258,37.576241,126.98616
종로구,326, 안국역 5번출구 앞,202005,1762,1593,3355,37.576241,126.98616
종로구,326, 안국역 5번출구 앞,202006,1907,1609,3516,37.576241,126.98616
종로구,327, 낙원상가 옆,201901,649,733,1382,37.573357,126.987465
종로구,327, 낙원상가 옆,201902,524,573,1097,37.573357,126.987465
종로구,327, 낙원상가 옆,201903,913,900,1813,37.573357,126.987465
종로구,327, 낙원상가 옆,201904,1259,1287,2546,37.573357,126.987465
종로구,327, 낙원상가 옆,201905,1501,1479,2980,37.573357,126.987465
종로구,327, 낙원상가 옆,201906,1537,1499,3036,37.573357,126.987465
종로구,327, 낙원상가 옆,201907,1365,1332,2697,37.573357,126.987465
종로구,327, 낙원상가 옆,201908,1434,1376,2810,37.573357,126.987465
종로구,327, 낙원상가 옆,201909,1278,1300,2578,37.573357,126.987465
종로구,327, 낙원상가 옆,201910,1489,1486,2975,37.573357,126.987465
종로구,327, 낙원상가 옆,201911,1024,1042,2066,37.573357,126.987465
종로구,327, 낙원상가 옆,201912,765,822,1587,37.573357,126.987465
종로구,327, 낙원상가 옆,202001,664,739,1403,37.573357,126.987465
종로구,327, 낙원상가 옆,202002,702,708,1410,37.573357,126.987465
종로구,327, 낙원상가 옆,202003,933,934,1867,37.573357,126.987465
종로구,327, 낙원상가 옆,202004,1171,1164,2335,37.573357,126.987465
종로구,327, 낙원상가 옆,202005,1287,1285,2572,37.573357,126.987465
종로구,327, 낙원상가 옆,202006,1371,1364,2735,37.573357,126.987465
종로구,328, 탑골공원 앞,201901,542,526,1068,37.570396,126.98819
종로구,328, 탑골공원 앞,201902,510,495,1005,37.570396,126.98819
종로구,328, 탑골공원 앞,201903,791,769,1560,37.570396,126.98819
종로구,328, 탑골공원 앞,201904,1270,1191,2461,37.570396,126.98819
종로구,328, 탑골공원 앞,201905,1605,1468,3073,37.570396,126.98819
종로구,328, 탑골공원 앞,201906,1609,1467,3076,37.570396,126.98819
종로구,328, 탑골공원 앞,201907,1457,1361,2818,37.570396,126.98819
종로구,328, 탑골공원 앞,201908,1392,1321,2713,37.570396,126.98819
종로구,328, 탑골공원 앞,201909,1315,1222,2537,37.570396,126.98819
종로구,328, 탑골공원 앞,201910,1437,1367,2804,37.570396,126.98819
종로구,328, 탑골공원 앞,201911,1187,1123,2310,37.570396,126.98819
종로구,328, 탑골공원 앞,201912,804,696,1500,37.570396,126.98819
종로구,328, 탑골공원 앞,202001,685,646,1331,37.570396,126.98819
종로구,328, 탑골공원 앞,202002,613,570,1183,37.570396,126.98819
종로구,328, 탑골공원 앞,202003,977,911,1888,37.570396,126.98819
종로구,328, 탑골공원 앞,202004,1264,1150,2414,37.570396,126.98819
종로구,328, 탑골공원 앞,202005,1306,1246,2552,37.570396,126.98819
종로구,328, 탑골공원 앞,202006,1141,1050,2191,37.570396,126.98819
종로구,329, 청계2가 사거리 옆,201901,557,604,1161,37.568344,126.987892
종로구,329, 청계2가 사거리 옆,201902,514,551,1065,37.568344,126.987892
종로구,329, 청계2가 사거리 옆,201903,869,863,1732,37.568344,126.987892
종로구,329, 청계2가 사거리 옆,201904,1249,1260,2509,37.568344,126.987892
종로구,329, 청계2가 사거리 옆,201905,1799,1793,3592,37.568344,126.987892
종로구,329, 청계2가 사거리 옆,201906,1920,1914,3834,37.568344,126.987892
종로구,329, 청계2가 사거리 옆,201907,1907,1920,3827,37.568344,126.987892
종로구,329, 청계2가 사거리 옆,201908,1569,1584,3153,37.568344,126.987892
종로구,329, 청계2가 사거리 옆,201909,1618,1625,3243,37.568344,126.987892
종로구,329, 청계2가 사거리 옆,201910,2061,2041,4102,37.568344,126.987892
종로구,329, 청계2가 사거리 옆,201911,1578,1652,3230,37.568344,126.987892
종로구,329, 청계2가 사거리 옆,201912,777,877,1654,37.568344,126.987892
종로구,329, 청계2가 사거리 옆,202001,800,813,1613,37.568344,126.987892
종로구,329, 청계2가 사거리 옆,202002,750,850,1600,37.568344,126.987892
종로구,329, 청계2가 사거리 옆,202003,1287,1326,2613,37.568344,126.987892
종로구,329, 청계2가 사거리 옆,202004,1752,1777,3529,37.568344,126.987892
종로구,329, 청계2가 사거리 옆,202005,1185,1196,2381,37.568344,126.987892
종로구,329, 청계2가 사거리 옆,202006,1568,1564,3132,37.568344,126.987892
중구,330, 청계천 한빛광장,201901,246,287,533,#N/A,#N/A
중구,330, 청계천 한빛광장,201902,239,235,474,#N/A,#N/A
중구,330, 청계천 한빛광장,201903,454,508,962,#N/A,#N/A
중구,330, 청계천 한빛광장,201904,683,698,1381,#N/A,#N/A
중구,330, 청계천 한빛광장,201905,811,921,1732,#N/A,#N/A
중구,330, 청계천 한빛광장,201906,984,1043,2027,#N/A,#N/A
중구,330, 청계천 한빛광장,201907,939,1041,1980,#N/A,#N/A
중구,330, 청계천 한빛광장,201908,885,900,1785,#N/A,#N/A
중구,330, 청계천 한빛광장,201909,902,970,1872,#N/A,#N/A
중구,330, 청계천 한빛광장,201910,1144,1210,2354,#N/A,#N/A
중구,330, 청계천 한빛광장,201911,744,829,1573,#N/A,#N/A
중구,330, 청계천 한빛광장,201912,431,510,941,#N/A,#N/A
중구,330, 청계천 한빛광장,202001,354,415,769,#N/A,#N/A
중구,330, 청계천 한빛광장,202002,60,84,144,#N/A,#N/A
중구,331, 을지로2가 사거리 북측,201901,457,468,925,37.566383,126.987206
중구,331, 을지로2가 사거리 북측,201902,365,358,723,37.566383,126.987206
중구,331, 을지로2가 사거리 북측,201903,671,666,1337,37.566383,126.987206
중구,331, 을지로2가 사거리 북측,201904,896,881,1777,37.566383,126.987206
중구,331, 을지로2가 사거리 북측,201905,1090,1063,2153,37.566383,126.987206
중구,331, 을지로2가 사거리 북측,201906,1028,1021,2049,37.566383,126.987206
중구,331, 을지로2가 사거리 북측,201907,1104,1104,2208,37.566383,126.987206
중구,331, 을지로2가 사거리 북측,201908,977,968,1945,37.566383,126.987206
중구,331, 을지로2가 사거리 북측,201909,997,994,1991,37.566383,126.987206
중구,331, 을지로2가 사거리 북측,201910,1336,1360,2696,37.566383,126.987206
중구,331, 을지로2가 사거리 북측,201911,964,995,1959,37.566383,126.987206
중구,331, 을지로2가 사거리 북측,201912,557,604,1161,37.566383,126.987206
중구,331, 을지로2가 사거리 북측,202001,559,593,1152,37.566383,126.987206
중구,331, 을지로2가 사거리 북측,202002,604,604,1208,37.566383,126.987206
중구,331, 을지로2가 사거리 북측,202003,953,957,1910,37.566383,126.987206
중구,331, 을지로2가 사거리 북측,202004,1276,1286,2562,37.566383,126.987206
중구,331, 을지로2가 사거리 북측,202005,1266,1342,2608,37.566383,126.987206
중구,331, 을지로2가 사거리 북측,202006,1484,1503,2987,37.566383,126.987206
중구,332, 을지로2가 사거리 남측,201901,287,279,566,37.56599,126.987793
중구,332, 을지로2가 사거리 남측,201902,233,236,469,37.56599,126.987793
중구,332, 을지로2가 사거리 남측,201903,394,380,774,37.56599,126.987793
중구,332, 을지로2가 사거리 남측,201904,681,633,1314,37.56599,126.987793
중구,332, 을지로2가 사거리 남측,201905,787,751,1538,37.56599,126.987793
중구,332, 을지로2가 사거리 남측,201906,713,704,1417,37.56599,126.987793
중구,332, 을지로2가 사거리 남측,201907,804,796,1600,37.56599,126.987793
중구,332, 을지로2가 사거리 남측,201908,666,656,1322,37.56599,126.987793
중구,332, 을지로2가 사거리 남측,201909,707,710,1417,37.56599,126.987793
중구,332, 을지로2가 사거리 남측,201910,824,829,1653,37.56599,126.987793
중구,332, 을지로2가 사거리 남측,201911,685,702,1387,37.56599,126.987793
중구,332, 을지로2가 사거리 남측,201912,413,417,830,37.56599,126.987793
중구,332, 을지로2가 사거리 남측,202001,393,394,787,37.56599,126.987793
중구,332, 을지로2가 사거리 남측,202002,373,363,736,37.56599,126.987793
중구,332, 을지로2가 사거리 남측,202003,548,547,1095,37.56599,126.987793
중구,332, 을지로2가 사거리 남측,202004,934,933,1867,37.56599,126.987793
중구,332, 을지로2가 사거리 남측,202005,805,805,1610,37.56599,126.987793
중구,332, 을지로2가 사거리 남측,202006,903,906,1809,37.56599,126.987793
종로구,334, 종로3가역 2번출구 뒤,201901,732,869,1601,37.570599,126.991791
종로구,334, 종로3가역 2번출구 뒤,201902,638,724,1362,37.570599,126.991791
종로구,334, 종로3가역 2번출구 뒤,201903,1126,1192,2318,37.570599,126.991791
종로구,334, 종로3가역 2번출구 뒤,201904,1527,1748,3275,37.570599,126.991791
종로구,334, 종로3가역 2번출구 뒤,201905,2159,2180,4339,37.570599,126.991791
종로구,334, 종로3가역 2번출구 뒤,201906,2291,2268,4559,37.570599,126.991791
종로구,334, 종로3가역 2번출구 뒤,201907,2111,2132,4243,37.570599,126.991791
종로구,334, 종로3가역 2번출구 뒤,201908,1926,1920,3846,37.570599,126.991791
종로구,334, 종로3가역 2번출구 뒤,201909,1874,1850,3724,37.570599,126.991791
종로구,334, 종로3가역 2번출구 뒤,201910,2401,2403,4804,37.570599,126.991791
종로구,334, 종로3가역 2번출구 뒤,201911,1703,1729,3432,37.570599,126.991791
종로구,334, 종로3가역 2번출구 뒤,201912,1018,1126,2144,37.570599,126.991791
종로구,334, 종로3가역 2번출구 뒤,202001,884,981,1865,37.570599,126.991791
종로구,334, 종로3가역 2번출구 뒤,202002,881,900,1781,37.570599,126.991791
종로구,334, 종로3가역 2번출구 뒤,202003,1444,1434,2878,37.570599,126.991791
종로구,334, 종로3가역 2번출구 뒤,202004,1822,1782,3604,37.570599,126.991791
종로구,334, 종로3가역 2번출구 뒤,202005,1905,1876,3781,37.570599,126.991791
종로구,334, 종로3가역 2번출구 뒤,202006,1938,1906,3844,37.570599,126.991791
종로구,335, 종로3가역 15번출구 앞,201901,579,625,1204,37.570198,126.991257
종로구,335, 종로3가역 15번출구 앞,201902,425,470,895,37.570198,126.991257
종로구,335, 종로3가역 15번출구 앞,201903,817,891,1708,37.570198,126.991257
종로구,335, 종로3가역 15번출구 앞,201904,1142,1191,2333,37.570198,126.991257
종로구,335, 종로3가역 15번출구 앞,201905,1474,1448,2922,37.570198,126.991257
종로구,335, 종로3가역 15번출구 앞,201906,1528,1526,3054,37.570198,126.991257
종로구,335, 종로3가역 15번출구 앞,201907,1474,1474,2948,37.570198,126.991257
종로구,335, 종로3가역 15번출구 앞,201908,1207,1207,2414,37.570198,126.991257
종로구,335, 종로3가역 15번출구 앞,201909,1219,1213,2432,37.570198,126.991257
종로구,335, 종로3가역 15번출구 앞,201910,1626,1632,3258,37.570198,126.991257
종로구,335, 종로3가역 15번출구 앞,201911,1299,1304,2603,37.570198,126.991257
종로구,335, 종로3가역 15번출구 앞,201912,813,877,1690,37.570198,126.991257
종로구,335, 종로3가역 15번출구 앞,202001,766,798,1564,37.570198,126.991257
종로구,335, 종로3가역 15번출구 앞,202002,720,742,1462,37.570198,126.991257
종로구,335, 종로3가역 15번출구 앞,202003,1010,1009,2019,37.570198,126.991257
종로구,335, 종로3가역 15번출구 앞,202004,1258,1257,2515,37.570198,126.991257
종로구,335, 종로3가역 15번출구 앞,202005,1058,1059,2117,37.570198,126.991257
종로구,335, 종로3가역 15번출구 앞,202006,1268,1270,2538,37.570198,126.991257
중구,336, 티마크 호텔 앞,201901,379,312,691,37.562618,126.992836
중구,336, 티마크 호텔 앞,201902,266,220,486,37.562618,126.992836
중구,336, 티마크 호텔 앞,201903,501,443,944,37.562618,126.992836
중구,336, 티마크 호텔 앞,201904,759,639,1398,37.562618,126.992836
중구,336, 티마크 호텔 앞,201905,875,751,1626,37.562618,126.992836
중구,336, 티마크 호텔 앞,201906,807,741,1548,37.562618,126.992836
중구,336, 티마크 호텔 앞,201907,859,772,1631,37.562618,126.992836
중구,336, 티마크 호텔 앞,201908,728,657,1385,37.562618,126.992836
중구,336, 티마크 호텔 앞,201909,762,716,1478,37.562618,126.992836
중구,336, 티마크 호텔 앞,201910,886,850,1736,37.562618,126.992836
중구,336, 티마크 호텔 앞,201911,546,512,1058,37.562618,126.992836
중구,336, 티마크 호텔 앞,201912,538,426,964,37.562618,126.992836
중구,336, 티마크 호텔 앞,202001,429,352,781,37.562618,126.992836
중구,336, 티마크 호텔 앞,202002,336,301,637,37.562618,126.992836
중구,336, 티마크 호텔 앞,202003,404,366,770,37.562618,126.992836
중구,336, 티마크 호텔 앞,202004,589,546,1135,37.562618,126.992836
중구,336, 티마크 호텔 앞,202005,614,582,1196,37.562618,126.992836
중구,336, 티마크 호텔 앞,202006,780,761,1541,37.562618,126.992836
종로구,337, 창경궁 입구,201901,137,145,282,37.578979,126.996475
종로구,337, 창경궁 입구,201902,169,211,380,37.578979,126.996475
종로구,337, 창경궁 입구,201903,309,316,625,37.578979,126.996475
종로구,337, 창경궁 입구,201904,563,548,1111,37.578979,126.996475
종로구,337, 창경궁 입구,201905,646,603,1249,37.578979,126.996475
종로구,337, 창경궁 입구,201906,500,475,975,37.578979,126.996475
종로구,337, 창경궁 입구,201907,471,423,894,37.578979,126.996475
종로구,337, 창경궁 입구,201908,501,487,988,37.578979,126.996475
종로구,337, 창경궁 입구,201909,512,490,1002,37.578979,126.996475
종로구,337, 창경궁 입구,201910,626,622,1248,37.578979,126.996475
종로구,337, 창경궁 입구,201911,473,466,939,37.578979,126.996475
종로구,337, 창경궁 입구,201912,234,240,474,37.578979,126.996475
종로구,337, 창경궁 입구,202001,231,213,444,37.578979,126.996475
종로구,337, 창경궁 입구,202002,187,167,354,37.578979,126.996475
종로구,337, 창경궁 입구,202003,362,365,727,37.578979,126.996475
종로구,337, 창경궁 입구,202004,463,451,914,37.578979,126.996475
종로구,337, 창경궁 입구,202005,474,466,940,37.578979,126.996475
종로구,337, 창경궁 입구,202006,436,407,843,37.578979,126.996475
종로구,338, 세운스퀘어 앞,201901,791,817,1608,37.570957,126.997124
종로구,338, 세운스퀘어 앞,201902,625,619,1244,37.570957,126.997124
종로구,338, 세운스퀘어 앞,201903,947,943,1890,37.570957,126.997124
종로구,338, 세운스퀘어 앞,201904,1378,1273,2651,37.570957,126.997124
종로구,338, 세운스퀘어 앞,201905,1650,1550,3200,37.570957,126.997124
종로구,338, 세운스퀘어 앞,201906,1571,1451,3022,37.570957,126.997124
종로구,338, 세운스퀘어 앞,201907,1573,1532,3105,37.570957,126.997124
종로구,338, 세운스퀘어 앞,201908,1402,1330,2732,37.570957,126.997124
종로구,338, 세운스퀘어 앞,201909,1292,1171,2463,37.570957,126.997124
종로구,338, 세운스퀘어 앞,201910,1645,1598,3243,37.570957,126.997124
종로구,338, 세운스퀘어 앞,201911,1411,1313,2724,37.570957,126.997124
종로구,338, 세운스퀘어 앞,201912,1034,941,1975,37.570957,126.997124
종로구,338, 세운스퀘어 앞,202001,944,897,1841,37.570957,126.997124
종로구,338, 세운스퀘어 앞,202002,763,757,1520,37.570957,126.997124
종로구,338, 세운스퀘어 앞,202003,835,768,1603,37.570957,126.997124
종로구,338, 세운스퀘어 앞,202004,1066,1030,2096,37.570957,126.997124
종로구,338, 세운스퀘어 앞,202005,1016,1013,2029,37.570957,126.997124
종로구,338, 세운스퀘어 앞,202006,1406,1398,2804,37.570957,126.997124
종로구,339, 종로4가 사거리,201901,634,676,1310,37.571068,126.998192
종로구,339, 종로4가 사거리,201902,476,502,978,37.571068,126.998192
종로구,339, 종로4가 사거리,201903,706,725,1431,37.571068,126.998192
종로구,339, 종로4가 사거리,201904,989,933,1922,37.571068,126.998192
종로구,339, 종로4가 사거리,201905,1266,1151,2417,37.571068,126.998192
종로구,339, 종로4가 사거리,201906,1190,1068,2258,37.571068,126.998192
종로구,339, 종로4가 사거리,201907,1292,1151,2443,37.571068,126.998192
종로구,339, 종로4가 사거리,201908,1220,1089,2309,37.571068,126.998192
종로구,339, 종로4가 사거리,201909,1288,1120,2408,37.571068,126.998192
종로구,339, 종로4가 사거리,201910,1540,1376,2916,37.571068,126.998192
종로구,339, 종로4가 사거리,201911,1066,1008,2074,37.571068,126.998192
종로구,339, 종로4가 사거리,201912,734,744,1478,37.571068,126.998192
종로구,339, 종로4가 사거리,202001,648,660,1308,37.571068,126.998192
종로구,339, 종로4가 사거리,202002,521,579,1100,37.571068,126.998192
종로구,339, 종로4가 사거리,202003,911,818,1729,37.571068,126.998192
종로구,339, 종로4가 사거리,202004,1095,948,2043,37.571068,126.998192
종로구,339, 종로4가 사거리,202005,1006,919,1925,37.571068,126.998192
종로구,339, 종로4가 사거리,202006,1141,1030,2171,37.571068,126.998192
종로구,340, 혜화동 로터리,201901,538,532,1070,37.585629,127.000679
종로구,340, 혜화동 로터리,201902,490,471,961,37.585629,127.000679
종로구,340, 혜화동 로터리,201903,990,980,1970,37.585629,127.000679
종로구,340, 혜화동 로터리,201904,1323,1318,2641,37.585629,127.000679
종로구,340, 혜화동 로터리,201905,1831,1795,3626,37.585629,127.000679
종로구,340, 혜화동 로터리,201906,1874,1827,3701,37.585629,127.000679
종로구,340, 혜화동 로터리,201907,1912,1881,3793,37.585629,127.000679
종로구,340, 혜화동 로터리,201908,1821,1792,3613,37.585629,127.000679
종로구,340, 혜화동 로터리,201909,1767,1728,3495,37.585629,127.000679
종로구,340, 혜화동 로터리,201910,1982,1984,3966,37.585629,127.000679
종로구,340, 혜화동 로터리,201911,1467,1490,2957,37.585629,127.000679
종로구,340, 혜화동 로터리,201912,877,901,1778,37.585629,127.000679
종로구,340, 혜화동 로터리,202001,757,804,1561,37.585629,127.000679
종로구,340, 혜화동 로터리,202002,749,808,1557,37.585629,127.000679
종로구,340, 혜화동 로터리,202003,1290,1329,2619,37.585629,127.000679
종로구,340, 혜화동 로터리,202004,1699,1684,3383,37.585629,127.000679
종로구,340, 혜화동 로터리,202005,1909,1904,3813,37.585629,127.000679
종로구,340, 혜화동 로터리,202006,2031,2029,4060,37.585629,127.000679
종로구,341, 혜화역 3번출구 뒤,201901,452,489,941,37.58157,127.001785
종로구,341, 혜화역 3번출구 뒤,201902,435,467,902,37.58157,127.001785
종로구,341, 혜화역 3번출구 뒤,201903,755,746,1501,37.58157,127.001785
종로구,341, 혜화역 3번출구 뒤,201904,1136,1030,2166,37.58157,127.001785
종로구,341, 혜화역 3번출구 뒤,201905,1539,1407,2946,37.58157,127.001785
종로구,341, 혜화역 3번출구 뒤,201906,1537,1384,2921,37.58157,127.001785
종로구,341, 혜화역 3번출구 뒤,201907,1478,1361,2839,37.58157,127.001785
종로구,341, 혜화역 3번출구 뒤,201908,1376,1264,2640,37.58157,127.001785
종로구,341, 혜화역 3번출구 뒤,201909,1246,1137,2383,37.58157,127.001785
종로구,341, 혜화역 3번출구 뒤,201910,1384,1356,2740,37.58157,127.001785
종로구,341, 혜화역 3번출구 뒤,201911,1072,994,2066,37.58157,127.001785
종로구,341, 혜화역 3번출구 뒤,201912,744,644,1388,37.58157,127.001785
종로구,341, 혜화역 3번출구 뒤,202001,671,594,1265,37.58157,127.001785
종로구,341, 혜화역 3번출구 뒤,202002,563,518,1081,37.58157,127.001785
종로구,341, 혜화역 3번출구 뒤,202003,826,784,1610,37.58157,127.001785
종로구,341, 혜화역 3번출구 뒤,202004,1061,1001,2062,37.58157,127.001785
종로구,341, 혜화역 3번출구 뒤,202005,1137,1072,2209,37.58157,127.001785
종로구,341, 혜화역 3번출구 뒤,202006,1229,1127,2356,37.58157,127.001785
종로구,342, 대학로 마로니에공원,201901,694,761,1455,37.579784,127.002533
종로구,342, 대학로 마로니에공원,201902,633,724,1357,37.579784,127.002533
종로구,342, 대학로 마로니에공원,201903,1166,1312,2478,37.579784,127.002533
종로구,342, 대학로 마로니에공원,201904,1767,1932,3699,37.579784,127.002533
종로구,342, 대학로 마로니에공원,201905,2514,2462,4976,37.579784,127.002533
종로구,342, 대학로 마로니에공원,201906,2790,2741,5531,37.579784,127.002533
종로구,342, 대학로 마로니에공원,201907,2779,2737,5516,37.579784,127.002533
종로구,342, 대학로 마로니에공원,201908,2573,2569,5142,37.579784,127.002533
종로구,342, 대학로 마로니에공원,201909,2493,2415,4908,37.579784,127.002533
종로구,342, 대학로 마로니에공원,201910,3147,3131,6278,37.579784,127.002533
종로구,342, 대학로 마로니에공원,201911,2095,2229,4324,37.579784,127.002533
종로구,342, 대학로 마로니에공원,201912,1212,1339,2551,37.579784,127.002533
종로구,342, 대학로 마로니에공원,202001,977,1052,2029,37.579784,127.002533
종로구,342, 대학로 마로니에공원,202002,948,1008,1956,37.579784,127.002533
종로구,342, 대학로 마로니에공원,202003,1477,1478,2955,37.579784,127.002533
종로구,342, 대학로 마로니에공원,202004,2038,2011,4049,37.579784,127.002533
종로구,342, 대학로 마로니에공원,202005,2292,2247,4539,37.579784,127.002533
종로구,342, 대학로 마로니에공원,202006,2557,2511,5068,37.579784,127.002533
종로구,343, 예일빌딩(율곡로) 앞,201901,475,452,927,37.575432,127.004982
종로구,343, 예일빌딩(율곡로) 앞,201902,338,327,665,37.575432,127.004982
종로구,343, 예일빌딩(율곡로) 앞,201903,556,534,1090,37.575432,127.004982
종로구,343, 예일빌딩(율곡로) 앞,201904,693,629,1322,37.575432,127.004982
종로구,343, 예일빌딩(율곡로) 앞,201905,837,737,1574,37.575432,127.004982
종로구,343, 예일빌딩(율곡로) 앞,201906,747,633,1380,37.575432,127.004982
종로구,343, 예일빌딩(율곡로) 앞,201907,973,821,1794,37.575432,127.004982
종로구,343, 예일빌딩(율곡로) 앞,201908,899,829,1728,37.575432,127.004982
종로구,343, 예일빌딩(율곡로) 앞,201909,696,648,1344,37.575432,127.004982
종로구,343, 예일빌딩(율곡로) 앞,201910,785,770,1555,37.575432,127.004982
종로구,343, 예일빌딩(율곡로) 앞,201911,645,601,1246,37.575432,127.004982
종로구,343, 예일빌딩(율곡로) 앞,201912,521,465,986,37.575432,127.004982
종로구,343, 예일빌딩(율곡로) 앞,202001,402,291,693,37.575432,127.004982
종로구,343, 예일빌딩(율곡로) 앞,202002,335,242,577,37.575432,127.004982
종로구,343, 예일빌딩(율곡로) 앞,202003,425,380,805,37.575432,127.004982
종로구,343, 예일빌딩(율곡로) 앞,202004,572,513,1085,37.575432,127.004982
종로구,343, 예일빌딩(율곡로) 앞,202005,423,407,830,37.575432,127.004982
종로구,343, 예일빌딩(율곡로) 앞,202006,404,397,801,37.575432,127.004982
종로구,344, 성균관대 E하우스 앞,201901,426,394,820,37.574036,127.006721
종로구,344, 성균관대 E하우스 앞,201902,298,242,540,37.574036,127.006721
종로구,344, 성균관대 E하우스 앞,201903,658,645,1303,37.574036,127.006721
종로구,344, 성균관대 E하우스 앞,201904,882,914,1796,37.574036,127.006721
종로구,344, 성균관대 E하우스 앞,201905,1173,1156,2329,37.574036,127.006721
종로구,344, 성균관대 E하우스 앞,201906,1192,1129,2321,37.574036,127.006721
종로구,344, 성균관대 E하우스 앞,201907,1037,965,2002,37.574036,127.006721
종로구,344, 성균관대 E하우스 앞,201908,848,768,1616,37.574036,127.006721
종로구,344, 성균관대 E하우스 앞,201909,1231,1205,2436,37.574036,127.006721
종로구,344, 성균관대 E하우스 앞,201910,1571,1561,3132,37.574036,127.006721
종로구,344, 성균관대 E하우스 앞,201911,1083,1181,2264,37.574036,127.006721
종로구,344, 성균관대 E하우스 앞,201912,668,714,1382,37.574036,127.006721
종로구,344, 성균관대 E하우스 앞,202001,428,424,852,37.574036,127.006721
종로구,344, 성균관대 E하우스 앞,202002,375,352,727,37.574036,127.006721
종로구,344, 성균관대 E하우스 앞,202003,434,415,849,37.574036,127.006721
종로구,344, 성균관대 E하우스 앞,202004,615,526,1141,37.574036,127.006721
종로구,344, 성균관대 E하우스 앞,202005,501,483,984,37.574036,127.006721
종로구,344, 성균관대 E하우스 앞,202006,590,523,1113,37.574036,127.006721
종로구,345, 서울보증보험본사 앞,201901,502,562,1064,37.573307,127.00071
종로구,345, 서울보증보험본사 앞,201902,396,408,804,37.573307,127.00071
종로구,345, 서울보증보험본사 앞,201903,626,658,1284,37.573307,127.00071
종로구,345, 서울보증보험본사 앞,201904,915,853,1768,37.573307,127.00071
종로구,345, 서울보증보험본사 앞,201905,1168,1059,2227,37.573307,127.00071
종로구,345, 서울보증보험본사 앞,201906,1217,1134,2351,37.573307,127.00071
종로구,345, 서울보증보험본사 앞,201907,1399,1323,2722,37.573307,127.00071
종로구,345, 서울보증보험본사 앞,201908,1363,1274,2637,37.573307,127.00071
종로구,345, 서울보증보험본사 앞,201909,1176,1116,2292,37.573307,127.00071
종로구,345, 서울보증보험본사 앞,201910,1537,1441,2978,37.573307,127.00071
종로구,345, 서울보증보험본사 앞,201911,1214,1211,2425,37.573307,127.00071
종로구,345, 서울보증보험본사 앞,201912,802,883,1685,37.573307,127.00071
종로구,345, 서울보증보험본사 앞,202001,716,748,1464,37.573307,127.00071
종로구,345, 서울보증보험본사 앞,202002,587,614,1201,37.573307,127.00071
종로구,345, 서울보증보험본사 앞,202003,686,649,1335,37.573307,127.00071
종로구,345, 서울보증보험본사 앞,202004,806,745,1551,37.573307,127.00071
종로구,345, 서울보증보험본사 앞,202005,916,871,1787,37.573307,127.00071
종로구,345, 서울보증보험본사 앞,202006,1165,1065,2230,37.573307,127.00071
중구,346, 맥스타일 앞,201901,683,730,1413,37.569183,127.00988
중구,346, 맥스타일 앞,201902,660,702,1362,37.569183,127.00988
중구,346, 맥스타일 앞,201903,1157,1319,2476,37.569183,127.00988
중구,346, 맥스타일 앞,201904,1589,1757,3346,37.569183,127.00988
중구,346, 맥스타일 앞,201905,2335,2416,4751,37.569183,127.00988
중구,346, 맥스타일 앞,201906,2356,2421,4777,37.569183,127.00988
중구,346, 맥스타일 앞,201907,2186,2288,4474,37.569183,127.00988
중구,346, 맥스타일 앞,201908,2093,2113,4206,37.569183,127.00988
중구,346, 맥스타일 앞,201909,1973,2075,4048,37.569183,127.00988
중구,346, 맥스타일 앞,201910,2507,2585,5092,37.569183,127.00988
중구,346, 맥스타일 앞,201911,1782,1916,3698,37.569183,127.00988
중구,346, 맥스타일 앞,201912,1131,1291,2422,37.569183,127.00988
중구,346, 맥스타일 앞,202001,965,1052,2017,37.569183,127.00988
중구,346, 맥스타일 앞,202002,958,1017,1975,37.569183,127.00988
중구,346, 맥스타일 앞,202003,1335,1419,2754,37.569183,127.00988
중구,346, 맥스타일 앞,202004,1810,1859,3669,37.569183,127.00988
중구,346, 맥스타일 앞,202005,1782,1831,3613,37.569183,127.00988
중구,346, 맥스타일 앞,202006,1987,2043,4030,37.569183,127.00988
중구,347, 동대문역사문화공원역 9번출구 앞,201901,592,543,1135,37.565331,127.007843
중구,347, 동대문역사문화공원역 9번출구 앞,201902,544,416,960,37.565331,127.007843
중구,347, 동대문역사문화공원역 9번출구 앞,201903,993,957,1950,37.565331,127.007843
중구,347, 동대문역사문화공원역 9번출구 앞,201904,1414,1284,2698,37.565331,127.007843
중구,347, 동대문역사문화공원역 9번출구 앞,201905,2245,1945,4190,37.565331,127.007843
중구,347, 동대문역사문화공원역 9번출구 앞,201906,2198,2022,4220,37.565331,127.007843
중구,347, 동대문역사문화공원역 9번출구 앞,201907,1906,1696,3602,37.565331,127.007843
중구,347, 동대문역사문화공원역 9번출구 앞,201908,1999,1741,3740,37.565331,127.007843
중구,347, 동대문역사문화공원역 9번출구 앞,201909,1822,1679,3501,37.565331,127.007843
중구,347, 동대문역사문화공원역 9번출구 앞,201910,2180,2071,4251,37.565331,127.007843
중구,347, 동대문역사문화공원역 9번출구 앞,201911,1521,1396,2917,37.565331,127.007843
중구,347, 동대문역사문화공원역 9번출구 앞,201912,925,836,1761,37.565331,127.007843
중구,347, 동대문역사문화공원역 9번출구 앞,202001,745,665,1410,37.565331,127.007843
중구,347, 동대문역사문화공원역 9번출구 앞,202002,696,618,1314,37.565331,127.007843
중구,347, 동대문역사문화공원역 9번출구 앞,202003,1140,1002,2142,37.565331,127.007843
중구,347, 동대문역사문화공원역 9번출구 앞,202004,1629,1401,3030,37.565331,127.007843
중구,347, 동대문역사문화공원역 9번출구 앞,202005,1678,1509,3187,37.565331,127.007843
중구,347, 동대문역사문화공원역 9번출구 앞,202006,1484,1221,2705,37.565331,127.007843
종로구,348, 독립문역 사거리,201901,355,272,627,37.572029,126.960785
종로구,348, 독립문역 사거리,201902,343,254,597,37.572029,126.960785
종로구,348, 독립문역 사거리,201903,614,465,1079,37.572029,126.960785
종로구,348, 독립문역 사거리,201904,802,603,1405,37.572029,126.960785
종로구,348, 독립문역 사거리,201905,920,754,1674,37.572029,126.960785
종로구,348, 독립문역 사거리,201906,970,788,1758,37.572029,126.960785
종로구,348, 독립문역 사거리,201907,969,711,1680,37.572029,126.960785
종로구,348, 독립문역 사거리,201908,910,754,1664,37.572029,126.960785
종로구,348, 독립문역 사거리,201909,842,683,1525,37.572029,126.960785
종로구,348, 독립문역 사거리,201910,974,737,1711,37.572029,126.960785
종로구,348, 독립문역 사거리,201911,692,510,1202,37.572029,126.960785
종로구,348, 독립문역 사거리,201912,538,313,851,37.572029,126.960785
종로구,348, 독립문역 사거리,202001,479,254,733,37.572029,126.960785
종로구,348, 독립문역 사거리,202002,416,287,703,37.572029,126.960785
종로구,348, 독립문역 사거리,202003,743,537,1280,37.572029,126.960785
종로구,348, 독립문역 사거리,202004,1146,785,1931,37.572029,126.960785
종로구,348, 독립문역 사거리,202005,1048,722,1770,37.572029,126.960785
종로구,348, 독립문역 사거리,202006,1281,837,2118,37.572029,126.960785
종로구,349, 사직동주민센터,201901,370,292,662,37.576332,126.96859
종로구,349, 사직동주민센터,201902,307,252,559,37.576332,126.96859
종로구,349, 사직동주민센터,201903,515,435,950,37.576332,126.96859
종로구,349, 사직동주민센터,201904,718,597,1315,37.576332,126.96859
종로구,349, 사직동주민센터,201905,769,735,1504,37.576332,126.96859
종로구,349, 사직동주민센터,201906,827,786,1613,37.576332,126.96859
종로구,349, 사직동주민센터,201907,807,756,1563,37.576332,126.96859
종로구,349, 사직동주민센터,201908,685,664,1349,37.576332,126.96859
종로구,349, 사직동주민센터,201909,749,719,1468,37.576332,126.96859
종로구,349, 사직동주민센터,201910,827,803,1630,37.576332,126.96859
종로구,349, 사직동주민센터,201911,571,548,1119,37.576332,126.96859
종로구,349, 사직동주민센터,201912,390,370,760,37.576332,126.96859
종로구,349, 사직동주민센터,202001,434,394,828,37.576332,126.96859
종로구,349, 사직동주민센터,202002,412,379,791,37.576332,126.96859
종로구,349, 사직동주민센터,202003,628,585,1213,37.576332,126.96859
종로구,349, 사직동주민센터,202004,796,757,1553,37.576332,126.96859
종로구,349, 사직동주민센터,202005,853,777,1630,37.576332,126.96859
종로구,349, 사직동주민센터,202006,786,741,1527,37.576332,126.96859
종로구,351, 청운초교 앞 삼거리,201901,356,293,649,37.585079,126.970619
종로구,351, 청운초교 앞 삼거리,201902,314,269,583,37.585079,126.970619
종로구,351, 청운초교 앞 삼거리,201903,523,436,959,37.585079,126.970619
종로구,351, 청운초교 앞 삼거리,201904,680,582,1262,37.585079,126.970619
종로구,351, 청운초교 앞 삼거리,201905,747,707,1454,37.585079,126.970619
종로구,351, 청운초교 앞 삼거리,201906,780,736,1516,37.585079,126.970619
종로구,351, 청운초교 앞 삼거리,201907,774,730,1504,37.585079,126.970619
종로구,351, 청운초교 앞 삼거리,201908,747,695,1442,37.585079,126.970619
종로구,351, 청운초교 앞 삼거리,201909,774,752,1526,37.585079,126.970619
종로구,351, 청운초교 앞 삼거리,201910,944,937,1881,37.585079,126.970619
종로구,351, 청운초교 앞 삼거리,201911,710,642,1352,37.585079,126.970619
종로구,351, 청운초교 앞 삼거리,201912,455,403,858,37.585079,126.970619
종로구,351, 청운초교 앞 삼거리,202001,412,354,766,37.585079,126.970619
종로구,351, 청운초교 앞 삼거리,202002,314,264,578,37.585079,126.970619
종로구,351, 청운초교 앞 삼거리,202003,562,522,1084,37.585079,126.970619
종로구,351, 청운초교 앞 삼거리,202004,833,787,1620,37.585079,126.970619
종로구,351, 청운초교 앞 삼거리,202005,826,764,1590,37.585079,126.970619
종로구,351, 청운초교 앞 삼거리,202006,1004,982,1986,37.585079,126.970619
종로구,352, 중앙고입구 삼거리,201901,175,111,286,37.583416,126.985237
종로구,352, 중앙고입구 삼거리,201902,175,89,264,37.583416,126.985237
종로구,352, 중앙고입구 삼거리,201903,316,193,509,37.583416,126.985237
종로구,352, 중앙고입구 삼거리,201904,486,222,708,37.583416,126.985237
종로구,352, 중앙고입구 삼거리,201905,423,270,693,37.583416,126.985237
종로구,352, 중앙고입구 삼거리,201906,465,262,727,37.583416,126.985237
종로구,352, 중앙고입구 삼거리,201907,515,235,750,37.583416,126.985237
종로구,352, 중앙고입구 삼거리,201908,333,183,516,37.583416,126.985237
종로구,352, 중앙고입구 삼거리,201909,332,174,506,37.583416,126.985237
종로구,352, 중앙고입구 삼거리,201910,333,226,559,37.583416,126.985237
종로구,352, 중앙고입구 삼거리,201911,248,175,423,37.583416,126.985237
종로구,352, 중앙고입구 삼거리,201912,186,89,275,37.583416,126.985237
종로구,352, 중앙고입구 삼거리,202001,179,59,238,37.583416,126.985237
종로구,352, 중앙고입구 삼거리,202002,133,84,217,37.583416,126.985237
종로구,352, 중앙고입구 삼거리,202003,192,88,280,37.583416,126.985237
종로구,352, 중앙고입구 삼거리,202004,345,138,483,37.583416,126.985237
종로구,352, 중앙고입구 삼거리,202005,398,203,601,37.583416,126.985237
종로구,352, 중앙고입구 삼거리,202006,291,175,466,37.583416,126.985237
종로구,353, 재동초교 앞 삼거리,201901,270,236,506,37.579388,126.984947
종로구,353, 재동초교 앞 삼거리,201902,212,227,439,37.579388,126.984947
종로구,353, 재동초교 앞 삼거리,201903,422,451,873,37.579388,126.984947
종로구,353, 재동초교 앞 삼거리,201904,683,693,1376,37.579388,126.984947
종로구,353, 재동초교 앞 삼거리,201905,915,818,1733,37.579388,126.984947
종로구,353, 재동초교 앞 삼거리,201906,900,830,1730,37.579388,126.984947
종로구,353, 재동초교 앞 삼거리,201907,727,662,1389,37.579388,126.984947
종로구,353, 재동초교 앞 삼거리,201908,681,646,1327,37.579388,126.984947
종로구,353, 재동초교 앞 삼거리,201909,709,674,1383,37.579388,126.984947
종로구,353, 재동초교 앞 삼거리,201910,810,791,1601,37.579388,126.984947
종로구,353, 재동초교 앞 삼거리,201911,590,563,1153,37.579388,126.984947
종로구,353, 재동초교 앞 삼거리,201912,377,362,739,37.579388,126.984947
종로구,353, 재동초교 앞 삼거리,202001,422,393,815,37.579388,126.984947
종로구,353, 재동초교 앞 삼거리,202002,383,359,742,37.579388,126.984947
종로구,353, 재동초교 앞 삼거리,202003,617,590,1207,37.579388,126.984947
종로구,353, 재동초교 앞 삼거리,202004,819,792,1611,37.579388,126.984947
종로구,353, 재동초교 앞 삼거리,202005,826,802,1628,37.579388,126.984947
종로구,353, 재동초교 앞 삼거리,202006,787,778,1565,37.579388,126.984947
종로구,354, 포르투갈 대사관 앞,201901,355,277,632,37.579155,126.98896
종로구,354, 포르투갈 대사관 앞,201902,318,263,581,37.579155,126.98896
종로구,354, 포르투갈 대사관 앞,201903,536,470,1006,37.579155,126.98896
종로구,354, 포르투갈 대사관 앞,201904,906,748,1654,37.579155,126.98896
종로구,354, 포르투갈 대사관 앞,201905,1122,985,2107,37.579155,126.98896
종로구,354, 포르투갈 대사관 앞,201906,983,872,1855,37.579155,126.98896
종로구,354, 포르투갈 대사관 앞,201907,962,804,1766,37.579155,126.98896
종로구,354, 포르투갈 대사관 앞,201908,853,770,1623,37.579155,126.98896
종로구,354, 포르투갈 대사관 앞,201909,888,796,1684,37.579155,126.98896
종로구,354, 포르투갈 대사관 앞,201910,1144,1090,2234,37.579155,126.98896
종로구,354, 포르투갈 대사관 앞,201911,836,802,1638,37.579155,126.98896
종로구,354, 포르투갈 대사관 앞,201912,497,399,896,37.579155,126.98896
종로구,354, 포르투갈 대사관 앞,202001,521,442,963,37.579155,126.98896
종로구,354, 포르투갈 대사관 앞,202002,457,367,824,37.579155,126.98896
종로구,354, 포르투갈 대사관 앞,202003,653,620,1273,37.579155,126.98896
종로구,354, 포르투갈 대사관 앞,202004,987,907,1894,37.579155,126.98896
종로구,354, 포르투갈 대사관 앞,202005,1094,1002,2096,37.579155,126.98896
종로구,354, 포르투갈 대사관 앞,202006,936,908,1844,37.579155,126.98896
종로구,355, 서울사대부속초교 앞,201901,626,692,1318,37.576508,127.002457
종로구,355, 서울사대부속초교 앞,201902,527,571,1098,37.576508,127.002457
종로구,355, 서울사대부속초교 앞,201903,815,923,1738,37.576508,127.002457
종로구,355, 서울사대부속초교 앞,201904,1120,1185,2305,37.576508,127.002457
종로구,355, 서울사대부속초교 앞,201905,1577,1443,3020,37.576508,127.002457
종로구,355, 서울사대부속초교 앞,201906,1442,1280,2722,37.576508,127.002457
종로구,355, 서울사대부속초교 앞,201907,1685,1436,3121,37.576508,127.002457
종로구,355, 서울사대부속초교 앞,201908,1569,1349,2918,37.576508,127.002457
종로구,355, 서울사대부속초교 앞,201909,1472,1331,2803,37.576508,127.002457
종로구,355, 서울사대부속초교 앞,201910,1614,1421,3035,37.576508,127.002457
종로구,355, 서울사대부속초교 앞,201911,1248,1147,2395,37.576508,127.002457
종로구,355, 서울사대부속초교 앞,201912,850,860,1710,37.576508,127.002457
종로구,355, 서울사대부속초교 앞,202001,601,729,1330,37.576508,127.002457
종로구,355, 서울사대부속초교 앞,202002,591,598,1189,37.576508,127.002457
종로구,355, 서울사대부속초교 앞,202003,847,804,1651,37.576508,127.002457
종로구,355, 서울사대부속초교 앞,202004,1203,1036,2239,37.576508,127.002457
종로구,355, 서울사대부속초교 앞,202005,1009,907,1916,37.576508,127.002457
종로구,355, 서울사대부속초교 앞,202006,1180,965,2145,37.576508,127.002457
종로구,356, KT혜화지사 앞,201901,673,631,1304,37.577145,127.00206
종로구,356, KT혜화지사 앞,201902,535,524,1059,37.577145,127.00206
종로구,356, KT혜화지사 앞,201903,851,861,1712,37.577145,127.00206
종로구,356, KT혜화지사 앞,201904,1186,1180,2366,37.577145,127.00206
종로구,356, KT혜화지사 앞,201905,1478,1401,2879,37.577145,127.00206
종로구,356, KT혜화지사 앞,201906,1431,1332,2763,37.577145,127.00206
종로구,356, KT혜화지사 앞,201907,1487,1403,2890,37.577145,127.00206
종로구,356, KT혜화지사 앞,201908,1375,1255,2630,37.577145,127.00206
종로구,356, KT혜화지사 앞,201909,1187,1150,2337,37.577145,127.00206
종로구,356, KT혜화지사 앞,201910,1479,1385,2864,37.577145,127.00206
종로구,356, KT혜화지사 앞,201911,1249,1165,2414,37.577145,127.00206
종로구,356, KT혜화지사 앞,201912,759,782,1541,37.577145,127.00206
종로구,356, KT혜화지사 앞,202001,650,650,1300,37.577145,127.00206
종로구,356, KT혜화지사 앞,202002,571,568,1139,37.577145,127.00206
종로구,356, KT혜화지사 앞,202003,871,836,1707,37.577145,127.00206
종로구,356, KT혜화지사 앞,202004,1064,1014,2078,37.577145,127.00206
종로구,356, KT혜화지사 앞,202005,1063,1035,2098,37.577145,127.00206
종로구,356, KT혜화지사 앞,202006,1233,1180,2413,37.577145,127.00206
종로구,358, 성대입구 사거리,201901,997,1109,2106,37.5825,126.998535
종로구,358, 성대입구 사거리,201902,891,971,1862,37.5825,126.998535
종로구,358, 성대입구 사거리,201903,1776,1841,3617,37.5825,126.998535
종로구,358, 성대입구 사거리,201904,2470,2486,4956,37.5825,126.998535
종로구,358, 성대입구 사거리,201905,3574,3484,7058,37.5825,126.998535
종로구,358, 성대입구 사거리,201906,3463,3443,6906,37.5825,126.998535
종로구,358, 성대입구 사거리,201907,3153,3142,6295,37.5825,126.998535
종로구,358, 성대입구 사거리,201908,2898,2891,5789,37.5825,126.998535
종로구,358, 성대입구 사거리,201909,3159,3121,6280,37.5825,126.998535
종로구,358, 성대입구 사거리,201910,3712,3695,7407,37.5825,126.998535
종로구,358, 성대입구 사거리,201911,2782,2790,5572,37.5825,126.998535
종로구,358, 성대입구 사거리,201912,1770,1758,3528,37.5825,126.998535
종로구,358, 성대입구 사거리,202001,1286,1365,2651,37.5825,126.998535
종로구,358, 성대입구 사거리,202002,1115,1157,2272,37.5825,126.998535
종로구,358, 성대입구 사거리,202003,1760,1727,3487,37.5825,126.998535
종로구,358, 성대입구 사거리,202004,2245,2190,4435,37.5825,126.998535
종로구,358, 성대입구 사거리,202005,2305,2276,4581,37.5825,126.998535
종로구,358, 성대입구 사거리,202006,2230,2211,4441,37.5825,126.998535
종로구,359, 원남동사거리,201901,400,481,881,37.576061,126.997681
종로구,359, 원남동사거리,201902,346,395,741,37.576061,126.997681
종로구,359, 원남동사거리,201903,612,701,1313,37.576061,126.997681
종로구,359, 원남동사거리,201904,1030,1079,2109,37.576061,126.997681
종로구,359, 원남동사거리,201905,1325,1404,2729,37.576061,126.997681
종로구,359, 원남동사거리,201906,1296,1289,2585,37.576061,126.997681
종로구,359, 원남동사거리,201907,1252,1272,2524,37.576061,126.997681
종로구,359, 원남동사거리,201908,1103,1095,2198,37.576061,126.997681
종로구,359, 원남동사거리,201909,1353,1368,2721,37.576061,126.997681
종로구,359, 원남동사거리,201910,1609,1646,3255,37.576061,126.997681
종로구,359, 원남동사거리,201911,1173,1280,2453,37.576061,126.997681
종로구,359, 원남동사거리,201912,709,830,1539,37.576061,126.997681
종로구,359, 원남동사거리,202001,569,627,1196,37.576061,126.997681
종로구,359, 원남동사거리,202002,493,525,1018,37.576061,126.997681
종로구,359, 원남동사거리,202003,756,757,1513,37.576061,126.997681
종로구,359, 원남동사거리,202004,925,943,1868,37.576061,126.997681
종로구,359, 원남동사거리,202005,1008,1007,2015,37.576061,126.997681
종로구,359, 원남동사거리,202006,1151,1168,2319,37.576061,126.997681
종로구,361, 동묘앞역 1번출구 뒤,201901,858,987,1845,37.573242,127.015907
종로구,361, 동묘앞역 1번출구 뒤,201902,770,892,1662,37.573242,127.015907
종로구,361, 동묘앞역 1번출구 뒤,201903,1298,1590,2888,37.573242,127.015907
종로구,361, 동묘앞역 1번출구 뒤,201904,1924,2261,4185,37.573242,127.015907
종로구,361, 동묘앞역 1번출구 뒤,201905,3223,3267,6490,37.573242,127.015907
종로구,361, 동묘앞역 1번출구 뒤,201906,3189,3204,6393,37.573242,127.015907
종로구,361, 동묘앞역 1번출구 뒤,201907,3243,3185,6428,37.573242,127.015907
종로구,361, 동묘앞역 1번출구 뒤,201908,3073,3060,6133,37.573242,127.015907
종로구,361, 동묘앞역 1번출구 뒤,201909,2908,2908,5816,37.573242,127.015907
종로구,361, 동묘앞역 1번출구 뒤,201910,3629,3657,7286,37.573242,127.015907
종로구,361, 동묘앞역 1번출구 뒤,201911,2588,2757,5345,37.573242,127.015907
종로구,361, 동묘앞역 1번출구 뒤,201912,1613,1776,3389,37.573242,127.015907
종로구,361, 동묘앞역 1번출구 뒤,202001,1430,1596,3026,37.573242,127.015907
종로구,361, 동묘앞역 1번출구 뒤,202002,1313,1458,2771,37.573242,127.015907
종로구,361, 동묘앞역 1번출구 뒤,202003,2081,2070,4151,37.573242,127.015907
종로구,361, 동묘앞역 1번출구 뒤,202004,2841,2817,5658,37.573242,127.015907
종로구,361, 동묘앞역 1번출구 뒤,202005,2758,2744,5502,37.573242,127.015907
종로구,361, 동묘앞역 1번출구 뒤,202006,3151,3140,6291,37.573242,127.015907
종로구,362, 청계8가 사거리,201901,591,597,1188,37.572224,127.022705
종로구,362, 청계8가 사거리,201902,448,456,904,37.572224,127.022705
종로구,362, 청계8가 사거리,201903,898,879,1777,37.572224,127.022705
종로구,362, 청계8가 사거리,201904,1137,1145,2282,37.572224,127.022705
종로구,362, 청계8가 사거리,201905,1574,1539,3113,37.572224,127.022705
종로구,362, 청계8가 사거리,201906,1446,1420,2866,37.572224,127.022705
종로구,362, 청계8가 사거리,201907,1687,1695,3382,37.572224,127.022705
종로구,362, 청계8가 사거리,201908,1600,1609,3209,37.572224,127.022705
종로구,362, 청계8가 사거리,201909,1421,1412,2833,37.572224,127.022705
종로구,362, 청계8가 사거리,201910,1790,1789,3579,37.572224,127.022705
종로구,362, 청계8가 사거리,201911,1527,1510,3037,37.572224,127.022705
종로구,362, 청계8가 사거리,201912,997,972,1969,37.572224,127.022705
종로구,362, 청계8가 사거리,202001,900,898,1798,37.572224,127.022705
종로구,362, 청계8가 사거리,202002,928,898,1826,37.572224,127.022705
종로구,362, 청계8가 사거리,202003,1340,1253,2593,37.572224,127.022705
종로구,362, 청계8가 사거리,202004,1523,1471,2994,37.572224,127.022705
종로구,362, 청계8가 사거리,202005,1637,1577,3214,37.572224,127.022705
종로구,362, 청계8가 사거리,202006,1788,1764,3552,37.572224,127.022705
종로구,363, 신설동역 11번출구 뒤,201901,560,677,1237,37.57576,127.022835
종로구,363, 신설동역 11번출구 뒤,201902,446,492,938,37.57576,127.022835
종로구,363, 신설동역 11번출구 뒤,201903,906,925,1831,37.57576,127.022835
종로구,363, 신설동역 11번출구 뒤,201904,1170,1179,2349,37.57576,127.022835
종로구,363, 신설동역 11번출구 뒤,201905,1589,1562,3151,37.57576,127.022835
종로구,363, 신설동역 11번출구 뒤,201906,1915,1909,3824,37.57576,127.022835
종로구,363, 신설동역 11번출구 뒤,201907,2190,2135,4325,37.57576,127.022835
종로구,363, 신설동역 11번출구 뒤,201908,1858,1851,3709,37.57576,127.022835
종로구,363, 신설동역 11번출구 뒤,201909,1765,1773,3538,37.57576,127.022835
종로구,363, 신설동역 11번출구 뒤,201910,2282,2275,4557,37.57576,127.022835
종로구,363, 신설동역 11번출구 뒤,201911,1648,1701,3349,37.57576,127.022835
종로구,363, 신설동역 11번출구 뒤,201912,919,1059,1978,37.57576,127.022835
종로구,363, 신설동역 11번출구 뒤,202001,821,916,1737,37.57576,127.022835
종로구,363, 신설동역 11번출구 뒤,202002,825,894,1719,37.57576,127.022835
종로구,363, 신설동역 11번출구 뒤,202003,1270,1287,2557,37.57576,127.022835
종로구,363, 신설동역 11번출구 뒤,202004,1596,1589,3185,37.57576,127.022835
종로구,363, 신설동역 11번출구 뒤,202005,1658,1631,3289,37.57576,127.022835
종로구,363, 신설동역 11번출구 뒤,202006,1799,1796,3595,37.57576,127.022835
종로구,364, 창신역 1번출구 앞,201901,454,362,816,37.579334,127.015083
종로구,364, 창신역 1번출구 앞,201902,445,301,746,37.579334,127.015083
종로구,364, 창신역 1번출구 앞,201903,686,479,1165,37.579334,127.015083
종로구,364, 창신역 1번출구 앞,201904,834,717,1551,37.579334,127.015083
종로구,364, 창신역 1번출구 앞,201905,1143,1058,2201,37.579334,127.015083
종로구,364, 창신역 1번출구 앞,201906,1099,1030,2129,37.579334,127.015083
종로구,364, 창신역 1번출구 앞,201907,1050,933,1983,37.579334,127.015083
종로구,364, 창신역 1번출구 앞,201908,899,827,1726,37.579334,127.015083
종로구,364, 창신역 1번출구 앞,201909,819,773,1592,37.579334,127.015083
종로구,364, 창신역 1번출구 앞,201910,842,816,1658,37.579334,127.015083
종로구,364, 창신역 1번출구 앞,201911,671,603,1274,37.579334,127.015083
종로구,364, 창신역 1번출구 앞,201912,566,400,966,37.579334,127.015083
종로구,364, 창신역 1번출구 앞,202001,481,345,826,37.579334,127.015083
종로구,364, 창신역 1번출구 앞,202002,488,346,834,37.579334,127.015083
종로구,364, 창신역 1번출구 앞,202003,565,525,1090,37.579334,127.015083
종로구,364, 창신역 1번출구 앞,202004,780,750,1530,37.579334,127.015083
종로구,364, 창신역 1번출구 앞,202005,871,833,1704,37.579334,127.015083
종로구,364, 창신역 1번출구 앞,202006,742,680,1422,37.579334,127.015083
종로구,367, 독립문역 3-1번출구,201901,185,176,361,37.573849,126.958694
종로구,367, 독립문역 3-1번출구,201902,277,266,543,37.573849,126.958694
종로구,367, 독립문역 3-1번출구,201903,498,457,955,37.573849,126.958694
종로구,367, 독립문역 3-1번출구,201904,684,711,1395,37.573849,126.958694
종로구,367, 독립문역 3-1번출구,201905,920,923,1843,37.573849,126.958694
종로구,367, 독립문역 3-1번출구,201906,963,1005,1968,37.573849,126.958694
종로구,367, 독립문역 3-1번출구,201907,1011,1032,2043,37.573849,126.958694
종로구,367, 독립문역 3-1번출구,201908,863,844,1707,37.573849,126.958694
종로구,367, 독립문역 3-1번출구,201909,747,770,1517,37.573849,126.958694
종로구,367, 독립문역 3-1번출구,201910,1028,1076,2104,37.573849,126.958694
종로구,367, 독립문역 3-1번출구,201911,810,858,1668,37.573849,126.958694
종로구,367, 독립문역 3-1번출구,201912,494,457,951,37.573849,126.958694
종로구,367, 독립문역 3-1번출구,202001,495,490,985,37.573849,126.958694
종로구,367, 독립문역 3-1번출구,202002,423,408,831,37.573849,126.958694
종로구,367, 독립문역 3-1번출구,202003,780,753,1533,37.573849,126.958694
종로구,367, 독립문역 3-1번출구,202004,1379,1123,2502,37.573849,126.958694
종로구,367, 독립문역 3-1번출구,202005,1516,1213,2729,37.573849,126.958694
종로구,367, 독립문역 3-1번출구,202006,1598,1326,2924,37.573849,126.958694
종로구,368, SK 서린빌딩 앞,201901,430,425,855,37.569248,126.980537
종로구,368, SK 서린빌딩 앞,201902,343,337,680,37.569248,126.980537
종로구,368, SK 서린빌딩 앞,201903,525,577,1102,37.569248,126.980537
종로구,368, SK 서린빌딩 앞,201904,974,1032,2006,37.569248,126.980537
종로구,368, SK 서린빌딩 앞,201905,1180,1268,2448,37.569248,126.980537
종로구,368, SK 서린빌딩 앞,201906,1140,1170,2310,37.569248,126.980537
종로구,368, SK 서린빌딩 앞,201907,1076,1098,2174,37.569248,126.980537
종로구,368, SK 서린빌딩 앞,201908,974,995,1969,37.569248,126.980537
종로구,368, SK 서린빌딩 앞,201909,1178,1243,2421,37.569248,126.980537
종로구,368, SK 서린빌딩 앞,201910,1371,1447,2818,37.569248,126.980537
종로구,368, SK 서린빌딩 앞,201911,958,1027,1985,37.569248,126.980537
종로구,368, SK 서린빌딩 앞,201912,535,586,1121,37.569248,126.980537
종로구,368, SK 서린빌딩 앞,202001,466,517,983,37.569248,126.980537
종로구,368, SK 서린빌딩 앞,202002,413,439,852,37.569248,126.980537
종로구,368, SK 서린빌딩 앞,202003,800,789,1589,37.569248,126.980537
종로구,368, SK 서린빌딩 앞,202004,970,976,1946,37.569248,126.980537
종로구,368, SK 서린빌딩 앞,202005,1093,1128,2221,37.569248,126.980537
종로구,368, SK 서린빌딩 앞,202006,1146,1312,2458,37.569248,126.980537
종로구,369, 광화문 시민열린마당,201901,660,566,1226,37.575493,126.9785
종로구,369, 광화문 시민열린마당,201902,484,384,868,37.575493,126.9785
종로구,369, 광화문 시민열린마당,201903,898,758,1656,37.575493,126.9785
종로구,369, 광화문 시민열린마당,201904,1326,1204,2530,37.575493,126.9785
종로구,369, 광화문 시민열린마당,201905,1684,1444,3128,37.575493,126.9785
종로구,369, 광화문 시민열린마당,201906,1704,1322,3026,37.575493,126.9785
종로구,369, 광화문 시민열린마당,201907,1506,1210,2716,37.575493,126.9785
종로구,369, 광화문 시민열린마당,201908,1474,1139,2613,37.575493,126.9785
종로구,369, 광화문 시민열린마당,201909,1616,1235,2851,37.575493,126.9785
종로구,369, 광화문 시민열린마당,201910,1958,1528,3486,37.575493,126.9785
종로구,369, 광화문 시민열린마당,201911,1437,1079,2516,37.575493,126.9785
종로구,369, 광화문 시민열린마당,201912,750,583,1333,37.575493,126.9785
종로구,369, 광화문 시민열린마당,202001,688,526,1214,37.575493,126.9785
종로구,369, 광화문 시민열린마당,202002,560,452,1012,37.575493,126.9785
종로구,369, 광화문 시민열린마당,202003,869,685,1554,37.575493,126.9785
종로구,369, 광화문 시민열린마당,202004,1367,1023,2390,37.575493,126.9785
종로구,369, 광화문 시민열린마당,202005,1560,1008,2568,37.575493,126.9785
종로구,369, 광화문 시민열린마당,202006,1757,1119,2876,37.575493,126.9785
중구,370, 시청역(2호선) 9번출구 뒤,201901,429,409,838,37.563229,126.974838
중구,370, 시청역(2호선) 9번출구 뒤,201902,364,355,719,37.563229,126.974838
중구,370, 시청역(2호선) 9번출구 뒤,201903,670,614,1284,37.563229,126.974838
중구,370, 시청역(2호선) 9번출구 뒤,201904,789,791,1580,37.563229,126.974838
중구,370, 시청역(2호선) 9번출구 뒤,201905,54,44,98,37.563229,126.974838
중구,370, 시청역(2호선) 9번출구 뒤,201906,1129,989,2118,37.563229,126.974838
중구,370, 시청역(2호선) 9번출구 뒤,201907,1405,1099,2504,37.563229,126.974838
중구,370, 시청역(2호선) 9번출구 뒤,201908,1344,1055,2399,37.563229,126.974838
중구,370, 시청역(2호선) 9번출구 뒤,201909,1372,1068,2440,37.563229,126.974838
중구,370, 시청역(2호선) 9번출구 뒤,201910,1783,1443,3226,37.563229,126.974838
중구,370, 시청역(2호선) 9번출구 뒤,201911,1185,1037,2222,37.563229,126.974838
중구,370, 시청역(2호선) 9번출구 뒤,201912,705,663,1368,37.563229,126.974838
중구,370, 시청역(2호선) 9번출구 뒤,202001,693,633,1326,37.563229,126.974838
중구,370, 시청역(2호선) 9번출구 뒤,202002,656,611,1267,37.563229,126.974838
중구,370, 시청역(2호선) 9번출구 뒤,202003,1091,1036,2127,37.563229,126.974838
중구,370, 시청역(2호선) 9번출구 뒤,202004,1477,1374,2851,37.563229,126.974838
중구,370, 시청역(2호선) 9번출구 뒤,202005,1496,1269,2765,37.563229,126.974838
중구,370, 시청역(2호선) 9번출구 뒤,202006,1669,1465,3134,37.563229,126.974838
중구,371, 동대입구역 6번출구 뒤,201901,216,201,417,37.558872,127.005539
중구,371, 동대입구역 6번출구 뒤,201902,180,200,380,37.558872,127.005539
중구,371, 동대입구역 6번출구 뒤,201903,418,469,887,37.558872,127.005539
중구,371, 동대입구역 6번출구 뒤,201904,680,684,1364,37.558872,127.005539
중구,371, 동대입구역 6번출구 뒤,201905,1008,978,1986,37.558872,127.005539
중구,371, 동대입구역 6번출구 뒤,201906,877,862,1739,37.558872,127.005539
중구,371, 동대입구역 6번출구 뒤,201907,796,768,1564,37.558872,127.005539
중구,371, 동대입구역 6번출구 뒤,201908,756,745,1501,37.558872,127.005539
중구,371, 동대입구역 6번출구 뒤,201909,865,855,1720,37.558872,127.005539
중구,371, 동대입구역 6번출구 뒤,201910,1163,1161,2324,37.558872,127.005539
중구,371, 동대입구역 6번출구 뒤,201911,659,656,1315,37.558872,127.005539
중구,371, 동대입구역 6번출구 뒤,201912,330,327,657,37.558872,127.005539
중구,371, 동대입구역 6번출구 뒤,202001,258,302,560,37.558872,127.005539
중구,371, 동대입구역 6번출구 뒤,202002,280,282,562,37.558872,127.005539
중구,371, 동대입구역 6번출구 뒤,202003,587,592,1179,37.558872,127.005539
중구,371, 동대입구역 6번출구 뒤,202004,846,831,1677,37.558872,127.005539
중구,371, 동대입구역 6번출구 뒤,202005,878,870,1748,37.558872,127.005539
중구,371, 동대입구역 6번출구 뒤,202006,750,739,1489,37.558872,127.005539
중구,372, 약수역 3번출구 뒤,201901,237,226,463,37.554295,127.0112
중구,372, 약수역 3번출구 뒤,201902,237,221,458,37.554295,127.0112
중구,372, 약수역 3번출구 뒤,201903,369,388,757,37.554295,127.0112
중구,372, 약수역 3번출구 뒤,201904,584,557,1141,37.554295,127.0112
중구,372, 약수역 3번출구 뒤,201905,1106,1071,2177,37.554295,127.0112
중구,372, 약수역 3번출구 뒤,201906,1128,1098,2226,37.554295,127.0112
중구,372, 약수역 3번출구 뒤,201907,1037,1025,2062,37.554295,127.0112
중구,372, 약수역 3번출구 뒤,201908,988,942,1930,37.554295,127.0112
중구,372, 약수역 3번출구 뒤,201909,980,962,1942,37.554295,127.0112
중구,372, 약수역 3번출구 뒤,201910,1104,1092,2196,37.554295,127.0112
중구,372, 약수역 3번출구 뒤,201911,705,693,1398,37.554295,127.0112
중구,372, 약수역 3번출구 뒤,201912,443,477,920,37.554295,127.0112
중구,372, 약수역 3번출구 뒤,202001,387,380,767,37.554295,127.0112
중구,372, 약수역 3번출구 뒤,202002,359,367,726,37.554295,127.0112
중구,372, 약수역 3번출구 뒤,202003,787,786,1573,37.554295,127.0112
중구,372, 약수역 3번출구 뒤,202004,1072,1065,2137,37.554295,127.0112
중구,372, 약수역 3번출구 뒤,202005,1179,1167,2346,37.554295,127.0112
중구,372, 약수역 3번출구 뒤,202006,1192,1200,2392,37.554295,127.0112
중구,373, 청구 어린이공원,201901,44,36,80,37.555859,127.013855
중구,373, 청구 어린이공원,201902,48,31,79,37.555859,127.013855
중구,373, 청구 어린이공원,201903,91,72,163,37.555859,127.013855
중구,373, 청구 어린이공원,201904,139,114,253,37.555859,127.013855
중구,373, 청구 어린이공원,201905,179,141,320,37.555859,127.013855
중구,373, 청구 어린이공원,201906,190,120,310,37.555859,127.013855
중구,373, 청구 어린이공원,201907,150,134,284,37.555859,127.013855
중구,373, 청구 어린이공원,201908,159,116,275,37.555859,127.013855
중구,373, 청구 어린이공원,201909,169,120,289,37.555859,127.013855
중구,373, 청구 어린이공원,201910,214,217,431,37.555859,127.013855
중구,373, 청구 어린이공원,201911,120,103,223,37.555859,127.013855
중구,373, 청구 어린이공원,201912,96,84,180,37.555859,127.013855
중구,373, 청구 어린이공원,202001,79,65,144,37.555859,127.013855
중구,373, 청구 어린이공원,202002,57,56,113,37.555859,127.013855
중구,373, 청구 어린이공원,202003,108,101,209,37.555859,127.013855
중구,373, 청구 어린이공원,202004,175,141,316,37.555859,127.013855
중구,373, 청구 어린이공원,202005,177,159,336,37.555859,127.013855
중구,373, 청구 어린이공원,202006,177,172,349,37.555859,127.013855
중구,374, 청구역 2번출구 앞,201901,321,316,637,37.560474,127.014076
중구,374, 청구역 2번출구 앞,201902,272,267,539,37.560474,127.014076
중구,374, 청구역 2번출구 앞,201903,529,539,1068,37.560474,127.014076
중구,374, 청구역 2번출구 앞,201904,757,798,1555,37.560474,127.014076
중구,374, 청구역 2번출구 앞,201905,1290,1304,2594,37.560474,127.014076
중구,374, 청구역 2번출구 앞,201906,1291,1297,2588,37.560474,127.014076
중구,374, 청구역 2번출구 앞,201907,1336,1336,2672,37.560474,127.014076
중구,374, 청구역 2번출구 앞,201908,977,973,1950,37.560474,127.014076
중구,374, 청구역 2번출구 앞,201909,1136,1127,2263,37.560474,127.014076
중구,374, 청구역 2번출구 앞,201910,1197,1203,2400,37.560474,127.014076
중구,374, 청구역 2번출구 앞,201911,842,863,1705,37.560474,127.014076
중구,374, 청구역 2번출구 앞,201912,571,567,1138,37.560474,127.014076
중구,374, 청구역 2번출구 앞,202001,459,458,917,37.560474,127.014076
중구,374, 청구역 2번출구 앞,202002,496,493,989,37.560474,127.014076
중구,374, 청구역 2번출구 앞,202003,884,888,1772,37.560474,127.014076
중구,374, 청구역 2번출구 앞,202004,1325,1318,2643,37.560474,127.014076
중구,374, 청구역 2번출구 앞,202005,1227,1233,2460,37.560474,127.014076
중구,374, 청구역 2번출구 앞,202006,1291,1302,2593,37.560474,127.014076
중구,375, 다산 어린이공원,201901,358,401,759,37.563717,127.018425
중구,375, 다산 어린이공원,201902,287,395,682,37.563717,127.018425
중구,375, 다산 어린이공원,201903,571,609,1180,37.563717,127.018425
중구,375, 다산 어린이공원,201904,874,916,1790,37.563717,127.018425
중구,375, 다산 어린이공원,201905,1284,1319,2603,37.563717,127.018425
중구,375, 다산 어린이공원,201906,1380,1414,2794,37.563717,127.018425
중구,375, 다산 어린이공원,201907,1401,1434,2835,37.563717,127.018425
중구,375, 다산 어린이공원,201908,1215,1226,2441,37.563717,127.018425
중구,375, 다산 어린이공원,201909,1144,1123,2267,37.563717,127.018425
중구,375, 다산 어린이공원,201910,1494,1531,3025,37.563717,127.018425
중구,375, 다산 어린이공원,201911,1003,1046,2049,37.563717,127.018425
중구,375, 다산 어린이공원,201912,640,684,1324,37.563717,127.018425
중구,375, 다산 어린이공원,202001,520,542,1062,37.563717,127.018425
중구,375, 다산 어린이공원,202002,500,529,1029,37.563717,127.018425
중구,375, 다산 어린이공원,202003,934,921,1855,37.563717,127.018425
중구,375, 다산 어린이공원,202004,1305,1267,2572,37.563717,127.018425
중구,375, 다산 어린이공원,202005,1280,1280,2560,37.563717,127.018425
중구,375, 다산 어린이공원,202006,1513,1529,3042,37.563717,127.018425
중구,377, 서울역 5번출구 앞,201901,230,223,453,#N/A,#N/A
중구,377, 서울역 5번출구 앞,201902,188,225,413,#N/A,#N/A
중구,377, 서울역 5번출구 앞,201903,184,186,370,#N/A,#N/A
중구,378, 청계7가 사거리,201901,672,652,1324,37.569805,127.016953
중구,378, 청계7가 사거리,201902,510,465,975,37.569805,127.016953
중구,378, 청계7가 사거리,201903,941,933,1874,37.569805,127.016953
중구,378, 청계7가 사거리,201904,1219,1199,2418,37.569805,127.016953
중구,378, 청계7가 사거리,201905,1592,1591,3183,37.569805,127.016953
중구,378, 청계7가 사거리,201906,1567,1553,3120,37.569805,127.016953
중구,378, 청계7가 사거리,201907,1900,1844,3744,37.569805,127.016953
중구,378, 청계7가 사거리,201908,1488,1480,2968,37.569805,127.016953
중구,378, 청계7가 사거리,201909,1587,1544,3131,37.569805,127.016953
중구,378, 청계7가 사거리,201910,2017,2050,4067,37.569805,127.016953
중구,378, 청계7가 사거리,201911,1583,1571,3154,37.569805,127.016953
중구,378, 청계7가 사거리,201912,973,972,1945,37.569805,127.016953
중구,378, 청계7가 사거리,202001,658,695,1353,37.569805,127.016953
중구,378, 청계7가 사거리,202002,683,684,1367,37.569805,127.016953
중구,378, 청계7가 사거리,202003,1193,1159,2352,37.569805,127.016953
중구,378, 청계7가 사거리,202004,1392,1358,2750,37.569805,127.016953
중구,378, 청계7가 사거리,202005,1297,1276,2573,37.569805,127.016953
중구,378, 청계7가 사거리,202006,1600,1582,3182,37.569805,127.016953
중구,379, 서울역9번출구,201901,216,188,404,37.556,126.973358
중구,379, 서울역9번출구,201902,204,193,397,37.556,126.973358
중구,379, 서울역9번출구,201903,466,480,946,37.556,126.973358
중구,379, 서울역9번출구,201904,895,902,1797,37.556,126.973358
중구,379, 서울역9번출구,201905,1239,1238,2477,37.556,126.973358
중구,379, 서울역9번출구,201906,1180,1186,2366,37.556,126.973358
중구,379, 서울역9번출구,201907,1171,1178,2349,37.556,126.973358
중구,379, 서울역9번출구,201908,1012,1013,2025,37.556,126.973358
중구,379, 서울역9번출구,201909,1380,1377,2757,37.556,126.973358
중구,379, 서울역9번출구,201910,1749,1768,3517,37.556,126.973358
중구,379, 서울역9번출구,201911,1112,1149,2261,37.556,126.973358
중구,379, 서울역9번출구,201912,631,664,1295,37.556,126.973358
중구,379, 서울역9번출구,202001,569,617,1186,37.556,126.973358
중구,379, 서울역9번출구,202002,534,548,1082,37.556,126.973358
중구,379, 서울역9번출구,202003,994,1006,2000,37.556,126.973358
중구,379, 서울역9번출구,202004,1304,1306,2610,37.556,126.973358
중구,379, 서울역9번출구,202005,1149,1145,2294,37.556,126.973358
중구,379, 서울역9번출구,202006,1212,1207,2419,37.556,126.973358
중구,380, CJ제일제당 앞,201901,357,326,683,37.563866,127.002747
중구,380, CJ제일제당 앞,201902,288,230,518,37.563866,127.002747
중구,380, CJ제일제당 앞,201903,513,459,972,37.563866,127.002747
중구,380, CJ제일제당 앞,201904,792,727,1519,37.563866,127.002747
중구,380, CJ제일제당 앞,201905,1101,1058,2159,37.563866,127.002747
중구,380, CJ제일제당 앞,201906,1127,1060,2187,37.563866,127.002747
중구,380, CJ제일제당 앞,201907,1105,1007,2112,37.563866,127.002747
중구,380, CJ제일제당 앞,201908,962,874,1836,37.563866,127.002747
중구,380, CJ제일제당 앞,201909,935,917,1852,37.563866,127.002747
중구,380, CJ제일제당 앞,201910,1256,1175,2431,37.563866,127.002747
중구,380, CJ제일제당 앞,201911,837,837,1674,37.563866,127.002747
중구,380, CJ제일제당 앞,201912,571,544,1115,37.563866,127.002747
중구,380, CJ제일제당 앞,202001,463,440,903,37.563866,127.002747
중구,380, CJ제일제당 앞,202002,441,408,849,37.563866,127.002747
중구,380, CJ제일제당 앞,202003,630,571,1201,37.563866,127.002747
중구,380, CJ제일제당 앞,202004,932,885,1817,37.563866,127.002747
중구,380, CJ제일제당 앞,202005,868,846,1714,37.563866,127.002747
중구,380, CJ제일제당 앞,202006,1208,1165,2373,37.563866,127.002747
중구,381, 장충체육관,201901,88,42,130,37.558533,127.006989
중구,381, 장충체육관,201902,57,32,89,37.558533,127.006989
중구,381, 장충체육관,201903,115,81,196,37.558533,127.006989
중구,381, 장충체육관,201904,204,143,347,37.558533,127.006989
중구,381, 장충체육관,201905,244,151,395,37.558533,127.006989
중구,381, 장충체육관,201906,202,158,360,37.558533,127.006989
중구,381, 장충체육관,201907,213,113,326,37.558533,127.006989
중구,381, 장충체육관,201908,184,87,271,37.558533,127.006989
중구,381, 장충체육관,201909,206,101,307,37.558533,127.006989
중구,381, 장충체육관,201910,259,172,431,37.558533,127.006989
중구,381, 장충체육관,201911,180,107,287,37.558533,127.006989
중구,381, 장충체육관,201912,145,81,226,37.558533,127.006989
중구,381, 장충체육관,202001,115,87,202,37.558533,127.006989
중구,381, 장충체육관,202002,99,73,172,37.558533,127.006989
중구,381, 장충체육관,202003,152,110,262,37.558533,127.006989
중구,381, 장충체육관,202004,294,144,438,37.558533,127.006989
중구,381, 장충체육관,202005,171,133,304,37.558533,127.006989
중구,381, 장충체육관,202006,150,99,249,37.558533,127.006989
중구,382, 약수역 10번출구 앞,201901,222,262,484,37.555199,127.010048
중구,382, 약수역 10번출구 앞,201902,196,216,412,37.555199,127.010048
중구,382, 약수역 10번출구 앞,201903,368,385,753,37.555199,127.010048
중구,382, 약수역 10번출구 앞,201904,522,516,1038,37.555199,127.010048
중구,382, 약수역 10번출구 앞,201905,746,757,1503,37.555199,127.010048
중구,382, 약수역 10번출구 앞,201906,780,795,1575,37.555199,127.010048
중구,382, 약수역 10번출구 앞,201907,743,758,1501,37.555199,127.010048
중구,382, 약수역 10번출구 앞,201908,686,668,1354,37.555199,127.010048
중구,382, 약수역 10번출구 앞,201909,724,710,1434,37.555199,127.010048
중구,382, 약수역 10번출구 앞,201910,835,846,1681,37.555199,127.010048
중구,382, 약수역 10번출구 앞,201911,528,537,1065,37.555199,127.010048
중구,382, 약수역 10번출구 앞,201912,319,356,675,37.555199,127.010048
중구,382, 약수역 10번출구 앞,202001,253,336,589,37.555199,127.010048
중구,382, 약수역 10번출구 앞,202002,271,316,587,37.555199,127.010048
중구,382, 약수역 10번출구 앞,202003,487,487,974,37.555199,127.010048
중구,382, 약수역 10번출구 앞,202004,830,810,1640,37.555199,127.010048
중구,382, 약수역 10번출구 앞,202005,756,747,1503,37.555199,127.010048
중구,382, 약수역 10번출구 앞,202006,728,732,1460,37.555199,127.010048
중구,383, 신당역 12번 출구 뒤,201901,810,781,1591,37.565849,127.016403
중구,383, 신당역 12번 출구 뒤,201902,770,738,1508,37.565849,127.016403
중구,383, 신당역 12번 출구 뒤,201903,1369,1243,2612,37.565849,127.016403
중구,383, 신당역 12번 출구 뒤,201904,1772,1633,3405,37.565849,127.016403
중구,383, 신당역 12번 출구 뒤,201905,2741,2483,5224,37.565849,127.016403
중구,383, 신당역 12번 출구 뒤,201906,3043,2783,5826,37.565849,127.016403
중구,383, 신당역 12번 출구 뒤,201907,2930,2659,5589,37.565849,127.016403
중구,383, 신당역 12번 출구 뒤,201908,2668,2309,4977,37.565849,127.016403
중구,383, 신당역 12번 출구 뒤,201909,2614,2439,5053,37.565849,127.016403
중구,383, 신당역 12번 출구 뒤,201910,3126,2853,5979,37.565849,127.016403
중구,383, 신당역 12번 출구 뒤,201911,2278,2069,4347,37.565849,127.016403
중구,383, 신당역 12번 출구 뒤,201912,1484,1253,2737,37.565849,127.016403
중구,383, 신당역 12번 출구 뒤,202001,1246,1103,2349,37.565849,127.016403
중구,383, 신당역 12번 출구 뒤,202002,1127,1011,2138,37.565849,127.016403
중구,383, 신당역 12번 출구 뒤,202003,1458,1303,2761,37.565849,127.016403
중구,383, 신당역 12번 출구 뒤,202004,2315,2114,4429,37.565849,127.016403
중구,383, 신당역 12번 출구 뒤,202005,2366,2196,4562,37.565849,127.016403
중구,383, 신당역 12번 출구 뒤,202006,2518,2353,4871,37.565849,127.016403
중구,384, 종로학원본원,201901,222,215,437,37.55978,126.968506
중구,384, 종로학원본원,201902,179,193,372,37.55978,126.968506
중구,384, 종로학원본원,201903,295,278,573,37.55978,126.968506
중구,384, 종로학원본원,201904,458,434,892,37.55978,126.968506
중구,384, 종로학원본원,201905,572,555,1127,37.55978,126.968506
중구,384, 종로학원본원,201906,620,609,1229,37.55978,126.968506
중구,384, 종로학원본원,201907,610,568,1178,37.55978,126.968506
중구,384, 종로학원본원,201908,527,501,1028,37.55978,126.968506
중구,384, 종로학원본원,201909,289,307,596,37.55978,126.968506
중구,384, 종로학원본원,201910,523,519,1042,37.55978,126.968506
중구,384, 종로학원본원,201911,381,397,778,37.55978,126.968506
중구,384, 종로학원본원,201912,251,246,497,37.55978,126.968506
중구,384, 종로학원본원,202001,230,219,449,37.55978,126.968506
중구,384, 종로학원본원,202002,229,203,432,37.55978,126.968506
중구,384, 종로학원본원,202003,418,405,823,37.55978,126.968506
중구,384, 종로학원본원,202004,586,578,1164,37.55978,126.968506
중구,384, 종로학원본원,202005,588,589,1177,37.55978,126.968506
중구,384, 종로학원본원,202006,758,750,1508,37.55978,126.968506
종로구,385, 종각역 5번출구,201901,698,689,1387,37.569836,126.982658
종로구,385, 종각역 5번출구,201902,562,587,1149,37.569836,126.982658
종로구,385, 종각역 5번출구,201903,979,980,1959,37.569836,126.982658
종로구,385, 종각역 5번출구,201904,1483,1477,2960,37.569836,126.982658
종로구,385, 종각역 5번출구,201905,1891,1858,3749,37.569836,126.982658
종로구,385, 종각역 5번출구,201906,1739,1704,3443,37.569836,126.982658
종로구,385, 종각역 5번출구,201907,1631,1568,3199,37.569836,126.982658
종로구,385, 종각역 5번출구,201908,1433,1420,2853,37.569836,126.982658
종로구,385, 종각역 5번출구,201909,1486,1476,2962,37.569836,126.982658
종로구,385, 종각역 5번출구,201910,1880,1870,3750,37.569836,126.982658
종로구,385, 종각역 5번출구,201911,1488,1499,2987,37.569836,126.982658
종로구,385, 종각역 5번출구,201912,950,1001,1951,37.569836,126.982658
종로구,385, 종각역 5번출구,202001,731,759,1490,37.569836,126.982658
종로구,385, 종각역 5번출구,202002,721,727,1448,37.569836,126.982658
종로구,385, 종각역 5번출구,202003,1125,1117,2242,37.569836,126.982658
종로구,385, 종각역 5번출구,202004,1390,1363,2753,37.569836,126.982658
종로구,385, 종각역 5번출구,202005,1535,1529,3064,37.569836,126.982658
종로구,385, 종각역 5번출구,202006,1700,1674,3374,37.569836,126.982658
종로구,386, 올림픽기념 국민생활관 앞,201901,371,307,678,#N/A,#N/A
종로구,386, 올림픽기념 국민생활관 앞,201902,308,273,581,#N/A,#N/A
종로구,386, 올림픽기념 국민생활관 앞,201903,537,523,1060,#N/A,#N/A
종로구,386, 올림픽기념 국민생활관 앞,201904,772,701,1473,#N/A,#N/A
종로구,386, 올림픽기념 국민생활관 앞,201905,945,912,1857,#N/A,#N/A
종로구,386, 올림픽기념 국민생활관 앞,201906,1002,962,1964,#N/A,#N/A
종로구,386, 올림픽기념 국민생활관 앞,201907,1011,1013,2024,#N/A,#N/A
종로구,386, 올림픽기념 국민생활관 앞,201908,1014,986,2000,#N/A,#N/A
종로구,386, 올림픽기념 국민생활관 앞,201909,859,844,1703,#N/A,#N/A
종로구,386, 올림픽기념 국민생활관 앞,201910,1001,981,1982,#N/A,#N/A
종로구,386, 올림픽기념 국민생활관 앞,201911,777,750,1527,#N/A,#N/A
종로구,386, 올림픽기념 국민생활관 앞,201912,591,533,1124,#N/A,#N/A
종로구,386, 올림픽기념 국민생활관 앞,202001,473,451,924,#N/A,#N/A
종로구,386, 올림픽기념 국민생활관 앞,202002,228,205,433,#N/A,#N/A
종로구,386, 올림픽기념 국민생활관 앞,202003,435,425,860,#N/A,#N/A
종로구,386, 올림픽기념 국민생활관 앞,202004,522,507,1029,#N/A,#N/A
종로구,386, 올림픽기념 국민생활관 앞,202005,587,577,1164,#N/A,#N/A
종로구,386, 올림픽기념 국민생활관 앞,202006,714,655,1369,#N/A,#N/A
중구,387, 훈련원공원주차장 앞,201901,262,245,507,37.566994,127.003464
중구,387, 훈련원공원주차장 앞,201902,255,232,487,37.566994,127.003464
중구,387, 훈련원공원주차장 앞,201903,452,448,900,37.566994,127.003464
중구,387, 훈련원공원주차장 앞,201904,590,567,1157,37.566994,127.003464
중구,387, 훈련원공원주차장 앞,201905,1078,957,2035,37.566994,127.003464
중구,387, 훈련원공원주차장 앞,201906,1055,900,1955,37.566994,127.003464
중구,387, 훈련원공원주차장 앞,201907,1197,1007,2204,37.566994,127.003464
중구,387, 훈련원공원주차장 앞,201908,1114,944,2058,37.566994,127.003464
중구,387, 훈련원공원주차장 앞,201909,977,836,1813,37.566994,127.003464
중구,387, 훈련원공원주차장 앞,201910,1178,1043,2221,37.566994,127.003464
중구,387, 훈련원공원주차장 앞,201911,776,740,1516,37.566994,127.003464
중구,387, 훈련원공원주차장 앞,201912,549,543,1092,37.566994,127.003464
중구,387, 훈련원공원주차장 앞,202001,383,341,724,37.566994,127.003464
중구,387, 훈련원공원주차장 앞,202002,410,354,764,37.566994,127.003464
중구,387, 훈련원공원주차장 앞,202003,677,529,1206,37.566994,127.003464
중구,387, 훈련원공원주차장 앞,202004,1012,779,1791,37.566994,127.003464
중구,387, 훈련원공원주차장 앞,202005,1086,837,1923,37.566994,127.003464
중구,387, 훈련원공원주차장 앞,202006,1220,920,2140,37.566994,127.003464
종로구,388, 동성중학교 앞,201901,246,300,546,37.585735,127.00161
종로구,388, 동성중학교 앞,201902,235,244,479,37.585735,127.00161
종로구,388, 동성중학교 앞,201903,484,496,980,37.585735,127.00161
종로구,388, 동성중학교 앞,201904,834,791,1625,37.585735,127.00161
종로구,388, 동성중학교 앞,201905,1115,1079,2194,37.585735,127.00161
종로구,388, 동성중학교 앞,201906,1197,1174,2371,37.585735,127.00161
종로구,388, 동성중학교 앞,201907,1032,1008,2040,37.585735,127.00161
종로구,388, 동성중학교 앞,201908,964,923,1887,37.585735,127.00161
종로구,388, 동성중학교 앞,201909,943,932,1875,37.585735,127.00161
종로구,388, 동성중학교 앞,201910,1107,1098,2205,37.585735,127.00161
종로구,388, 동성중학교 앞,201911,719,714,1433,37.585735,127.00161
종로구,388, 동성중학교 앞,201912,506,519,1025,37.585735,127.00161
종로구,388, 동성중학교 앞,202001,451,418,869,37.585735,127.00161
종로구,388, 동성중학교 앞,202002,418,429,847,37.585735,127.00161
종로구,388, 동성중학교 앞,202003,700,692,1392,37.585735,127.00161
종로구,388, 동성중학교 앞,202004,951,920,1871,37.585735,127.00161
종로구,388, 동성중학교 앞,202005,903,895,1798,37.585735,127.00161
종로구,388, 동성중학교 앞,202006,1015,975,1990,37.585735,127.00161
중구,389, 을지로4가역 1번출구,201901,361,383,744,37.56673,126.996605
중구,389, 을지로4가역 1번출구,201902,314,349,663,37.56673,126.996605
중구,389, 을지로4가역 1번출구,201903,585,675,1260,37.56673,126.996605
중구,389, 을지로4가역 1번출구,201904,820,863,1683,37.56673,126.996605
중구,389, 을지로4가역 1번출구,201905,1232,1198,2430,37.56673,126.996605
중구,389, 을지로4가역 1번출구,201906,1351,1291,2642,37.56673,126.996605
중구,389, 을지로4가역 1번출구,201907,1448,1377,2825,37.56673,126.996605
중구,389, 을지로4가역 1번출구,201908,1289,1224,2513,37.56673,126.996605
중구,389, 을지로4가역 1번출구,201909,1332,1300,2632,37.56673,126.996605
중구,389, 을지로4가역 1번출구,201910,1694,1683,3377,37.56673,126.996605
중구,389, 을지로4가역 1번출구,201911,1238,1234,2472,37.56673,126.996605
중구,389, 을지로4가역 1번출구,201912,700,715,1415,37.56673,126.996605
중구,389, 을지로4가역 1번출구,202001,631,631,1262,37.56673,126.996605
중구,389, 을지로4가역 1번출구,202002,651,654,1305,37.56673,126.996605
중구,389, 을지로4가역 1번출구,202003,864,889,1753,37.56673,126.996605
중구,389, 을지로4가역 1번출구,202004,1158,1129,2287,37.56673,126.996605
중구,389, 을지로4가역 1번출구,202005,1012,1020,2032,37.56673,126.996605
중구,389, 을지로4가역 1번출구,202006,981,962,1943,37.56673,126.996605
중구,390, 충무로역 1번출구,201901,494,500,994,37.56139,126.995354
중구,390, 충무로역 1번출구,201902,412,422,834,37.56139,126.995354
중구,390, 충무로역 1번출구,201903,820,795,1615,37.56139,126.995354
중구,390, 충무로역 1번출구,201904,1222,1120,2342,37.56139,126.995354
중구,390, 충무로역 1번출구,201905,1658,1585,3243,37.56139,126.995354
중구,390, 충무로역 1번출구,201906,1560,1503,3063,37.56139,126.995354
중구,390, 충무로역 1번출구,201907,1569,1489,3058,37.56139,126.995354
중구,390, 충무로역 1번출구,201908,1380,1316,2696,37.56139,126.995354
중구,390, 충무로역 1번출구,201909,1276,1262,2538,37.56139,126.995354
중구,390, 충무로역 1번출구,201910,1631,1606,3237,37.56139,126.995354
중구,390, 충무로역 1번출구,201911,1185,1153,2338,37.56139,126.995354
중구,390, 충무로역 1번출구,201912,732,673,1405,37.56139,126.995354
중구,390, 충무로역 1번출구,202001,658,619,1277,37.56139,126.995354
중구,390, 충무로역 1번출구,202002,623,597,1220,37.56139,126.995354
중구,390, 충무로역 1번출구,202003,1000,971,1971,37.56139,126.995354
중구,390, 충무로역 1번출구,202004,1332,1302,2634,37.56139,126.995354
중구,390, 충무로역 1번출구,202005,1375,1374,2749,37.56139,126.995354
중구,390, 충무로역 1번출구,202006,1641,1617,3258,37.56139,126.995354
중구,391, 정동길입구,201901,243,231,474,37.565437,126.973305
중구,391, 정동길입구,201902,219,209,428,37.565437,126.973305
중구,391, 정동길입구,201903,425,409,834,37.565437,126.973305
중구,391, 정동길입구,201904,655,601,1256,37.565437,126.973305
중구,391, 정동길입구,201905,700,682,1382,37.565437,126.973305
중구,391, 정동길입구,201906,727,686,1413,37.565437,126.973305
중구,391, 정동길입구,201907,716,667,1383,37.565437,126.973305
중구,391, 정동길입구,201908,735,598,1333,37.565437,126.973305
중구,391, 정동길입구,201909,829,621,1450,37.565437,126.973305
중구,391, 정동길입구,201910,1009,809,1818,37.565437,126.973305
중구,391, 정동길입구,201911,502,460,962,37.565437,126.973305
중구,391, 정동길입구,201912,263,252,515,37.565437,126.973305
중구,391, 정동길입구,202001,222,211,433,37.565437,126.973305
중구,391, 정동길입구,202002,142,137,279,37.565437,126.973305
중구,391, 정동길입구,202003,270,240,510,37.565437,126.973305
중구,391, 정동길입구,202004,550,366,916,37.565437,126.973305
중구,391, 정동길입구,202005,562,470,1032,37.565437,126.973305
중구,391, 정동길입구,202006,501,469,970,37.565437,126.973305
종로구,393, 동대문역 8번 출구,201901,531,536,1067,37.570141,127.009377
종로구,393, 동대문역 8번 출구,201902,484,518,1002,37.570141,127.009377
종로구,393, 동대문역 8번 출구,201903,871,944,1815,37.570141,127.009377
종로구,393, 동대문역 8번 출구,201904,1389,1432,2821,37.570141,127.009377
종로구,393, 동대문역 8번 출구,201905,2035,2046,4081,37.570141,127.009377
종로구,393, 동대문역 8번 출구,201906,2145,2106,4251,37.570141,127.009377
종로구,393, 동대문역 8번 출구,201907,2145,2082,4227,37.570141,127.009377
종로구,393, 동대문역 8번 출구,201908,1807,1780,3587,37.570141,127.009377
종로구,393, 동대문역 8번 출구,201909,2063,2064,4127,37.570141,127.009377
종로구,393, 동대문역 8번 출구,201910,2564,2577,5141,37.570141,127.009377
종로구,393, 동대문역 8번 출구,201911,1785,1803,3588,37.570141,127.009377
종로구,393, 동대문역 8번 출구,201912,1092,1092,2184,37.570141,127.009377
종로구,393, 동대문역 8번 출구,202001,799,819,1618,37.570141,127.009377
종로구,393, 동대문역 8번 출구,202002,831,828,1659,37.570141,127.009377
종로구,393, 동대문역 8번 출구,202003,1550,1525,3075,37.570141,127.009377
종로구,393, 동대문역 8번 출구,202004,2204,2183,4387,37.570141,127.009377
종로구,393, 동대문역 8번 출구,202005,2408,2407,4815,37.570141,127.009377
종로구,393, 동대문역 8번 출구,202006,2475,2423,4898,37.570141,127.009377
종로구,394, 경희궁 자이 3단지,201901,223,200,423,37.56749,126.965919
종로구,394, 경희궁 자이 3단지,201902,217,222,439,37.56749,126.965919
종로구,394, 경희궁 자이 3단지,201903,415,397,812,37.56749,126.965919
종로구,394, 경희궁 자이 3단지,201904,593,520,1113,37.56749,126.965919
종로구,394, 경희궁 자이 3단지,201905,646,553,1199,37.56749,126.965919
종로구,394, 경희궁 자이 3단지,201906,588,567,1155,37.56749,126.965919
종로구,394, 경희궁 자이 3단지,201907,664,604,1268,37.56749,126.965919
종로구,394, 경희궁 자이 3단지,201908,661,561,1222,37.56749,126.965919
종로구,394, 경희궁 자이 3단지,201909,631,546,1177,37.56749,126.965919
종로구,394, 경희궁 자이 3단지,201910,719,666,1385,37.56749,126.965919
종로구,394, 경희궁 자이 3단지,201911,557,531,1088,37.56749,126.965919
종로구,394, 경희궁 자이 3단지,201912,400,371,771,37.56749,126.965919
종로구,394, 경희궁 자이 3단지,202001,331,321,652,37.56749,126.965919
종로구,394, 경희궁 자이 3단지,202002,356,320,676,37.56749,126.965919
종로구,394, 경희궁 자이 3단지,202003,501,472,973,37.56749,126.965919
종로구,394, 경희궁 자이 3단지,202004,497,469,966,37.56749,126.965919
종로구,394, 경희궁 자이 3단지,202005,59,63,122,37.56749,126.965919
종로구,394, 경희궁 자이 3단지,202006,90,101,191,37.56749,126.965919
종로구,395, 경희궁 자이 2단지,201901,258,261,519,37.568855,126.964561
종로구,395, 경희궁 자이 2단지,201902,266,269,535,37.568855,126.964561
종로구,395, 경희궁 자이 2단지,201903,559,578,1137,37.568855,126.964561
종로구,395, 경희궁 자이 2단지,201904,742,797,1539,37.568855,126.964561
종로구,395, 경희궁 자이 2단지,201905,971,952,1923,37.568855,126.964561
종로구,395, 경희궁 자이 2단지,201906,962,980,1942,37.568855,126.964561
종로구,395, 경희궁 자이 2단지,201907,1028,1038,2066,37.568855,126.964561
종로구,395, 경희궁 자이 2단지,201908,955,989,1944,37.568855,126.964561
종로구,395, 경희궁 자이 2단지,201909,996,1014,2010,37.568855,126.964561
종로구,395, 경희궁 자이 2단지,201910,1117,1146,2263,37.568855,126.964561
종로구,395, 경희궁 자이 2단지,201911,724,751,1475,37.568855,126.964561
종로구,395, 경희궁 자이 2단지,201912,456,469,925,37.568855,126.964561
종로구,395, 경희궁 자이 2단지,202001,432,419,851,37.568855,126.964561
종로구,395, 경희궁 자이 2단지,202002,403,388,791,37.568855,126.964561
종로구,395, 경희궁 자이 2단지,202003,698,682,1380,37.568855,126.964561
종로구,395, 경희궁 자이 2단지,202004,1084,1112,2196,37.568855,126.964561
종로구,395, 경희궁 자이 2단지,202005,1201,1206,2407,37.568855,126.964561
종로구,395, 경희궁 자이 2단지,202006,1413,1385,2798,37.568855,126.964561
종로구,397, 종묘공영주차장 건너편,201901,337,351,688,37.57048,126.996635
종로구,397, 종묘공영주차장 건너편,201902,278,306,584,37.57048,126.996635
종로구,397, 종묘공영주차장 건너편,201903,479,473,952,37.57048,126.996635
종로구,397, 종묘공영주차장 건너편,201904,734,709,1443,37.57048,126.996635
종로구,397, 종묘공영주차장 건너편,201905,933,874,1807,37.57048,126.996635
종로구,397, 종묘공영주차장 건너편,201906,869,840,1709,37.57048,126.996635
종로구,397, 종묘공영주차장 건너편,201907,821,761,1582,37.57048,126.996635
종로구,397, 종묘공영주차장 건너편,201908,854,776,1630,37.57048,126.996635
종로구,397, 종묘공영주차장 건너편,201909,835,795,1630,37.57048,126.996635
종로구,397, 종묘공영주차장 건너편,201910,1030,994,2024,37.57048,126.996635
종로구,397, 종묘공영주차장 건너편,201911,750,698,1448,37.57048,126.996635
종로구,397, 종묘공영주차장 건너편,201912,458,437,895,37.57048,126.996635
종로구,397, 종묘공영주차장 건너편,202001,423,405,828,37.57048,126.996635
종로구,397, 종묘공영주차장 건너편,202002,424,412,836,37.57048,126.996635
종로구,397, 종묘공영주차장 건너편,202003,623,587,1210,37.57048,126.996635
종로구,397, 종묘공영주차장 건너편,202004,690,668,1358,37.57048,126.996635
종로구,397, 종묘공영주차장 건너편,202005,684,657,1341,37.57048,126.996635
종로구,397, 종묘공영주차장 건너편,202006,588,544,1132,37.57048,126.996635
중구,398, 을지로3가역 3번출구,201901,393,377,770,37.566559,126.992439
중구,398, 을지로3가역 3번출구,201902,387,383,770,37.566559,126.992439
중구,398, 을지로3가역 3번출구,201903,648,645,1293,37.566559,126.992439
중구,398, 을지로3가역 3번출구,201904,841,856,1697,37.566559,126.992439
중구,398, 을지로3가역 3번출구,201905,1480,1457,2937,37.566559,126.992439
중구,398, 을지로3가역 3번출구,201906,1461,1414,2875,37.566559,126.992439
중구,398, 을지로3가역 3번출구,201907,1469,1438,2907,37.566559,126.992439
중구,398, 을지로3가역 3번출구,201908,1419,1357,2776,37.566559,126.992439
중구,398, 을지로3가역 3번출구,201909,1259,1231,2490,37.566559,126.992439
중구,398, 을지로3가역 3번출구,201910,1658,1652,3310,37.566559,126.992439
중구,398, 을지로3가역 3번출구,201911,1129,1118,2247,37.566559,126.992439
중구,398, 을지로3가역 3번출구,201912,599,565,1164,37.566559,126.992439
중구,398, 을지로3가역 3번출구,202001,564,537,1101,37.566559,126.992439
중구,398, 을지로3가역 3번출구,202002,441,443,884,37.566559,126.992439
중구,398, 을지로3가역 3번출구,202003,826,802,1628,37.566559,126.992439
중구,398, 을지로3가역 3번출구,202004,340,339,679,37.566559,126.992439
중구,398, 을지로3가역 3번출구,202005,1197,1192,2389,37.566559,126.992439
중구,398, 을지로3가역 3번출구,202006,1387,1371,2758,37.566559,126.992439
중구,399, 서울역 센트럴 자이아파트,201901,170,89,259,37.554108,126.965408
중구,399, 서울역 센트럴 자이아파트,201902,124,73,197,37.554108,126.965408
중구,399, 서울역 센트럴 자이아파트,201903,251,195,446,37.554108,126.965408
중구,399, 서울역 센트럴 자이아파트,201904,405,290,695,37.554108,126.965408
중구,399, 서울역 센트럴 자이아파트,201905,445,393,838,37.554108,126.965408
중구,399, 서울역 센트럴 자이아파트,201906,421,353,774,37.554108,126.965408
중구,399, 서울역 센트럴 자이아파트,201907,400,360,760,37.554108,126.965408
중구,399, 서울역 센트럴 자이아파트,201908,351,314,665,37.554108,126.965408
중구,399, 서울역 센트럴 자이아파트,201909,423,319,742,37.554108,126.965408
중구,399, 서울역 센트럴 자이아파트,201910,544,357,901,37.554108,126.965408
중구,399, 서울역 센트럴 자이아파트,201911,433,250,683,37.554108,126.965408
중구,399, 서울역 센트럴 자이아파트,201912,274,169,443,37.554108,126.965408
중구,399, 서울역 센트럴 자이아파트,202001,255,156,411,37.554108,126.965408
중구,399, 서울역 센트럴 자이아파트,202002,286,176,462,37.554108,126.965408
중구,399, 서울역 센트럴 자이아파트,202003,439,364,803,37.554108,126.965408
중구,399, 서울역 센트럴 자이아파트,202004,596,431,1027,37.554108,126.965408
중구,399, 서울역 센트럴 자이아파트,202005,543,443,986,37.554108,126.965408
중구,399, 서울역 센트럴 자이아파트,202006,916,472,1388,37.554108,126.965408
마포구,400, 상암한화오벨리스크 1차 앞,201901,331,366,697,37.587524,126.883003
마포구,400, 상암한화오벨리스크 1차 앞,201902,241,248,489,37.587524,126.883003
마포구,400, 상암한화오벨리스크 1차 앞,201903,568,567,1135,37.587524,126.883003
마포구,400, 상암한화오벨리스크 1차 앞,201904,799,756,1555,37.587524,126.883003
마포구,400, 상암한화오벨리스크 1차 앞,201905,1098,1096,2194,37.587524,126.883003
마포구,400, 상암한화오벨리스크 1차 앞,201906,1105,1144,2249,37.587524,126.883003
마포구,400, 상암한화오벨리스크 1차 앞,201907,1222,1295,2517,37.587524,126.883003
마포구,400, 상암한화오벨리스크 1차 앞,201908,1228,1239,2467,37.587524,126.883003
마포구,400, 상암한화오벨리스크 1차 앞,201909,1121,1063,2184,37.587524,126.883003
마포구,400, 상암한화오벨리스크 1차 앞,201910,1284,1206,2490,37.587524,126.883003
마포구,400, 상암한화오벨리스크 1차 앞,201911,841,763,1604,37.587524,126.883003
마포구,400, 상암한화오벨리스크 1차 앞,201912,469,412,881,37.587524,126.883003
마포구,400, 상암한화오벨리스크 1차 앞,202001,390,340,730,37.587524,126.883003
마포구,400, 상암한화오벨리스크 1차 앞,202002,373,351,724,37.587524,126.883003
마포구,400, 상암한화오벨리스크 1차 앞,202003,669,576,1245,37.587524,126.883003
마포구,400, 상암한화오벨리스크 1차 앞,202004,876,759,1635,37.587524,126.883003
마포구,400, 상암한화오벨리스크 1차 앞,202005,1007,878,1885,37.587524,126.883003
마포구,400, 상암한화오벨리스크 1차 앞,202006,1335,1160,2495,37.587524,126.883003
마포구,401, 상암월드컵파크 10단지 앞,201901,360,319,679,37.586189,126.881615
마포구,401, 상암월드컵파크 10단지 앞,201902,282,295,577,37.586189,126.881615
마포구,401, 상암월드컵파크 10단지 앞,201903,482,504,986,37.586189,126.881615
마포구,401, 상암월드컵파크 10단지 앞,201904,696,718,1414,37.586189,126.881615
마포구,401, 상암월드컵파크 10단지 앞,201905,902,940,1842,37.586189,126.881615
마포구,401, 상암월드컵파크 10단지 앞,201906,940,958,1898,37.586189,126.881615
마포구,401, 상암월드컵파크 10단지 앞,201907,893,944,1837,37.586189,126.881615
마포구,401, 상암월드컵파크 10단지 앞,201908,973,1035,2008,37.586189,126.881615
마포구,401, 상암월드컵파크 10단지 앞,201909,987,947,1934,37.586189,126.881615
마포구,401, 상암월드컵파크 10단지 앞,201910,1107,1086,2193,37.586189,126.881615
마포구,401, 상암월드컵파크 10단지 앞,201911,741,799,1540,37.586189,126.881615
마포구,401, 상암월드컵파크 10단지 앞,201912,411,438,849,37.586189,126.881615
마포구,401, 상암월드컵파크 10단지 앞,202001,448,441,889,37.586189,126.881615
마포구,401, 상암월드컵파크 10단지 앞,202002,438,435,873,37.586189,126.881615
마포구,401, 상암월드컵파크 10단지 앞,202003,696,745,1441,37.586189,126.881615
마포구,401, 상암월드컵파크 10단지 앞,202004,964,915,1879,37.586189,126.881615
마포구,401, 상암월드컵파크 10단지 앞,202005,1038,1014,2052,37.586189,126.881615
마포구,401, 상암월드컵파크 10단지 앞,202006,1143,1093,2236,37.586189,126.881615
마포구,402, 상암월드컵파크 9단지 앞,201901,244,187,431,37.582855,126.879822
마포구,402, 상암월드컵파크 9단지 앞,201902,240,199,439,37.582855,126.879822
마포구,402, 상암월드컵파크 9단지 앞,201903,564,508,1072,37.582855,126.879822
마포구,402, 상암월드컵파크 9단지 앞,201904,776,664,1440,37.582855,126.879822
마포구,402, 상암월드컵파크 9단지 앞,201905,1082,963,2045,37.582855,126.879822
마포구,402, 상암월드컵파크 9단지 앞,201906,1109,1008,2117,37.582855,126.879822
마포구,402, 상암월드컵파크 9단지 앞,201907,1084,977,2061,37.582855,126.879822
마포구,402, 상암월드컵파크 9단지 앞,201908,1024,999,2023,37.582855,126.879822
마포구,402, 상암월드컵파크 9단지 앞,201909,894,806,1700,37.582855,126.879822
마포구,402, 상암월드컵파크 9단지 앞,201910,1315,1235,2550,37.582855,126.879822
마포구,402, 상암월드컵파크 9단지 앞,201911,904,914,1818,37.582855,126.879822
마포구,402, 상암월드컵파크 9단지 앞,201912,473,465,938,37.582855,126.879822
마포구,402, 상암월드컵파크 9단지 앞,202001,442,378,820,37.582855,126.879822
마포구,402, 상암월드컵파크 9단지 앞,202002,397,354,751,37.582855,126.879822
마포구,402, 상암월드컵파크 9단지 앞,202003,813,787,1600,37.582855,126.879822
마포구,402, 상암월드컵파크 9단지 앞,202004,934,918,1852,37.582855,126.879822
마포구,402, 상암월드컵파크 9단지 앞,202005,1189,1151,2340,37.582855,126.879822
마포구,402, 상암월드컵파크 9단지 앞,202006,1323,1249,2572,37.582855,126.879822
마포구,403, 부엉이공원 앞,201901,263,102,365,37.58559,126.884727
마포구,403, 부엉이공원 앞,201902,214,88,302,37.58559,126.884727
마포구,403, 부엉이공원 앞,201903,489,206,695,37.58559,126.884727
마포구,403, 부엉이공원 앞,201904,717,254,971,37.58559,126.884727
마포구,403, 부엉이공원 앞,201905,1071,435,1506,37.58559,126.884727
마포구,403, 부엉이공원 앞,201906,1155,568,1723,37.58559,126.884727
마포구,403, 부엉이공원 앞,201907,1081,507,1588,37.58559,126.884727
마포구,403, 부엉이공원 앞,201908,971,496,1467,37.58559,126.884727
마포구,403, 부엉이공원 앞,201909,862,468,1330,37.58559,126.884727
마포구,403, 부엉이공원 앞,201910,1049,559,1608,37.58559,126.884727
마포구,403, 부엉이공원 앞,201911,770,407,1177,37.58559,126.884727
마포구,403, 부엉이공원 앞,201912,457,183,640,37.58559,126.884727
마포구,403, 부엉이공원 앞,202001,397,167,564,37.58559,126.884727
마포구,403, 부엉이공원 앞,202002,376,136,512,37.58559,126.884727
마포구,403, 부엉이공원 앞,202003,639,295,934,37.58559,126.884727
마포구,403, 부엉이공원 앞,202004,598,373,971,37.58559,126.884727
마포구,403, 부엉이공원 앞,202005,535,431,966,37.58559,126.884727
마포구,403, 부엉이공원 앞,202006,935,559,1494,37.58559,126.884727
마포구,405, DMC빌 앞,201901,235,258,493,37.582657,126.885788
마포구,405, DMC빌 앞,201902,198,199,397,37.582657,126.885788
마포구,405, DMC빌 앞,201903,344,342,686,37.582657,126.885788
마포구,405, DMC빌 앞,201904,442,530,972,37.582657,126.885788
마포구,405, DMC빌 앞,201905,638,719,1357,37.582657,126.885788
마포구,405, DMC빌 앞,201906,762,827,1589,37.582657,126.885788
마포구,405, DMC빌 앞,201907,866,946,1812,37.582657,126.885788
마포구,405, DMC빌 앞,201908,878,895,1773,37.582657,126.885788
마포구,405, DMC빌 앞,201909,701,724,1425,37.582657,126.885788
마포구,405, DMC빌 앞,201910,895,943,1838,37.582657,126.885788
마포구,405, DMC빌 앞,201911,612,625,1237,37.582657,126.885788
마포구,405, DMC빌 앞,201912,362,365,727,37.582657,126.885788
마포구,405, DMC빌 앞,202001,335,385,720,37.582657,126.885788
마포구,405, DMC빌 앞,202002,338,348,686,37.582657,126.885788
마포구,405, DMC빌 앞,202003,600,624,1224,37.582657,126.885788
마포구,405, DMC빌 앞,202004,729,788,1517,37.582657,126.885788
마포구,405, DMC빌 앞,202005,771,848,1619,37.582657,126.885788
마포구,405, DMC빌 앞,202006,784,914,1698,37.582657,126.885788
마포구,406, 상암월드컵파크 7단지 앞,201901,215,201,416,37.581314,126.880585
마포구,406, 상암월드컵파크 7단지 앞,201902,205,156,361,37.581314,126.880585
마포구,406, 상암월드컵파크 7단지 앞,201903,317,286,603,37.581314,126.880585
마포구,406, 상암월드컵파크 7단지 앞,201904,486,402,888,37.581314,126.880585
마포구,406, 상암월드컵파크 7단지 앞,201905,763,652,1415,37.581314,126.880585
마포구,406, 상암월드컵파크 7단지 앞,201906,827,791,1618,37.581314,126.880585
마포구,406, 상암월드컵파크 7단지 앞,201907,765,701,1466,37.581314,126.880585
마포구,406, 상암월드컵파크 7단지 앞,201908,777,715,1492,37.581314,126.880585
마포구,406, 상암월드컵파크 7단지 앞,201909,765,690,1455,37.581314,126.880585
마포구,406, 상암월드컵파크 7단지 앞,201910,872,781,1653,37.581314,126.880585
마포구,406, 상암월드컵파크 7단지 앞,201911,530,513,1043,37.581314,126.880585
마포구,406, 상암월드컵파크 7단지 앞,201912,299,287,586,37.581314,126.880585
마포구,406, 상암월드컵파크 7단지 앞,202001,279,305,584,37.581314,126.880585
마포구,406, 상암월드컵파크 7단지 앞,202002,226,202,428,37.581314,126.880585
마포구,406, 상암월드컵파크 7단지 앞,202003,512,447,959,37.581314,126.880585
마포구,406, 상암월드컵파크 7단지 앞,202004,664,638,1302,37.581314,126.880585
마포구,406, 상암월드컵파크 7단지 앞,202005,720,675,1395,37.581314,126.880585
마포구,406, 상암월드컵파크 7단지 앞,202006,854,778,1632,37.581314,126.880585
마포구,407, 마포구 육아종합지원센터,201901,311,341,652,37.580631,126.883675
마포구,407, 마포구 육아종합지원센터,201902,234,242,476,37.580631,126.883675
마포구,407, 마포구 육아종합지원센터,201903,428,413,841,37.580631,126.883675
마포구,407, 마포구 육아종합지원센터,201904,733,679,1412,37.580631,126.883675
마포구,407, 마포구 육아종합지원센터,201905,1023,953,1976,37.580631,126.883675
마포구,407, 마포구 육아종합지원센터,201906,1151,1144,2295,37.580631,126.883675
마포구,407, 마포구 육아종합지원센터,201907,1110,1085,2195,37.580631,126.883675
마포구,407, 마포구 육아종합지원센터,201908,973,963,1936,37.580631,126.883675
마포구,407, 마포구 육아종합지원센터,201909,830,823,1653,37.580631,126.883675
마포구,407, 마포구 육아종합지원센터,201910,1137,1105,2242,37.580631,126.883675
마포구,407, 마포구 육아종합지원센터,201911,768,778,1546,37.580631,126.883675
마포구,407, 마포구 육아종합지원센터,201912,475,450,925,37.580631,126.883675
마포구,407, 마포구 육아종합지원센터,202001,393,402,795,37.580631,126.883675
마포구,407, 마포구 육아종합지원센터,202002,346,329,675,37.580631,126.883675
마포구,407, 마포구 육아종합지원센터,202003,681,652,1333,37.580631,126.883675
마포구,407, 마포구 육아종합지원센터,202004,873,869,1742,37.580631,126.883675
마포구,407, 마포구 육아종합지원센터,202005,1083,1068,2151,37.580631,126.883675
마포구,407, 마포구 육아종합지원센터,202006,1176,1150,2326,37.580631,126.883675
마포구,408, LG CNS앞,201901,451,414,865,37.580811,126.88665
마포구,408, LG CNS앞,201902,350,313,663,37.580811,126.88665
마포구,408, LG CNS앞,201903,737,721,1458,37.580811,126.88665
마포구,408, LG CNS앞,201904,1014,1099,2113,37.580811,126.88665
마포구,408, LG CNS앞,201905,1340,1437,2777,37.580811,126.88665
마포구,408, LG CNS앞,201906,1016,1099,2115,37.580811,126.88665
마포구,408, LG CNS앞,201907,1334,1284,2618,37.580811,126.88665
마포구,408, LG CNS앞,201908,1163,1151,2314,37.580811,126.88665
마포구,408, LG CNS앞,201909,1186,1224,2410,37.580811,126.88665
마포구,408, LG CNS앞,201910,1520,1594,3114,37.580811,126.88665
마포구,408, LG CNS앞,201911,1092,1095,2187,37.580811,126.88665
마포구,408, LG CNS앞,201912,659,622,1281,37.580811,126.88665
마포구,408, LG CNS앞,202001,563,551,1114,37.580811,126.88665
마포구,408, LG CNS앞,202002,503,508,1011,37.580811,126.88665
마포구,408, LG CNS앞,202003,714,641,1355,37.580811,126.88665
마포구,408, LG CNS앞,202004,983,970,1953,37.580811,126.88665
마포구,408, LG CNS앞,202005,1082,1088,2170,37.580811,126.88665
마포구,408, LG CNS앞,202006,1076,1079,2155,37.580811,126.88665
마포구,409, 누리꿈스퀘어 옆,201901,838,950,1788,37.579399,126.88916
마포구,409, 누리꿈스퀘어 옆,201902,711,761,1472,37.579399,126.88916
마포구,409, 누리꿈스퀘어 옆,201903,1406,1696,3102,37.579399,126.88916
마포구,409, 누리꿈스퀘어 옆,201904,1895,2413,4308,37.579399,126.88916
마포구,409, 누리꿈스퀘어 옆,201905,2480,3150,5630,37.579399,126.88916
마포구,409, 누리꿈스퀘어 옆,201906,2949,3326,6275,37.579399,126.88916
마포구,409, 누리꿈스퀘어 옆,201907,3044,3526,6570,37.579399,126.88916
마포구,409, 누리꿈스퀘어 옆,201908,2934,3156,6090,37.579399,126.88916
마포구,409, 누리꿈스퀘어 옆,201909,2456,2983,5439,37.579399,126.88916
마포구,409, 누리꿈스퀘어 옆,201910,3116,3772,6888,37.579399,126.88916
마포구,409, 누리꿈스퀘어 옆,201911,2421,2702,5123,37.579399,126.88916
마포구,409, 누리꿈스퀘어 옆,201912,1454,1546,3000,37.579399,126.88916
마포구,409, 누리꿈스퀘어 옆,202001,1188,1441,2629,37.579399,126.88916
마포구,409, 누리꿈스퀘어 옆,202002,1121,1245,2366,37.579399,126.88916
마포구,409, 누리꿈스퀘어 옆,202003,1972,2041,4013,37.579399,126.88916
마포구,409, 누리꿈스퀘어 옆,202004,2401,2548,4949,37.579399,126.88916
마포구,409, 누리꿈스퀘어 옆,202005,2519,2707,5226,37.579399,126.88916
마포구,409, 누리꿈스퀘어 옆,202006,2545,2943,5488,37.579399,126.88916
마포구,410, 상암중학교 옆,201901,114,72,186,37.577496,126.887772
마포구,410, 상암중학교 옆,201902,113,77,190,37.577496,126.887772
마포구,410, 상암중학교 옆,201903,222,177,399,37.577496,126.887772
마포구,410, 상암중학교 옆,201904,362,254,616,37.577496,126.887772
마포구,410, 상암중학교 옆,201905,529,370,899,37.577496,126.887772
마포구,410, 상암중학교 옆,201906,611,480,1091,37.577496,126.887772
마포구,410, 상암중학교 옆,201907,591,438,1029,37.577496,126.887772
마포구,410, 상암중학교 옆,201908,471,376,847,37.577496,126.887772
마포구,410, 상암중학교 옆,201909,340,303,643,37.577496,126.887772
마포구,410, 상암중학교 옆,201910,651,497,1148,37.577496,126.887772
마포구,410, 상암중학교 옆,201911,430,349,779,37.577496,126.887772
마포구,410, 상암중학교 옆,201912,241,175,416,37.577496,126.887772
마포구,410, 상암중학교 옆,202001,218,153,371,37.577496,126.887772
마포구,410, 상암중학교 옆,202002,194,158,352,37.577496,126.887772
마포구,410, 상암중학교 옆,202003,348,281,629,37.577496,126.887772
마포구,410, 상암중학교 옆,202004,482,462,944,37.577496,126.887772
마포구,410, 상암중학교 옆,202005,495,450,945,37.577496,126.887772
마포구,410, 상암중학교 옆,202006,481,414,895,37.577496,126.887772
마포구,411, DMC홍보관,201901,353,382,735,37.577995,126.891472
마포구,411, DMC홍보관,201902,310,335,645,37.577995,126.891472
마포구,411, DMC홍보관,201903,625,647,1272,37.577995,126.891472
마포구,411, DMC홍보관,201904,809,1009,1818,37.577995,126.891472
마포구,411, DMC홍보관,201905,1206,1436,2642,37.577995,126.891472
마포구,411, DMC홍보관,201906,1251,1398,2649,37.577995,126.891472
마포구,411, DMC홍보관,201907,1369,1540,2909,37.577995,126.891472
마포구,411, DMC홍보관,201908,1405,1495,2900,37.577995,126.891472
마포구,411, DMC홍보관,201909,1181,1395,2576,37.577995,126.891472
마포구,411, DMC홍보관,201910,1484,1751,3235,37.577995,126.891472
마포구,411, DMC홍보관,201911,1105,1208,2313,37.577995,126.891472
마포구,411, DMC홍보관,201912,580,685,1265,37.577995,126.891472
마포구,411, DMC홍보관,202001,508,615,1123,37.577995,126.891472
마포구,411, DMC홍보관,202002,523,603,1126,37.577995,126.891472
마포구,411, DMC홍보관,202003,987,1059,2046,37.577995,126.891472
마포구,411, DMC홍보관,202004,1278,1329,2607,37.577995,126.891472
마포구,411, DMC홍보관,202005,1497,1593,3090,37.577995,126.891472
마포구,411, DMC홍보관,202006,1555,1807,3362,37.577995,126.891472
마포구,412, DMC산학협력연구센터 앞,201901,517,488,1005,37.575802,126.890739
마포구,412, DMC산학협력연구센터 앞,201902,450,419,869,37.575802,126.890739
마포구,412, DMC산학협력연구센터 앞,201903,933,1039,1972,37.575802,126.890739
마포구,412, DMC산학협력연구센터 앞,201904,1246,1440,2686,37.575802,126.890739
마포구,412, DMC산학협력연구센터 앞,201905,1832,2039,3871,37.575802,126.890739
마포구,412, DMC산학협력연구센터 앞,201906,1967,2000,3967,37.575802,126.890739
마포구,412, DMC산학협력연구센터 앞,201907,1984,2022,4006,37.575802,126.890739
마포구,412, DMC산학협력연구센터 앞,201908,1851,1854,3705,37.575802,126.890739
마포구,412, DMC산학협력연구센터 앞,201909,1834,1882,3716,37.575802,126.890739
마포구,412, DMC산학협력연구센터 앞,201910,2490,2605,5095,37.575802,126.890739
마포구,412, DMC산학협력연구센터 앞,201911,1727,1758,3485,37.575802,126.890739
마포구,412, DMC산학협력연구센터 앞,201912,916,997,1913,37.575802,126.890739
마포구,412, DMC산학협력연구센터 앞,202001,810,871,1681,37.575802,126.890739
마포구,412, DMC산학협력연구센터 앞,202002,784,829,1613,37.575802,126.890739
마포구,412, DMC산학협력연구센터 앞,202003,1358,1360,2718,37.575802,126.890739
마포구,412, DMC산학협력연구센터 앞,202004,1615,1626,3241,37.575802,126.890739
마포구,412, DMC산학협력연구센터 앞,202005,1669,1668,3337,37.575802,126.890739
마포구,412, DMC산학협력연구센터 앞,202006,1992,2016,4008,37.575802,126.890739
마포구,413, 상암월드컵파크 3단지 후문,201901,237,140,377,37.571476,126.889687
마포구,413, 상암월드컵파크 3단지 후문,201902,220,155,375,37.571476,126.889687
마포구,413, 상암월드컵파크 3단지 후문,201903,370,267,637,37.571476,126.889687
마포구,413, 상암월드컵파크 3단지 후문,201904,588,458,1046,37.571476,126.889687
마포구,413, 상암월드컵파크 3단지 후문,201905,861,741,1602,37.571476,126.889687
마포구,413, 상암월드컵파크 3단지 후문,201906,860,732,1592,37.571476,126.889687
마포구,413, 상암월드컵파크 3단지 후문,201907,860,723,1583,37.571476,126.889687
마포구,413, 상암월드컵파크 3단지 후문,201908,767,644,1411,37.571476,126.889687
마포구,413, 상암월드컵파크 3단지 후문,201909,713,613,1326,37.571476,126.889687
마포구,413, 상암월드컵파크 3단지 후문,201910,1018,899,1917,37.571476,126.889687
마포구,413, 상암월드컵파크 3단지 후문,201911,622,537,1159,37.571476,126.889687
마포구,413, 상암월드컵파크 3단지 후문,201912,362,289,651,37.571476,126.889687
마포구,413, 상암월드컵파크 3단지 후문,202001,386,322,708,37.571476,126.889687
마포구,413, 상암월드컵파크 3단지 후문,202002,338,267,605,37.571476,126.889687
마포구,413, 상암월드컵파크 3단지 후문,202003,546,507,1053,37.571476,126.889687
마포구,413, 상암월드컵파크 3단지 후문,202004,698,667,1365,37.571476,126.889687
마포구,413, 상암월드컵파크 3단지 후문,202005,710,659,1369,37.571476,126.889687
마포구,413, 상암월드컵파크 3단지 후문,202006,792,672,1464,37.571476,126.889687
마포구,414, 상암동주민센터 옆,201901,480,546,1026,37.57822,126.89447
마포구,414, 상암동주민센터 옆,201902,343,375,718,37.57822,126.89447
마포구,414, 상암동주민센터 옆,201903,653,748,1401,37.57822,126.89447
마포구,414, 상암동주민센터 옆,201904,866,869,1735,37.57822,126.89447
마포구,414, 상암동주민센터 옆,201905,1280,1335,2615,37.57822,126.89447
마포구,414, 상암동주민센터 옆,201906,1470,1530,3000,37.57822,126.89447
마포구,414, 상암동주민센터 옆,201907,1557,1579,3136,37.57822,126.89447
마포구,414, 상암동주민센터 옆,201908,1542,1593,3135,37.57822,126.89447
마포구,414, 상암동주민센터 옆,201909,1378,1367,2745,37.57822,126.89447
마포구,414, 상암동주민센터 옆,201910,1760,1796,3556,37.57822,126.89447
마포구,414, 상암동주민센터 옆,201911,1186,1273,2459,37.57822,126.89447
마포구,414, 상암동주민센터 옆,201912,655,783,1438,37.57822,126.89447
마포구,414, 상암동주민센터 옆,202001,566,676,1242,37.57822,126.89447
마포구,414, 상암동주민센터 옆,202002,571,667,1238,37.57822,126.89447
마포구,414, 상암동주민센터 옆,202003,971,1025,1996,37.57822,126.89447
마포구,414, 상암동주민센터 옆,202004,1351,1340,2691,37.57822,126.89447
마포구,414, 상암동주민센터 옆,202005,1501,1497,2998,37.57822,126.89447
마포구,414, 상암동주민센터 옆,202006,1756,1730,3486,37.57822,126.89447
마포구,415, DMC역 9번출구 앞,201901,925,906,1831,37.577469,126.897362
마포구,415, DMC역 9번출구 앞,201902,784,744,1528,37.577469,126.897362
마포구,415, DMC역 9번출구 앞,201903,1655,1414,3069,37.577469,126.897362
마포구,415, DMC역 9번출구 앞,201904,2161,1755,3916,37.577469,126.897362
마포구,415, DMC역 9번출구 앞,201905,2902,2288,5190,37.577469,126.897362
마포구,415, DMC역 9번출구 앞,201906,2993,2453,5446,37.577469,126.897362
마포구,415, DMC역 9번출구 앞,201907,3353,2779,6132,37.577469,126.897362
마포구,415, DMC역 9번출구 앞,201908,2987,2426,5413,37.577469,126.897362
마포구,415, DMC역 9번출구 앞,201909,2368,2024,4392,37.577469,126.897362
마포구,415, DMC역 9번출구 앞,201910,3418,2973,6391,37.577469,126.897362
마포구,415, DMC역 9번출구 앞,201911,2617,2184,4801,37.577469,126.897362
마포구,415, DMC역 9번출구 앞,201912,1525,1374,2899,37.577469,126.897362
마포구,415, DMC역 9번출구 앞,202001,1188,1019,2207,37.577469,126.897362
마포구,415, DMC역 9번출구 앞,202002,1053,880,1933,37.577469,126.897362
마포구,415, DMC역 9번출구 앞,202003,1562,1228,2790,37.577469,126.897362
마포구,415, DMC역 9번출구 앞,202004,1875,1688,3563,37.577469,126.897362
마포구,415, DMC역 9번출구 앞,202005,1983,1809,3792,37.577469,126.897362
마포구,415, DMC역 9번출구 앞,202006,2638,2427,5065,37.577469,126.897362
마포구,416, 상암월드컵파크 1단지 교차로,201901,452,157,609,37.575665,126.894447
마포구,416, 상암월드컵파크 1단지 교차로,201902,438,197,635,37.575665,126.894447
마포구,416, 상암월드컵파크 1단지 교차로,201903,783,297,1080,37.575665,126.894447
마포구,416, 상암월드컵파크 1단지 교차로,201904,1090,379,1469,37.575665,126.894447
마포구,416, 상암월드컵파크 1단지 교차로,201905,1393,562,1955,37.575665,126.894447
마포구,416, 상암월드컵파크 1단지 교차로,201906,1297,573,1870,37.575665,126.894447
마포구,416, 상암월드컵파크 1단지 교차로,201907,1455,580,2035,37.575665,126.894447
마포구,416, 상암월드컵파크 1단지 교차로,201908,1310,520,1830,37.575665,126.894447
마포구,416, 상암월드컵파크 1단지 교차로,201909,897,454,1351,37.575665,126.894447
마포구,416, 상암월드컵파크 1단지 교차로,201910,1144,565,1709,37.575665,126.894447
마포구,416, 상암월드컵파크 1단지 교차로,201911,905,380,1285,37.575665,126.894447
마포구,416, 상암월드컵파크 1단지 교차로,201912,632,294,926,37.575665,126.894447
마포구,416, 상암월드컵파크 1단지 교차로,202001,526,216,742,37.575665,126.894447
마포구,416, 상암월드컵파크 1단지 교차로,202002,441,186,627,37.575665,126.894447
마포구,416, 상암월드컵파크 1단지 교차로,202003,767,376,1143,37.575665,126.894447
마포구,416, 상암월드컵파크 1단지 교차로,202004,683,439,1122,37.575665,126.894447
마포구,416, 상암월드컵파크 1단지 교차로,202005,756,551,1307,37.575665,126.894447
마포구,416, 상암월드컵파크 1단지 교차로,202006,940,665,1605,37.575665,126.894447
마포구,417, DMC역 2번출구 옆,201901,502,553,1055,37.575069,126.899918
마포구,417, DMC역 2번출구 옆,201902,395,443,838,37.575069,126.899918
마포구,417, DMC역 2번출구 옆,201903,830,791,1621,37.575069,126.899918
마포구,417, DMC역 2번출구 옆,201904,1517,1143,2660,37.575069,126.899918
마포구,417, DMC역 2번출구 옆,201905,2258,1646,3904,37.575069,126.899918
마포구,417, DMC역 2번출구 옆,201906,2250,1628,3878,37.575069,126.899918
마포구,417, DMC역 2번출구 옆,201907,2480,1625,4105,37.575069,126.899918
마포구,417, DMC역 2번출구 옆,201908,2080,1541,3621,37.575069,126.899918
마포구,417, DMC역 2번출구 옆,201909,1938,1367,3305,37.575069,126.899918
마포구,417, DMC역 2번출구 옆,201910,2350,1761,4111,37.575069,126.899918
마포구,417, DMC역 2번출구 옆,201911,1613,1235,2848,37.575069,126.899918
마포구,417, DMC역 2번출구 옆,201912,762,723,1485,37.575069,126.899918
마포구,417, DMC역 2번출구 옆,202001,737,605,1342,37.575069,126.899918
마포구,417, DMC역 2번출구 옆,202002,850,605,1455,37.575069,126.899918
마포구,417, DMC역 2번출구 옆,202003,1549,1208,2757,37.575069,126.899918
마포구,417, DMC역 2번출구 옆,202004,2145,1698,3843,37.575069,126.899918
마포구,417, DMC역 2번출구 옆,202005,1933,1691,3624,37.575069,126.899918
마포구,417, DMC역 2번출구 옆,202006,2164,1754,3918,37.575069,126.899918
마포구,418, 월드컵경기장역 3번출구 옆,201901,427,467,894,37.570721,126.898979
마포구,418, 월드컵경기장역 3번출구 옆,201902,532,585,1117,37.570721,126.898979
마포구,418, 월드컵경기장역 3번출구 옆,201903,1181,1249,2430,37.570721,126.898979
마포구,418, 월드컵경기장역 3번출구 옆,201904,2033,2079,4112,37.570721,126.898979
마포구,418, 월드컵경기장역 3번출구 옆,201905,3188,3133,6321,37.570721,126.898979
마포구,418, 월드컵경기장역 3번출구 옆,201906,3568,3595,7163,37.570721,126.898979
마포구,418, 월드컵경기장역 3번출구 옆,201907,3018,3007,6025,37.570721,126.898979
마포구,418, 월드컵경기장역 3번출구 옆,201908,3073,3084,6157,37.570721,126.898979
마포구,418, 월드컵경기장역 3번출구 옆,201909,2836,2857,5693,37.570721,126.898979
마포구,418, 월드컵경기장역 3번출구 옆,201910,3523,3542,7065,37.570721,126.898979
마포구,418, 월드컵경기장역 3번출구 옆,201911,1797,1832,3629,37.570721,126.898979
마포구,418, 월드컵경기장역 3번출구 옆,201912,760,877,1637,37.570721,126.898979
마포구,418, 월드컵경기장역 3번출구 옆,202001,782,883,1665,37.570721,126.898979
마포구,418, 월드컵경기장역 3번출구 옆,202002,872,890,1762,37.570721,126.898979
마포구,418, 월드컵경기장역 3번출구 옆,202003,3078,3174,6252,37.570721,126.898979
마포구,418, 월드컵경기장역 3번출구 옆,202004,3997,3981,7978,37.570721,126.898979
마포구,418, 월드컵경기장역 3번출구 옆,202005,3716,3737,7453,37.570721,126.898979
마포구,418, 월드컵경기장역 3번출구 옆,202006,3781,3771,7552,37.570721,126.898979
마포구,419, 홈플러스 앞,201901,653,556,1209,37.56842,126.899429
마포구,419, 홈플러스 앞,201902,733,621,1354,37.56842,126.899429
마포구,419, 홈플러스 앞,201903,1610,1393,3003,37.56842,126.899429
마포구,419, 홈플러스 앞,201904,2186,1911,4097,37.56842,126.899429
마포구,419, 홈플러스 앞,201905,3226,2887,6113,37.56842,126.899429
마포구,419, 홈플러스 앞,201906,3618,3394,7012,37.56842,126.899429
마포구,419, 홈플러스 앞,201907,3312,2977,6289,37.56842,126.899429
마포구,419, 홈플러스 앞,201908,3244,2894,6138,37.56842,126.899429
마포구,419, 홈플러스 앞,201909,2694,2533,5227,37.56842,126.899429
마포구,419, 홈플러스 앞,201910,3468,3149,6617,37.56842,126.899429
마포구,419, 홈플러스 앞,201911,2121,1840,3961,37.56842,126.899429
마포구,419, 홈플러스 앞,201912,1142,891,2033,37.56842,126.899429
마포구,419, 홈플러스 앞,202001,1051,841,1892,37.56842,126.899429
마포구,419, 홈플러스 앞,202002,1054,892,1946,37.56842,126.899429
마포구,419, 홈플러스 앞,202003,2667,2421,5088,37.56842,126.899429
마포구,419, 홈플러스 앞,202004,2984,2826,5810,37.56842,126.899429
마포구,419, 홈플러스 앞,202005,3219,3118,6337,37.56842,126.899429
마포구,419, 홈플러스 앞,202006,3153,2996,6149,37.56842,126.899429
마포구,420, 서울시 공공자전거 상암센터,201901,89,97,186,37.566246,126.896179
마포구,420, 서울시 공공자전거 상암센터,201902,115,124,239,37.566246,126.896179
마포구,420, 서울시 공공자전거 상암센터,201903,393,405,798,37.566246,126.896179
마포구,420, 서울시 공공자전거 상암센터,201904,734,670,1404,37.566246,126.896179
마포구,420, 서울시 공공자전거 상암센터,201905,1314,1135,2449,37.566246,126.896179
마포구,420, 서울시 공공자전거 상암센터,201906,1213,1159,2372,37.566246,126.896179
마포구,420, 서울시 공공자전거 상암센터,201907,846,711,1557,37.566246,126.896179
마포구,420, 서울시 공공자전거 상암센터,201908,1109,938,2047,37.566246,126.896179
마포구,420, 서울시 공공자전거 상암센터,201909,1714,1252,2966,37.566246,126.896179
마포구,420, 서울시 공공자전거 상암센터,201910,2373,1743,4116,37.566246,126.896179
마포구,420, 서울시 공공자전거 상암센터,201911,843,689,1532,37.566246,126.896179
마포구,420, 서울시 공공자전거 상암센터,201912,277,270,547,37.566246,126.896179
마포구,420, 서울시 공공자전거 상암센터,202001,263,254,517,37.566246,126.896179
마포구,420, 서울시 공공자전거 상암센터,202002,328,379,707,37.566246,126.896179
마포구,420, 서울시 공공자전거 상암센터,202003,1346,1147,2493,37.566246,126.896179
마포구,420, 서울시 공공자전거 상암센터,202004,1937,1523,3460,37.566246,126.896179
마포구,420, 서울시 공공자전거 상암센터,202005,2418,1778,4196,37.566246,126.896179
마포구,420, 서울시 공공자전거 상암센터,202006,2058,1575,3633,37.566246,126.896179
마포구,421, 마포구청 앞,201901,788,994,1782,37.565903,126.901184
마포구,421, 마포구청 앞,201902,788,876,1664,37.565903,126.901184
마포구,421, 마포구청 앞,201903,1585,1787,3372,37.565903,126.901184
마포구,421, 마포구청 앞,201904,2546,2732,5278,37.565903,126.901184
마포구,421, 마포구청 앞,201905,3756,3904,7660,37.565903,126.901184
마포구,421, 마포구청 앞,201906,3964,4224,8188,37.565903,126.901184
마포구,421, 마포구청 앞,201907,3673,4041,7714,37.565903,126.901184
마포구,421, 마포구청 앞,201908,3511,3823,7334,37.565903,126.901184
마포구,421, 마포구청 앞,201909,3528,3665,7193,37.565903,126.901184
마포구,421, 마포구청 앞,201910,3892,4065,7957,37.565903,126.901184
마포구,421, 마포구청 앞,201911,2201,2477,4678,37.565903,126.901184
마포구,421, 마포구청 앞,201912,1247,1424,2671,37.565903,126.901184
마포구,421, 마포구청 앞,202001,1127,1301,2428,37.565903,126.901184
마포구,421, 마포구청 앞,202002,1023,1147,2170,37.565903,126.901184
마포구,421, 마포구청 앞,202003,2470,2521,4991,37.565903,126.901184
마포구,421, 마포구청 앞,202004,3262,3313,6575,37.565903,126.901184
마포구,421, 마포구청 앞,202005,3468,3463,6931,37.565903,126.901184
마포구,421, 마포구청 앞,202006,2834,2942,5776,37.565903,126.901184
마포구,422, 문화비축기지,201901,91,154,245,37.569084,126.894424
마포구,422, 문화비축기지,201902,81,117,198,37.569084,126.894424
마포구,422, 문화비축기지,201903,258,272,530,37.569084,126.894424
마포구,422, 문화비축기지,201904,420,404,824,37.569084,126.894424
마포구,422, 문화비축기지,201905,785,743,1528,37.569084,126.894424
마포구,422, 문화비축기지,201906,710,591,1301,37.569084,126.894424
마포구,422, 문화비축기지,201907,594,529,1123,37.569084,126.894424
마포구,422, 문화비축기지,201908,654,566,1220,37.569084,126.894424
마포구,422, 문화비축기지,201909,637,593,1230,37.569084,126.894424
마포구,422, 문화비축기지,201910,1242,1174,2416,37.569084,126.894424
마포구,422, 문화비축기지,201911,520,508,1028,37.569084,126.894424
마포구,422, 문화비축기지,201912,162,161,323,37.569084,126.894424
마포구,422, 문화비축기지,202001,155,142,297,37.569084,126.894424
마포구,422, 문화비축기지,202002,120,114,234,37.569084,126.894424
마포구,422, 문화비축기지,202003,258,230,488,37.569084,126.894424
마포구,422, 문화비축기지,202004,134,176,310,37.569084,126.894424
마포구,422, 문화비축기지,202005,339,324,663,37.569084,126.894424
마포구,422, 문화비축기지,202006,317,250,567,37.569084,126.894424
마포구,424, 롯데하이마트 (상암월드컵점),201901,76,68,144,37.57362,126.898048
마포구,424, 롯데하이마트 (상암월드컵점),201902,100,77,177,37.57362,126.898048
마포구,424, 롯데하이마트 (상암월드컵점),201903,209,194,403,37.57362,126.898048
마포구,424, 롯데하이마트 (상암월드컵점),201904,446,348,794,37.57362,126.898048
마포구,424, 롯데하이마트 (상암월드컵점),201905,492,371,863,37.57362,126.898048
마포구,424, 롯데하이마트 (상암월드컵점),201906,517,373,890,37.57362,126.898048
마포구,424, 롯데하이마트 (상암월드컵점),201907,543,414,957,37.57362,126.898048
마포구,424, 롯데하이마트 (상암월드컵점),201908,612,398,1010,37.57362,126.898048
마포구,424, 롯데하이마트 (상암월드컵점),201909,435,319,754,37.57362,126.898048
마포구,424, 롯데하이마트 (상암월드컵점),201910,652,445,1097,37.57362,126.898048
마포구,424, 롯데하이마트 (상암월드컵점),201911,359,278,637,37.57362,126.898048
마포구,424, 롯데하이마트 (상암월드컵점),201912,179,175,354,37.57362,126.898048
마포구,424, 롯데하이마트 (상암월드컵점),202001,213,175,388,37.57362,126.898048
마포구,424, 롯데하이마트 (상암월드컵점),202002,182,146,328,37.57362,126.898048
마포구,424, 롯데하이마트 (상암월드컵점),202003,453,364,817,37.57362,126.898048
마포구,424, 롯데하이마트 (상암월드컵점),202004,420,361,781,37.57362,126.898048
마포구,424, 롯데하이마트 (상암월드컵점),202005,475,417,892,37.57362,126.898048
마포구,424, 롯데하이마트 (상암월드컵점),202006,704,530,1234,37.57362,126.898048
마포구,425, DMC첨단산업센터,201901,177,200,377,37.584503,126.885597
마포구,425, DMC첨단산업센터,201902,145,162,307,37.584503,126.885597
마포구,425, DMC첨단산업센터,201903,344,379,723,37.584503,126.885597
마포구,425, DMC첨단산업센터,201904,447,447,894,37.584503,126.885597
마포구,425, DMC첨단산업센터,201905,553,577,1130,37.584503,126.885597
마포구,425, DMC첨단산업센터,201906,510,487,997,37.584503,126.885597
마포구,425, DMC첨단산업센터,201907,633,592,1225,37.584503,126.885597
마포구,425, DMC첨단산업센터,201908,532,514,1046,37.584503,126.885597
마포구,425, DMC첨단산업센터,201909,428,425,853,37.584503,126.885597
마포구,425, DMC첨단산업센터,201910,512,513,1025,37.584503,126.885597
마포구,425, DMC첨단산업센터,201911,385,369,754,37.584503,126.885597
마포구,425, DMC첨단산업센터,201912,256,252,508,37.584503,126.885597
마포구,425, DMC첨단산업센터,202001,224,220,444,37.584503,126.885597
마포구,425, DMC첨단산업센터,202002,185,185,370,37.584503,126.885597
마포구,425, DMC첨단산업센터,202003,371,362,733,37.584503,126.885597
마포구,425, DMC첨단산업센터,202004,552,559,1111,37.584503,126.885597
마포구,425, DMC첨단산업센터,202005,562,557,1119,37.584503,126.885597
마포구,425, DMC첨단산업센터,202006,708,717,1425,37.584503,126.885597
마포구,426, 서울신용보증재단,201901,251,293,544,37.549061,126.954178
마포구,426, 서울신용보증재단,201902,261,293,554,37.549061,126.954178
마포구,426, 서울신용보증재단,201903,465,584,1049,37.549061,126.954178
마포구,426, 서울신용보증재단,201904,771,913,1684,37.549061,126.954178
마포구,426, 서울신용보증재단,201905,1269,1420,2689,37.549061,126.954178
마포구,426, 서울신용보증재단,201906,1577,1702,3279,37.549061,126.954178
마포구,426, 서울신용보증재단,201907,1376,1512,2888,37.549061,126.954178
마포구,426, 서울신용보증재단,201908,799,995,1794,37.549061,126.954178
마포구,426, 서울신용보증재단,201909,976,1019,1995,37.549061,126.954178
마포구,426, 서울신용보증재단,201910,1506,1565,3071,37.549061,126.954178
마포구,426, 서울신용보증재단,201911,916,1062,1978,37.549061,126.954178
마포구,426, 서울신용보증재단,201912,492,622,1114,37.549061,126.954178
마포구,426, 서울신용보증재단,202001,449,553,1002,37.549061,126.954178
마포구,426, 서울신용보증재단,202002,458,526,984,37.549061,126.954178
마포구,426, 서울신용보증재단,202003,1058,1080,2138,37.549061,126.954178
마포구,426, 서울신용보증재단,202004,1534,1547,3081,37.549061,126.954178
마포구,426, 서울신용보증재단,202005,1873,1895,3768,37.549061,126.954178
마포구,426, 서울신용보증재단,202006,2114,2138,4252,37.549061,126.954178
마포구,427, 성산시영아파트,201901,346,348,694,37.569584,126.903816
마포구,427, 성산시영아파트,201902,286,303,589,37.569584,126.903816
마포구,427, 성산시영아파트,201903,457,470,927,37.569584,126.903816
마포구,427, 성산시영아파트,201904,713,761,1474,37.569584,126.903816
마포구,427, 성산시영아파트,201905,1089,1128,2217,37.569584,126.903816
마포구,427, 성산시영아파트,201906,1256,1241,2497,37.569584,126.903816
마포구,427, 성산시영아파트,201907,1105,1238,2343,37.569584,126.903816
마포구,427, 성산시영아파트,201908,1109,1143,2252,37.569584,126.903816
마포구,427, 성산시영아파트,201909,1002,1045,2047,37.569584,126.903816
마포구,427, 성산시영아파트,201910,1289,1375,2664,37.569584,126.903816
마포구,427, 성산시영아파트,201911,803,910,1713,37.569584,126.903816
마포구,427, 성산시영아파트,201912,521,586,1107,37.569584,126.903816
마포구,427, 성산시영아파트,202001,498,558,1056,37.569584,126.903816
마포구,427, 성산시영아파트,202002,500,558,1058,37.569584,126.903816
마포구,427, 성산시영아파트,202003,1019,1059,2078,37.569584,126.903816
마포구,427, 성산시영아파트,202004,1362,1361,2723,37.569584,126.903816
마포구,427, 성산시영아파트,202005,1594,1596,3190,37.569584,126.903816
마포구,427, 성산시영아파트,202006,1850,1855,3705,37.569584,126.903816
중구,428, 명보사거리,201901,194,183,377,37.5644,126.991432
중구,428, 명보사거리,201902,144,140,284,37.5644,126.991432
중구,428, 명보사거리,201903,291,276,567,37.5644,126.991432
중구,428, 명보사거리,201904,490,440,930,37.5644,126.991432
중구,428, 명보사거리,201905,541,503,1044,37.5644,126.991432
중구,428, 명보사거리,201906,626,557,1183,37.5644,126.991432
중구,428, 명보사거리,201907,621,547,1168,37.5644,126.991432
중구,428, 명보사거리,201908,552,491,1043,37.5644,126.991432
중구,428, 명보사거리,201909,549,519,1068,37.5644,126.991432
중구,428, 명보사거리,201910,621,593,1214,37.5644,126.991432
중구,428, 명보사거리,201911,513,498,1011,37.5644,126.991432
중구,428, 명보사거리,201912,380,321,701,37.5644,126.991432
중구,428, 명보사거리,202001,241,190,431,37.5644,126.991432
중구,428, 명보사거리,202002,295,270,565,37.5644,126.991432
중구,428, 명보사거리,202003,414,387,801,37.5644,126.991432
중구,428, 명보사거리,202004,740,708,1448,37.5644,126.991432
중구,428, 명보사거리,202005,722,710,1432,37.5644,126.991432
중구,428, 명보사거리,202006,812,805,1617,37.5644,126.991432
중구,429, 송도병원,201901,101,48,149,37.549889,127.007347
중구,429, 송도병원,201902,71,20,91,37.549889,127.007347
중구,429, 송도병원,201903,126,74,200,37.549889,127.007347
중구,429, 송도병원,201904,207,93,300,37.549889,127.007347
중구,429, 송도병원,201905,236,152,388,37.549889,127.007347
중구,429, 송도병원,201906,212,163,375,37.549889,127.007347
중구,429, 송도병원,201907,202,168,370,37.549889,127.007347
중구,429, 송도병원,201908,216,149,365,37.549889,127.007347
중구,429, 송도병원,201909,191,148,339,37.549889,127.007347
중구,429, 송도병원,201910,234,169,403,37.549889,127.007347
중구,429, 송도병원,201911,142,93,235,37.549889,127.007347
중구,429, 송도병원,201912,106,36,142,37.549889,127.007347
중구,429, 송도병원,202001,116,41,157,37.549889,127.007347
중구,429, 송도병원,202002,81,31,112,37.549889,127.007347
중구,429, 송도병원,202003,156,143,299,37.549889,127.007347
중구,429, 송도병원,202004,199,171,370,37.549889,127.007347
중구,429, 송도병원,202005,233,199,432,37.549889,127.007347
중구,429, 송도병원,202006,156,144,300,37.549889,127.007347
중구,430, KEB하나은행 장충동지점,201901,181,169,350,37.562172,127.006264
중구,430, KEB하나은행 장충동지점,201902,155,132,287,37.562172,127.006264
중구,430, KEB하나은행 장충동지점,201903,291,263,554,37.562172,127.006264
중구,430, KEB하나은행 장충동지점,201904,405,372,777,37.562172,127.006264
중구,430, KEB하나은행 장충동지점,201905,583,558,1141,37.562172,127.006264
중구,430, KEB하나은행 장충동지점,201906,541,527,1068,37.562172,127.006264
중구,430, KEB하나은행 장충동지점,201907,657,600,1257,37.562172,127.006264
중구,430, KEB하나은행 장충동지점,201908,555,547,1102,37.562172,127.006264
중구,430, KEB하나은행 장충동지점,201909,503,489,992,37.562172,127.006264
중구,430, KEB하나은행 장충동지점,201910,656,623,1279,37.562172,127.006264
중구,430, KEB하나은행 장충동지점,201911,497,494,991,37.562172,127.006264
중구,430, KEB하나은행 장충동지점,201912,291,301,592,37.562172,127.006264
중구,430, KEB하나은행 장충동지점,202001,236,241,477,37.562172,127.006264
중구,430, KEB하나은행 장충동지점,202002,269,251,520,37.562172,127.006264
중구,430, KEB하나은행 장충동지점,202003,461,448,909,37.562172,127.006264
중구,430, KEB하나은행 장충동지점,202004,560,552,1112,37.562172,127.006264
중구,430, KEB하나은행 장충동지점,202005,533,532,1065,37.562172,127.006264
중구,430, KEB하나은행 장충동지점,202006,829,828,1657,37.562172,127.006264
중구,431, 청계천 영도교,201901,847,829,1676,37.5709,127.019524
중구,431, 청계천 영도교,201902,746,698,1444,37.5709,127.019524
중구,431, 청계천 영도교,201903,1212,1160,2372,37.5709,127.019524
중구,431, 청계천 영도교,201904,1497,1410,2907,37.5709,127.019524
중구,431, 청계천 영도교,201905,2127,1980,4107,37.5709,127.019524
중구,431, 청계천 영도교,201906,2231,2039,4270,37.5709,127.019524
중구,431, 청계천 영도교,201907,2511,2343,4854,37.5709,127.019524
중구,431, 청계천 영도교,201908,2492,2358,4850,37.5709,127.019524
중구,431, 청계천 영도교,201909,2415,2269,4684,37.5709,127.019524
중구,431, 청계천 영도교,201910,2728,2693,5421,37.5709,127.019524
중구,431, 청계천 영도교,201911,2094,2018,4112,37.5709,127.019524
중구,431, 청계천 영도교,201912,1408,1387,2795,37.5709,127.019524
중구,431, 청계천 영도교,202001,1241,1201,2442,37.5709,127.019524
중구,431, 청계천 영도교,202002,1160,1073,2233,37.5709,127.019524
중구,431, 청계천 영도교,202003,1816,1663,3479,37.5709,127.019524
중구,431, 청계천 영도교,202004,2389,2182,4571,37.5709,127.019524
중구,431, 청계천 영도교,202005,2298,2156,4454,37.5709,127.019524
중구,431, 청계천 영도교,202006,2511,2350,4861,37.5709,127.019524
마포구,432, 마포중앙도서관,201901,346,254,600,37.563339,126.908203
마포구,432, 마포중앙도서관,201902,290,212,502,37.563339,126.908203
마포구,432, 마포중앙도서관,201903,573,455,1028,37.563339,126.908203
마포구,432, 마포중앙도서관,201904,763,621,1384,37.563339,126.908203
마포구,432, 마포중앙도서관,201905,915,762,1677,37.563339,126.908203
마포구,432, 마포중앙도서관,201906,1131,976,2107,37.563339,126.908203
마포구,432, 마포중앙도서관,201907,962,860,1822,37.563339,126.908203
마포구,432, 마포중앙도서관,201908,941,864,1805,37.563339,126.908203
마포구,432, 마포중앙도서관,201909,783,726,1509,37.563339,126.908203
마포구,432, 마포중앙도서관,201910,1100,1063,2163,37.563339,126.908203
마포구,432, 마포중앙도서관,201911,734,617,1351,37.563339,126.908203
마포구,432, 마포중앙도서관,201912,573,447,1020,37.563339,126.908203
마포구,432, 마포중앙도서관,202001,577,484,1061,37.563339,126.908203
마포구,432, 마포중앙도서관,202002,491,410,901,37.563339,126.908203
마포구,432, 마포중앙도서관,202003,373,260,633,37.563339,126.908203
마포구,432, 마포중앙도서관,202004,386,362,748,37.563339,126.908203
마포구,432, 마포중앙도서관,202005,534,471,1005,37.563339,126.908203
마포구,432, 마포중앙도서관,202006,545,424,969,37.563339,126.908203
중구,433, 을지로입구역 2번출구,201901,326,389,715,37.566345,126.982292
중구,433, 을지로입구역 2번출구,201902,365,369,734,37.566345,126.982292
중구,433, 을지로입구역 2번출구,201903,740,750,1490,37.566345,126.982292
중구,433, 을지로입구역 2번출구,201904,1202,1197,2399,37.566345,126.982292
중구,433, 을지로입구역 2번출구,201905,1481,1477,2958,37.566345,126.982292
중구,433, 을지로입구역 2번출구,201906,1729,1714,3443,37.566345,126.982292
중구,433, 을지로입구역 2번출구,201907,1444,1419,2863,37.566345,126.982292
중구,433, 을지로입구역 2번출구,201908,1406,1390,2796,37.566345,126.982292
중구,433, 을지로입구역 2번출구,201909,1486,1482,2968,37.566345,126.982292
중구,433, 을지로입구역 2번출구,201910,1875,1868,3743,37.566345,126.982292
중구,433, 을지로입구역 2번출구,201911,1340,1367,2707,37.566345,126.982292
중구,433, 을지로입구역 2번출구,201912,801,854,1655,37.566345,126.982292
중구,433, 을지로입구역 2번출구,202001,697,755,1452,37.566345,126.982292
중구,433, 을지로입구역 2번출구,202002,641,634,1275,37.566345,126.982292
중구,433, 을지로입구역 2번출구,202003,888,883,1771,37.566345,126.982292
중구,433, 을지로입구역 2번출구,202004,1239,1229,2468,37.566345,126.982292
중구,433, 을지로입구역 2번출구,202005,1453,1415,2868,37.566345,126.982292
중구,433, 을지로입구역 2번출구,202006,1485,1459,2944,37.566345,126.982292
중구,434, 신당 레미안 버스정류장,201901,121,13,134,37.561489,127.023933
중구,434, 신당 레미안 버스정류장,201902,103,14,117,37.561489,127.023933
중구,434, 신당 레미안 버스정류장,201903,192,27,219,37.561489,127.023933
중구,434, 신당 레미안 버스정류장,201904,261,54,315,37.561489,127.023933
중구,434, 신당 레미안 버스정류장,201905,172,43,215,37.561489,127.023933
중구,434, 신당 래미안 버스정류장,201906,238,42,280,37.561489,127.023933
중구,434, 신당 래미안 버스정류장,201907,350,60,410,37.561489,127.023933
중구,434, 신당 래미안 버스정류장,201908,323,55,378,37.561489,127.023933
중구,434, 신당 래미안 버스정류장,201909,248,67,315,37.561489,127.023933
중구,434, 신당 래미안 버스정류장,201910,305,62,367,37.561489,127.023933
중구,434, 신당 래미안 버스정류장,201911,224,25,249,37.561489,127.023933
중구,434, 신당 래미안 버스정류장,201912,216,21,237,37.561489,127.023933
중구,434, 신당 래미안 버스정류장,202001,253,11,264,37.561489,127.023933
중구,434, 신당 래미안 버스정류장,202002,167,17,184,37.561489,127.023933
중구,434, 신당 래미안 버스정류장,202003,168,22,190,37.561489,127.023933
중구,434, 신당 래미안 버스정류장,202004,178,52,230,37.561489,127.023933
중구,434, 신당 래미안 버스정류장,202005,129,57,186,37.561489,127.023933
중구,434, 신당 래미안 버스정류장,202006,79,42,121,37.561489,127.023933
중구,435, SK 남산빌딩,201901,126,95,221,37.556862,126.975616
중구,435, SK 남산빌딩,201902,121,98,219,37.556862,126.975616
중구,435, SK 남산빌딩,201903,217,195,412,37.556862,126.975616
중구,435, SK 남산빌딩,201904,352,317,669,37.556862,126.975616
중구,435, SK 남산빌딩,201905,511,511,1022,37.556862,126.975616
중구,435, SK 남산빌딩,201906,432,422,854,37.556862,126.975616
중구,435, SK 남산빌딩,201907,385,372,757,37.556862,126.975616
중구,435, SK 남산빌딩,201908,409,409,818,37.556862,126.975616
중구,435, SK 남산빌딩,201909,411,390,801,37.556862,126.975616
중구,435, SK 남산빌딩,201910,535,534,1069,37.556862,126.975616
중구,435, SK 남산빌딩,201911,401,361,762,37.556862,126.975616
중구,435, SK 남산빌딩,201912,227,188,415,37.556862,126.975616
중구,435, SK 남산빌딩,202001,216,155,371,37.556862,126.975616
중구,435, SK 남산빌딩,202002,171,135,306,37.556862,126.975616
중구,435, SK 남산빌딩,202003,234,221,455,37.556862,126.975616
중구,435, SK 남산빌딩,202004,404,386,790,37.556862,126.975616
중구,435, SK 남산빌딩,202005,436,437,873,37.556862,126.975616
중구,435, SK 남산빌딩,202006,447,434,881,37.556862,126.975616
마포구,436, 이대역 5번출구,201901,300,62,362,37.556591,126.94619
마포구,436, 이대역 5번출구,201902,280,64,344,37.556591,126.94619
마포구,436, 이대역 5번출구,201903,569,201,770,37.556591,126.94619
마포구,436, 이대역 5번출구,201904,802,273,1075,37.556591,126.94619
마포구,436, 이대역 5번출구,201905,869,381,1250,37.556591,126.94619
마포구,436, 이대역 5번출구,201906,726,309,1035,37.556591,126.94619
마포구,436, 이대역 5번출구,201907,537,254,791,37.556591,126.94619
마포구,436, 이대역 5번출구,201908,478,242,720,37.556591,126.94619
마포구,436, 이대역 5번출구,201909,459,305,764,37.556591,126.94619
마포구,436, 이대역 5번출구,201910,448,332,780,37.556591,126.94619
마포구,436, 이대역 5번출구,201911,471,174,645,37.556591,126.94619
마포구,436, 이대역 5번출구,201912,329,106,435,37.556591,126.94619
마포구,436, 이대역 5번출구,202001,338,98,436,37.556591,126.94619
마포구,436, 이대역 5번출구,202002,220,85,305,37.556591,126.94619
마포구,436, 이대역 5번출구,202003,363,189,552,37.556591,126.94619
마포구,436, 이대역 5번출구,202004,371,285,656,37.556591,126.94619
마포구,436, 이대역 5번출구,202005,340,291,631,37.556591,126.94619
마포구,436, 이대역 5번출구,202006,299,210,509,37.556591,126.94619
마포구,437, 대흥역 1번출구,201901,217,199,416,37.54821,126.941383
마포구,437, 대흥역 1번출구,201902,250,232,482,37.54821,126.941383
마포구,437, 대흥역 1번출구,201903,530,537,1067,37.54821,126.941383
마포구,437, 대흥역 1번출구,201904,891,907,1798,37.54821,126.941383
마포구,437, 대흥역 1번출구,201905,1311,1268,2579,37.54821,126.941383
마포구,437, 대흥역 1번출구,201906,1351,1321,2672,37.54821,126.941383
마포구,437, 대흥역 1번출구,201907,1354,1251,2605,37.54821,126.941383
마포구,437, 대흥역 1번출구,201908,1272,1221,2493,37.54821,126.941383
마포구,437, 대흥역 1번출구,201909,1169,1153,2322,37.54821,126.941383
마포구,437, 대흥역 1번출구,201910,1363,1317,2680,37.54821,126.941383
마포구,437, 대흥역 1번출구,201911,847,896,1743,37.54821,126.941383
마포구,437, 대흥역 1번출구,201912,526,613,1139,37.54821,126.941383
마포구,437, 대흥역 1번출구,202001,405,497,902,37.54821,126.941383
마포구,437, 대흥역 1번출구,202002,427,471,898,37.54821,126.941383
마포구,437, 대흥역 1번출구,202003,925,934,1859,37.54821,126.941383
마포구,437, 대흥역 1번출구,202004,1191,1155,2346,37.54821,126.941383
마포구,437, 대흥역 1번출구,202005,1375,1369,2744,37.54821,126.941383
마포구,437, 대흥역 1번출구,202006,1474,1447,2921,37.54821,126.941383
마포구,438, 성산2-1 공영주차장,201901,418,406,824,37.56472,126.906769
마포구,438, 성산2-1 공영주차장,201902,373,371,744,37.56472,126.906769
마포구,438, 성산2-1 공영주차장,201903,796,717,1513,37.56472,126.906769
마포구,438, 성산2-1 공영주차장,201904,1198,1234,2432,37.56472,126.906769
마포구,438, 성산2-1 공영주차장,201905,1855,1848,3703,37.56472,126.906769
마포구,438, 성산2-1 공영주차장,201906,2235,2190,4425,37.56472,126.906769
마포구,438, 성산2-1 공영주차장,201907,2080,2074,4154,37.56472,126.906769
마포구,438, 성산2-1 공영주차장,201908,2209,2284,4493,37.56472,126.906769
마포구,438, 성산2-1 공영주차장,201909,2195,2188,4383,37.56472,126.906769
마포구,438, 성산2-1 공영주차장,201910,2835,2845,5680,37.56472,126.906769
마포구,438, 성산2-1 공영주차장,201911,1732,1683,3415,37.56472,126.906769
마포구,438, 성산2-1 공영주차장,201912,924,965,1889,37.56472,126.906769
마포구,438, 성산2-1 공영주차장,202001,824,831,1655,37.56472,126.906769
마포구,438, 성산2-1 공영주차장,202002,900,893,1793,37.56472,126.906769
마포구,438, 성산2-1 공영주차장,202003,1879,1809,3688,37.56472,126.906769
마포구,438, 성산2-1 공영주차장,202004,2401,2381,4782,37.56472,126.906769
마포구,438, 성산2-1 공영주차장,202005,2618,2605,5223,37.56472,126.906769
마포구,438, 성산2-1 공영주차장,202006,2620,2582,5202,37.56472,126.906769
마포구,439, 마포어린이공원,201901,277,299,576,37.535751,126.944038
마포구,439, 마포어린이공원,201902,248,294,542,37.535751,126.944038
마포구,439, 마포어린이공원,201903,504,577,1081,37.535751,126.944038
마포구,439, 마포어린이공원,201904,937,998,1935,37.535751,126.944038
마포구,439, 마포어린이공원,201905,1735,1833,3568,37.535751,126.944038
마포구,439, 마포어린이공원,201906,1843,1972,3815,37.535751,126.944038
마포구,439, 마포어린이공원,201907,1831,2016,3847,37.535751,126.944038
마포구,439, 마포어린이공원,201908,1857,2007,3864,37.535751,126.944038
마포구,439, 마포어린이공원,201909,1930,2109,4039,37.535751,126.944038
마포구,439, 마포어린이공원,201910,2179,2350,4529,37.535751,126.944038
마포구,439, 마포어린이공원,201911,1368,1447,2815,37.535751,126.944038
마포구,439, 마포어린이공원,201912,749,768,1517,37.535751,126.944038
마포구,439, 마포어린이공원,202001,673,699,1372,37.535751,126.944038
마포구,439, 마포어린이공원,202002,747,780,1527,37.535751,126.944038
마포구,439, 마포어린이공원,202003,2006,2120,4126,37.535751,126.944038
마포구,439, 마포어린이공원,202004,2701,2824,5525,37.535751,126.944038
마포구,439, 마포어린이공원,202005,2954,3061,6015,37.535751,126.944038
마포구,439, 마포어린이공원,202006,2973,3124,6097,37.535751,126.944038
마포구,440, 하늘공원 입구,201908,734,878,1612,37.570006,126.881149
마포구,440, 하늘공원 입구,201909,966,1047,2013,37.570006,126.881149
마포구,440, 하늘공원 입구,201910,2068,2309,4377,37.570006,126.881149
마포구,440, 하늘공원 입구,201911,521,576,1097,37.570006,126.881149
마포구,440, 하늘공원 입구,201912,152,131,283,37.570006,126.881149
마포구,440, 하늘공원 입구,202001,157,142,299,37.570006,126.881149
마포구,440, 하늘공원 입구,202002,214,224,438,37.570006,126.881149
마포구,440, 하늘공원 입구,202003,1230,1298,2528,37.570006,126.881149
마포구,440, 하늘공원 입구,202004,1684,1714,3398,37.570006,126.881149
마포구,440, 하늘공원 입구,202005,1958,2089,4047,37.570006,126.881149
마포구,440, 하늘공원 입구,202006,1341,1353,2694,37.570006,126.881149
중구,441,염천교사거리,202002,1,1,2,37.559891,126.97068
중구,441,염천교사거리,202003,86,55,141,37.559891,126.97068
중구,441,염천교사거리,202004,130,110,240,37.559891,126.97068
중구,441,염천교사거리,202005,164,165,329,37.559891,126.97068
중구,441,염천교사거리,202006,227,201,428,37.559891,126.97068
중구,442,서울역 서부,202003,1,1,2,37.553692,126.97216
중구,442,서울역 서부,202004,5,5,10,37.553692,126.97216
중구,442,서울역 서부,202006,171,129,300,37.553692,126.97216
중구,443,호암아트홀,202002,2,2,4,37.562111,126.970718
중구,443,호암아트홀,202003,93,75,168,37.562111,126.970718
중구,443,호암아트홀,202004,232,185,417,37.562111,126.970718
중구,443,호암아트홀,202005,323,301,624,37.562111,126.970718
중구,443,호암아트홀,202006,389,374,763,37.562111,126.970718
중구,444,서울역3번 출구,202003,1,1,2,37.557602,126.97258
중구,444,서울역3번 출구,202004,1,0,1,37.557602,126.97258
중구,444,서울역3번 출구,202006,46,45,91,37.557602,126.97258
중구,445,대한상공회의소,202002,1,0,1,37.560291,126.974548
중구,445,대한상공회의소,202003,98,78,176,37.560291,126.974548
중구,445,대한상공회의소,202004,315,306,621,37.560291,126.974548
중구,445,대한상공회의소,202005,448,442,890,37.560291,126.974548
중구,445,대한상공회의소,202006,651,636,1287,37.560291,126.974548
종로구,446, 상명대입구,201901,167,140,307,37.600128,126.957832
종로구,446, 상명대입구,201902,174,143,317,37.600128,126.957832
종로구,446, 상명대입구,201903,329,287,616,37.600128,126.957832
종로구,446, 상명대입구,201904,501,480,981,37.600128,126.957832
종로구,446, 상명대입구,201905,603,610,1213,37.600128,126.957832
종로구,446, 상명대입구,201906,533,523,1056,37.600128,126.957832
종로구,446, 상명대입구,201907,627,633,1260,37.600128,126.957832
종로구,446, 상명대입구,201908,531,571,1102,37.600128,126.957832
종로구,446, 상명대입구,201909,548,549,1097,37.600128,126.957832
종로구,446, 상명대입구,201910,604,604,1208,37.600128,126.957832
종로구,446, 상명대입구,201911,416,412,828,37.600128,126.957832
종로구,446, 상명대입구,201912,199,195,394,37.600128,126.957832
종로구,446, 상명대입구,202001,238,217,455,37.600128,126.957832
종로구,446, 상명대입구,202002,201,175,376,37.600128,126.957832
종로구,446, 상명대입구,202003,427,424,851,37.600128,126.957832
종로구,446, 상명대입구,202004,785,756,1541,37.600128,126.957832
종로구,446, 상명대입구,202005,789,746,1535,37.600128,126.957832
종로구,446, 상명대입구,202006,796,772,1568,37.600128,126.957832
종로구,447, 신영동삼거리,201901,63,28,91,37.603992,126.961945
종로구,447, 신영동삼거리,201902,51,34,85,37.603992,126.961945
종로구,447, 신영동삼거리,201903,99,64,163,37.603992,126.961945
종로구,447, 신영동삼거리,201904,136,102,238,37.603992,126.961945
종로구,447, 신영동삼거리,201905,146,128,274,37.603992,126.961945
종로구,447, 신영동삼거리,201906,168,136,304,37.603992,126.961945
종로구,447, 신영동삼거리,201907,217,112,329,37.603992,126.961945
종로구,447, 신영동삼거리,201908,186,93,279,37.603992,126.961945
종로구,447, 신영동삼거리,201909,144,81,225,37.603992,126.961945
종로구,447, 신영동삼거리,201910,145,86,231,37.603992,126.961945
종로구,447, 신영동삼거리,201911,158,108,266,37.603992,126.961945
종로구,447, 신영동삼거리,201912,104,69,173,37.603992,126.961945
종로구,447, 신영동삼거리,202001,95,65,160,37.603992,126.961945
종로구,447, 신영동삼거리,202002,56,48,104,37.603992,126.961945
종로구,447, 신영동삼거리,202003,71,64,135,37.603992,126.961945
종로구,447, 신영동삼거리,202004,1,1,2,37.603992,126.961945
종로구,449, 일성아파트,201901,56,15,71,37.608719,126.972862
종로구,449, 일성아파트,201902,39,16,55,37.608719,126.972862
종로구,449, 일성아파트,201903,80,35,115,37.608719,126.972862
종로구,449, 일성아파트,201904,128,61,189,37.608719,126.972862
종로구,449, 일성아파트,201905,112,80,192,37.608719,126.972862
종로구,449, 일성아파트,201906,62,54,116,37.608719,126.972862
종로구,449, 일성아파트,201907,88,53,141,37.608719,126.972862
종로구,449, 일성아파트,201908,98,47,145,37.608719,126.972862
종로구,449, 일성아파트,201909,68,60,128,37.608719,126.972862
종로구,449, 일성아파트,201910,102,90,192,37.608719,126.972862
종로구,449, 일성아파트,201911,88,61,149,37.608719,126.972862
종로구,449, 일성아파트,201912,104,43,147,37.608719,126.972862
종로구,449, 일성아파트,202001,97,56,153,37.608719,126.972862
종로구,449, 일성아파트,202002,103,47,150,37.608719,126.972862
종로구,449, 일성아파트,202003,159,89,248,37.608719,126.972862
종로구,449, 일성아파트,202004,210,109,319,37.608719,126.972862
종로구,449, 일성아파트,202005,200,124,324,37.608719,126.972862
종로구,449, 일성아파트,202006,259,143,402,37.608719,126.972862
종로구,450, 효자동 삼거리,201901,248,216,464,37.583603,126.972549
종로구,450, 효자동 삼거리,201902,256,188,444,37.583603,126.972549
종로구,450, 효자동 삼거리,201903,570,446,1016,37.583603,126.972549
종로구,450, 효자동 삼거리,201904,838,722,1560,37.583603,126.972549
종로구,450, 효자동 삼거리,201905,912,853,1765,37.583603,126.972549
종로구,450, 효자동 삼거리,201906,985,909,1894,37.583603,126.972549
종로구,450, 효자동 삼거리,201907,918,816,1734,37.583603,126.972549
종로구,450, 효자동 삼거리,201908,729,693,1422,37.583603,126.972549
종로구,450, 효자동 삼거리,201909,1021,937,1958,37.583603,126.972549
종로구,450, 효자동 삼거리,201910,1142,1073,2215,37.583603,126.972549
종로구,450, 효자동 삼거리,201911,870,757,1627,37.583603,126.972549
종로구,450, 효자동 삼거리,201912,468,383,851,37.583603,126.972549
종로구,450, 효자동 삼거리,202001,462,379,841,37.583603,126.972549
종로구,450, 효자동 삼거리,202002,445,315,760,37.583603,126.972549
종로구,450, 효자동 삼거리,202003,662,511,1173,37.583603,126.972549
종로구,450, 효자동 삼거리,202004,1054,813,1867,37.583603,126.972549
종로구,450, 효자동 삼거리,202005,1027,844,1871,37.583603,126.972549
종로구,450, 효자동 삼거리,202006,566,504,1070,37.583603,126.972549
종로구,451, 청와대앞길,201901,274,169,443,37.583515,126.979668
종로구,451, 청와대앞길,201902,256,157,413,37.583515,126.979668
종로구,451, 청와대앞길,201903,348,252,600,37.583515,126.979668
종로구,451, 청와대앞길,201904,576,381,957,37.583515,126.979668
종로구,451, 청와대앞길,201905,591,421,1012,37.583515,126.979668
종로구,451, 청와대앞길,201906,508,339,847,37.583515,126.979668
종로구,451, 청와대앞길,201907,478,325,803,37.583515,126.979668
종로구,451, 청와대앞길,201908,388,272,660,37.583515,126.979668
종로구,451, 청와대앞길,201909,322,188,510,37.583515,126.979668
종로구,451, 청와대앞길,201910,319,248,567,37.583515,126.979668
종로구,451, 청와대앞길,201911,310,196,506,37.583515,126.979668
종로구,451, 청와대앞길,201912,255,141,396,37.583515,126.979668
종로구,451, 청와대앞길,202001,197,96,293,37.583515,126.979668
종로구,451, 청와대앞길,202002,148,91,239,37.583515,126.979668
종로구,451, 청와대앞길,202003,297,162,459,37.583515,126.979668
종로구,451, 청와대앞길,202004,370,186,556,37.583515,126.979668
종로구,451, 청와대앞길,202005,279,173,452,37.583515,126.979668
종로구,451, 청와대앞길,202006,250,157,407,37.583515,126.979668
종로구,452, 동대문 종합시장 버스정류장,201901,214,220,434,37.571239,127.00441
종로구,452, 동대문 종합시장 버스정류장,201902,198,188,386,37.571239,127.00441
종로구,452, 동대문 종합시장 버스정류장,201903,366,386,752,37.571239,127.00441
종로구,452, 동대문 종합시장 버스정류장,201904,533,520,1053,37.571239,127.00441
종로구,452, 동대문 종합시장 버스정류장,201905,723,642,1365,37.571239,127.00441
종로구,452, 동대문 종합시장 버스정류장,201906,664,634,1298,37.571239,127.00441
종로구,452, 동대문 종합시장 버스정류장,201907,748,638,1386,37.571239,127.00441
종로구,452, 동대문 종합시장 버스정류장,201908,691,611,1302,37.571239,127.00441
종로구,452, 동대문 종합시장 버스정류장,201909,787,712,1499,37.571239,127.00441
종로구,452, 동대문 종합시장 버스정류장,201910,882,837,1719,37.571239,127.00441
종로구,452, 동대문 종합시장 버스정류장,201911,831,810,1641,37.571239,127.00441
종로구,452, 동대문 종합시장 버스정류장,201912,497,487,984,37.571239,127.00441
종로구,452, 동대문 종합시장 버스정류장,202001,409,420,829,37.571239,127.00441
종로구,452, 동대문 종합시장 버스정류장,202002,363,360,723,37.571239,127.00441
종로구,452, 동대문 종합시장 버스정류장,202003,550,522,1072,37.571239,127.00441
종로구,452, 동대문 종합시장 버스정류장,202004,774,698,1472,37.571239,127.00441
종로구,452, 동대문 종합시장 버스정류장,202005,699,654,1353,37.571239,127.00441
종로구,452, 동대문 종합시장 버스정류장,202006,765,669,1434,37.571239,127.00441
종로구,453, 종로오가 지하쇼핑센터 14번출구,201901,394,399,793,37.57114,127.000671
종로구,453, 종로오가 지하쇼핑센터 14번출구,201902,352,347,699,37.57114,127.000671
종로구,453, 종로오가 지하쇼핑센터 14번출구,201903,576,624,1200,37.57114,127.000671
종로구,453, 종로오가 지하쇼핑센터 14번출구,201904,867,893,1760,37.57114,127.000671
종로구,453, 종로오가 지하쇼핑센터 14번출구,201905,1172,1103,2275,37.57114,127.000671
종로구,453, 종로오가 지하쇼핑센터 14번출구,201906,1119,1072,2191,37.57114,127.000671
종로구,453, 종로오가 지하쇼핑센터 14번출구,201907,1201,1098,2299,37.57114,127.000671
종로구,453, 종로오가 지하쇼핑센터 14번출구,201908,1033,923,1956,37.57114,127.000671
종로구,453, 종로오가 지하쇼핑센터 14번출구,201909,1143,1077,2220,37.57114,127.000671
종로구,453, 종로오가 지하쇼핑센터 14번출구,201910,1553,1480,3033,37.57114,127.000671
종로구,453, 종로오가 지하쇼핑센터 14번출구,201911,1089,1074,2163,37.57114,127.000671
종로구,453, 종로오가 지하쇼핑센터 14번출구,201912,711,728,1439,37.57114,127.000671
종로구,453, 종로오가 지하쇼핑센터 14번출구,202001,597,690,1287,37.57114,127.000671
종로구,453, 종로오가 지하쇼핑센터 14번출구,202002,584,602,1186,37.57114,127.000671
종로구,453, 종로오가 지하쇼핑센터 14번출구,202003,893,872,1765,37.57114,127.000671
종로구,453, 종로오가 지하쇼핑센터 14번출구,202004,1226,1130,2356,37.57114,127.000671
종로구,453, 종로오가 지하쇼핑센터 14번출구,202005,1145,1124,2269,37.57114,127.000671
종로구,453, 종로오가 지하쇼핑센터 14번출구,202006,1229,1180,2409,37.57114,127.000671
종로구,454, 종로2가 버스정류장 (종각방향),201901,391,369,760,37.570358,126.986382
종로구,454, 종로2가 버스정류장 (종각방향),201902,357,356,713,37.570358,126.986382
종로구,454, 종로2가 버스정류장 (종각방향),201903,728,711,1439,37.570358,126.986382
종로구,454, 종로2가 버스정류장 (종각방향),201904,1135,1084,2219,37.570358,126.986382
종로구,454, 종로2가 버스정류장 (종각방향),201905,1315,1276,2591,37.570358,126.986382
종로구,454, 종로2가 버스정류장 (종각방향),201906,1269,1246,2515,37.570358,126.986382
종로구,454, 종로2가 버스정류장 (종각방향),201907,1287,1231,2518,37.570358,126.986382
종로구,454, 종로2가 버스정류장 (종각방향),201908,1136,1119,2255,37.570358,126.986382
종로구,454, 종로2가 버스정류장 (종각방향),201909,1168,1165,2333,37.570358,126.986382
종로구,454, 종로2가 버스정류장 (종각방향),201910,1263,1262,2525,37.570358,126.986382
종로구,454, 종로2가 버스정류장 (종각방향),201911,1128,1120,2248,37.570358,126.986382
종로구,454, 종로2가 버스정류장 (종각방향),201912,704,681,1385,37.570358,126.986382
종로구,454, 종로2가 버스정류장 (종각방향),202001,594,605,1199,37.570358,126.986382
종로구,454, 종로2가 버스정류장 (종각방향),202002,547,540,1087,37.570358,126.986382
종로구,454, 종로2가 버스정류장 (종각방향),202003,754,756,1510,37.570358,126.986382
종로구,454, 종로2가 버스정류장 (종각방향),202004,1188,1181,2369,37.570358,126.986382
종로구,454, 종로2가 버스정류장 (종각방향),202005,1185,1171,2356,37.570358,126.986382
종로구,454, 종로2가 버스정류장 (종각방향),202006,1286,1253,2539,37.570358,126.986382
종로구,455, 삼익한의원,201901,173,187,360,37.570961,127.006058
종로구,455, 삼익한의원,201902,175,184,359,37.570961,127.006058
종로구,455, 삼익한의원,201903,277,289,566,37.570961,127.006058
종로구,455, 삼익한의원,201904,435,399,834,37.570961,127.006058
종로구,455, 삼익한의원,201905,676,614,1290,37.570961,127.006058
종로구,455, 삼익한의원,201906,596,567,1163,37.570961,127.006058
종로구,455, 삼익한의원,201907,607,556,1163,37.570961,127.006058
종로구,455, 삼익한의원,201908,522,480,1002,37.570961,127.006058
종로구,455, 삼익한의원,201909,601,571,1172,37.570961,127.006058
종로구,455, 삼익한의원,201910,818,795,1613,37.570961,127.006058
종로구,455, 삼익한의원,201911,560,587,1147,37.570961,127.006058
종로구,455, 삼익한의원,201912,372,367,739,37.570961,127.006058
종로구,455, 삼익한의원,202001,269,258,527,37.570961,127.006058
종로구,455, 삼익한의원,202002,290,284,574,37.570961,127.006058
종로구,455, 삼익한의원,202003,448,434,882,37.570961,127.006058
종로구,455, 삼익한의원,202004,707,675,1382,37.570961,127.006058
종로구,455, 삼익한의원,202005,672,669,1341,37.570961,127.006058
종로구,455, 삼익한의원,202006,755,716,1471,37.570961,127.006058
종로구,456, 숭인2동 주민센터 입구 (이강3대냉면),201901,275,293,568,37.574471,127.019829
종로구,456, 숭인2동 주민센터 입구 (이강3대냉면),201902,269,290,559,37.574471,127.019829
종로구,456, 숭인2동 주민센터 입구 (이강3대냉면),201903,504,494,998,37.574471,127.019829
종로구,456, 숭인2동 주민센터 입구 (이강3대냉면),201904,651,627,1278,37.574471,127.019829
종로구,456, 숭인2동 주민센터 입구 (이강3대냉면),201905,912,863,1775,37.574471,127.019829
종로구,456, 숭인2동 주민센터 입구 (이강3대냉면),201906,834,773,1607,37.574471,127.019829
종로구,456, 숭인2동 주민센터 입구 (이강3대냉면),201907,871,860,1731,37.574471,127.019829
종로구,456, 숭인2동 주민센터 입구 (이강3대냉면),201908,942,953,1895,37.574471,127.019829
종로구,456, 숭인2동 주민센터 입구 (이강3대냉면),201909,777,777,1554,37.574471,127.019829
종로구,456, 숭인2동 주민센터 입구 (이강3대냉면),201910,1056,1040,2096,37.574471,127.019829
종로구,456, 숭인2동 주민센터 입구 (이강3대냉면),201911,800,817,1617,37.574471,127.019829
종로구,456, 숭인2동 주민센터 입구 (이강3대냉면),201912,494,518,1012,37.574471,127.019829
종로구,456, 숭인2동 주민센터 입구 (이강3대냉면),202001,437,441,878,37.574471,127.019829
종로구,456, 숭인2동 주민센터 입구 (이강3대냉면),202002,434,473,907,37.574471,127.019829
종로구,456, 숭인2동 주민센터 입구 (이강3대냉면),202003,880,894,1774,37.574471,127.019829
종로구,456, 숭인2동 주민센터 입구 (이강3대냉면),202004,899,885,1784,37.574471,127.019829
종로구,456, 숭인2동 주민센터 입구 (이강3대냉면),202005,874,862,1736,37.574471,127.019829
종로구,456, 숭인2동 주민센터 입구 (이강3대냉면),202006,981,981,1962,37.574471,127.019829
종로구,457, 종로꽃시장 입구 옆,201901,305,303,608,37.57132,127.00721
종로구,457, 종로꽃시장 입구 옆,201902,268,262,530,37.57132,127.00721
종로구,457, 종로꽃시장 입구 옆,201903,496,530,1026,37.57132,127.00721
종로구,457, 종로꽃시장 입구 옆,201904,622,607,1229,37.57132,127.00721
종로구,457, 종로꽃시장 입구 옆,201905,975,922,1897,37.57132,127.00721
종로구,457, 종로꽃시장 입구 옆,201906,892,871,1763,37.57132,127.00721
종로구,457, 종로꽃시장 입구 옆,201907,924,856,1780,37.57132,127.00721
종로구,457, 종로꽃시장 입구 옆,201908,749,715,1464,37.57132,127.00721
종로구,457, 종로꽃시장 입구 옆,201909,756,731,1487,37.57132,127.00721
종로구,457, 종로꽃시장 입구 옆,201910,936,914,1850,37.57132,127.00721
종로구,457, 종로꽃시장 입구 옆,201911,713,729,1442,37.57132,127.00721
종로구,457, 종로꽃시장 입구 옆,201912,430,426,856,37.57132,127.00721
종로구,457, 종로꽃시장 입구 옆,202001,406,418,824,37.57132,127.00721
종로구,457, 종로꽃시장 입구 옆,202002,415,402,817,37.57132,127.00721
종로구,457, 종로꽃시장 입구 옆,202003,649,630,1279,37.57132,127.00721
종로구,457, 종로꽃시장 입구 옆,202004,870,814,1684,37.57132,127.00721
종로구,457, 종로꽃시장 입구 옆,202005,710,701,1411,37.57132,127.00721
종로구,457, 종로꽃시장 입구 옆,202006,848,838,1686,37.57132,127.00721
종로구,458, 광화문역 5번출구,201901,439,431,870,37.569939,126.977539
종로구,458, 광화문역 5번출구,201902,383,382,765,37.569939,126.977539
종로구,458, 광화문역 5번출구,201903,685,659,1344,37.569939,126.977539
종로구,458, 광화문역 5번출구,201904,1178,1070,2248,37.569939,126.977539
종로구,458, 광화문역 5번출구,201905,1358,1321,2679,37.569939,126.977539
종로구,458, 광화문역 5번출구,201906,1524,1446,2970,37.569939,126.977539
종로구,458, 광화문역 5번출구,201907,1259,1240,2499,37.569939,126.977539
종로구,458, 광화문역 5번출구,201908,1285,1231,2516,37.569939,126.977539
종로구,458, 광화문역 5번출구,201909,1696,1451,3147,37.569939,126.977539
종로구,458, 광화문역 5번출구,201910,2019,1723,3742,37.569939,126.977539
종로구,458, 광화문역 5번출구,201911,1652,1341,2993,37.569939,126.977539
종로구,458, 광화문역 5번출구,201912,861,884,1745,37.569939,126.977539
종로구,458, 광화문역 5번출구,202001,707,649,1356,37.569939,126.977539
종로구,458, 광화문역 5번출구,202002,576,580,1156,37.569939,126.977539
종로구,458, 광화문역 5번출구,202003,1036,1004,2040,37.569939,126.977539
종로구,458, 광화문역 5번출구,202004,1682,1525,3207,37.569939,126.977539
종로구,458, 광화문역 5번출구,202005,1870,1656,3526,37.569939,126.977539
종로구,458, 광화문역 5번출구,202006,2296,1977,4273,37.569939,126.977539
종로구,461, 서울지방경찰청,201901,368,293,661,37.574364,126.972366
종로구,461, 서울지방경찰청,201902,325,314,639,37.574364,126.972366
종로구,461, 서울지방경찰청,201903,695,644,1339,37.574364,126.972366
종로구,461, 서울지방경찰청,201904,995,952,1947,37.574364,126.972366
종로구,461, 서울지방경찰청,201905,1103,1068,2171,37.574364,126.972366
종로구,461, 서울지방경찰청,201906,1199,1142,2341,37.574364,126.972366
종로구,461, 서울지방경찰청,201907,1270,1188,2458,37.574364,126.972366
종로구,461, 서울지방경찰청,201908,1180,1153,2333,37.574364,126.972366
종로구,461, 서울지방경찰청,201909,1182,1143,2325,37.574364,126.972366
종로구,461, 서울지방경찰청,201910,1480,1436,2916,37.574364,126.972366
종로구,461, 서울지방경찰청,201911,1070,1021,2091,37.574364,126.972366
종로구,461, 서울지방경찰청,201912,651,638,1289,37.574364,126.972366
종로구,461, 서울지방경찰청,202001,542,502,1044,37.574364,126.972366
종로구,461, 서울지방경찰청,202002,496,466,962,37.574364,126.972366
종로구,461, 서울지방경찰청,202003,828,737,1565,37.574364,126.972366
종로구,461, 서울지방경찰청,202004,990,879,1869,37.574364,126.972366
종로구,461, 서울지방경찰청,202005,983,862,1845,37.574364,126.972366
종로구,461, 서울지방경찰청,202006,1244,1006,2250,37.574364,126.972366
종로구,462, 신영동삼거리(북악터널방향),201906,94,38,132,37.603512,126.962067
종로구,462, 신영동삼거리(북악터널방향),201907,271,118,389,37.603512,126.962067
종로구,462, 신영동삼거리(북악터널방향),201908,295,139,434,37.603512,126.962067
종로구,462, 신영동삼거리(북악터널방향),201909,268,149,417,37.603512,126.962067
종로구,462, 신영동삼거리(북악터널방향),201910,278,186,464,37.603512,126.962067
종로구,462, 신영동삼거리(북악터널방향),201911,201,108,309,37.603512,126.962067
종로구,462, 신영동삼거리(북악터널방향),201912,133,86,219,37.603512,126.962067
종로구,462, 신영동삼거리(북악터널방향),202001,106,82,188,37.603512,126.962067
종로구,462, 신영동삼거리(북악터널방향),202002,106,97,203,37.603512,126.962067
종로구,462, 신영동삼거리(북악터널방향),202003,64,102,166,37.603512,126.962067
종로구,462, 신영동삼거리(북악터널방향),202004,18,69,87,37.603512,126.962067
종로구,462, 신영동삼거리(북악터널방향),202005,25,59,84,37.603512,126.962067
종로구,462, 신영동삼거리(북악터널방향),202006,43,61,104,37.603512,126.962067
종로구,463, 삼청동 주민센터,201908,172,163,335,#N/A,#N/A
종로구,463, 삼청동 주민센터,201909,47,48,95,#N/A,#N/A
종로구,464, 삼청동 골목,201908,273,249,522,37.58419,126.981697
종로구,464, 삼청동 골목,201909,716,680,1396,37.58419,126.981697
종로구,464, 삼청동 골목,201910,992,975,1967,37.58419,126.981697
종로구,464, 삼청동 골목,201911,712,679,1391,37.58419,126.981697
종로구,464, 삼청동 골목,201912,425,434,859,37.58419,126.981697
종로구,464, 삼청동 골목,202001,365,383,748,37.58419,126.981697
종로구,464, 삼청동 골목,202002,261,258,519,37.58419,126.981697
종로구,464, 삼청동 골목,202003,582,497,1079,37.58419,126.981697
종로구,464, 삼청동 골목,202004,771,680,1451,37.58419,126.981697
종로구,464, 삼청동 골목,202005,953,847,1800,37.58419,126.981697
종로구,464, 삼청동 골목,202006,815,746,1561,37.58419,126.981697
종로구,465, 삼청공원 앞,201911,28,15,43,37.587605,126.983597
종로구,465, 삼청공원 앞,201912,80,30,110,37.587605,126.983597
종로구,465, 삼청공원 앞,202001,71,27,98,37.587605,126.983597
종로구,465, 삼청공원 앞,202002,56,24,80,37.587605,126.983597
종로구,465, 삼청공원 앞,202003,86,45,131,37.587605,126.983597
종로구,465, 삼청공원 앞,202004,158,111,269,37.587605,126.983597
종로구,465, 삼청공원 앞,202005,127,84,211,37.587605,126.983597
종로구,465, 삼청공원 앞,202006,132,98,230,37.587605,126.983597
중구,466,롯데호텔,202003,63,42,105,37.565842,126.979813
중구,466,롯데호텔,202004,244,132,376,37.565842,126.979813
중구,466,롯데호텔,202005,349,234,583,37.565842,126.979813
중구,466,롯데호텔,202006,482,334,816,37.565842,126.979813
중구,467,한국은행,202003,41,22,63,37.562214,126.980866
중구,467,한국은행,202004,110,58,168,37.562214,126.980866
중구,467,한국은행,202005,152,137,289,37.562214,126.980866
중구,467,한국은행,202006,132,121,253,37.562214,126.980866
중구,468,웨스틴 조선호텔,202003,49,39,88,37.564159,126.979485
중구,468,웨스틴 조선호텔,202004,105,81,186,37.564159,126.979485
중구,468,웨스틴 조선호텔,202005,143,142,285,37.564159,126.979485
중구,468,웨스틴 조선호텔,202006,169,164,333,37.564159,126.979485
중구,469,회현역 1번출구,202003,1,1,2,37.559231,126.980141
중구,469,회현역 1번출구,202004,2,1,3,37.559231,126.980141
중구,469,회현역 1번출구,202006,87,77,164,37.559231,126.980141
중구,470,회현역 7번출구,202003,95,72,167,37.55965,126.979889
중구,470,회현역 7번출구,202004,264,178,442,37.55965,126.979889
중구,470,회현역 7번출구,202005,244,245,489,37.55965,126.979889
중구,470,회현역 7번출구,202006,328,320,648,37.55965,126.979889
중구,471,회현사거리 남측,202003,53,44,97,37.56036,126.982651
중구,471,회현사거리 남측,202004,231,221,452,37.56036,126.982651
중구,471,회현사거리 남측,202005,398,395,793,37.56036,126.982651
중구,471,회현사거리 남측,202006,519,514,1033,37.56036,126.982651
중구,472,삼일교(시그니쳐 타워),202002,1,1,2,37.567871,126.988983
중구,472,삼일교(시그니쳐 타워),202003,91,77,168,37.567871,126.988983
중구,472,삼일교(시그니쳐 타워),202004,341,297,638,37.567871,126.988983
중구,472,삼일교(시그니쳐 타워),202005,528,524,1052,37.567871,126.988983
중구,472,삼일교(시그니쳐 타워),202006,720,702,1422,37.567871,126.988983
중구,473,을지로4가역 9번출구,202002,0,1,1,37.566051,126.997986
중구,473,을지로4가역 9번출구,202003,87,69,156,37.566051,126.997986
중구,473,을지로4가역 9번출구,202004,405,379,784,37.566051,126.997986
중구,473,을지로4가역 9번출구,202005,555,524,1079,37.566051,126.997986
중구,473,을지로4가역 9번출구,202006,831,779,1610,37.566051,126.997986
중구,474,동대문역사문화공원역 1번출구 뒤편,202003,1,1,2,37.566299,127.008492
중구,474,동대문역사문화공원역 1번출구 뒤편,202004,2,2,4,37.566299,127.008492
중구,474,동대문역사문화공원역 1번출구 뒤편,202006,590,482,1072,37.566299,127.008492
중구,475,DDP 패션몰,202006,44,35,79,37.56765,127.01181
중구,476,광희문,202006,142,144,286,37.56443,127.009956
중구,477,앰배서더 호텔 주변,202003,0,1,1,37.559288,127.002686
중구,477,앰배서더 호텔 주변,202006,69,57,126,37.559288,127.002686
중구,479,동대입구역 3번 출구,202003,1,0,1,37.559376,127.006027
중구,479,동대입구역 3번 출구,202004,3,4,7,37.559376,127.006027
중구,479,동대입구역 3번 출구,202006,104,98,202,37.559376,127.006027
중구,480,약수역 6번 출구,202006,7,7,14,37.554321,127.010704
중구,481,신당역 10번 출구,202003,1,1,2,37.567032,127.015793
중구,481,신당역 10번 출구,202004,2,2,4,37.567032,127.015793
중구,481,신당역 10번 출구,202006,114,106,220,37.567032,127.015793
중구,482,예수소망교회,202004,49,40,89,37.55994,127.018478
중구,482,예수소망교회,202005,52,52,104,37.55994,127.018478
중구,482,예수소망교회,202006,60,60,120,37.55994,127.018478
중구,483,남산타운아파트 버스정류장,202006,71,65,136,37.547585,127.006439
중구,484,도동삼거리,202003,1,1,2,37.555767,126.977188
중구,484,도동삼거리,202004,2,2,4,37.555767,126.977188
중구,484,도동삼거리,202006,46,30,76,37.555767,126.977188
중구,485,서울역4번출구,202002,1,1,2,37.557404,126.973251
중구,485,서울역4번출구,202003,103,51,154,37.557404,126.973251
중구,485,서울역4번출구,202004,247,157,404,37.557404,126.973251
중구,485,서울역4번출구,202005,323,297,620,37.557404,126.973251
중구,485,서울역4번출구,202006,409,386,795,37.557404,126.973251
종로구,486, 평창동주민센터 앞,202003,117,99,216,#N/A,#N/A
종로구,486, 평창동주민센터 앞,202004,253,238,491,#N/A,#N/A
종로구,486, 평창동주민센터 앞,202005,265,245,510,#N/A,#N/A
종로구,486, 평창동주민센터 앞,202006,310,267,577,#N/A,#N/A
마포구,487,신석초교앞 교차로 교통섬,202004,1,1,2,37.54364,126.938309
마포구,487,신석초교앞 교차로 교통섬,202006,649,655,1304,37.54364,126.938309
마포구,489,구룡근린공원,202004,1,1,2,37.583336,126.8834
마포구,489,구룡근린공원,202006,131,93,224,37.583336,126.8834
마포구,490,가온문화공원,202004,87,89,176,37.582077,126.887665
마포구,490,가온문화공원,202005,357,366,723,37.582077,126.887665
마포구,490,가온문화공원,202006,796,794,1590,37.582077,126.887665
마포구,491,월드컵파크 4단지,202004,1,1,2,37.575977,126.888069
마포구,491,월드컵파크 4단지,202005,98,91,189,37.575977,126.888069
마포구,491,월드컵파크 4단지,202006,291,244,535,37.575977,126.888069
마포구,492,성산시영아파트 후문,202004,2,2,4,37.573135,126.901848
마포구,492,성산시영아파트 후문,202006,631,636,1267,37.573135,126.901848
마포구,493,홍대입구역 6번출구,202004,5,4,9,37.556576,126.928856
마포구,493,홍대입구역 6번출구,202005,331,332,663,37.556576,126.928856
마포구,493,홍대입구역 6번출구,202006,1134,1115,2249,37.556576,126.928856
마포구,495,염리초등학교 앞,202004,81,81,162,37.542431,126.946999
마포구,495,염리초등학교 앞,202005,231,229,460,37.542431,126.946999
마포구,495,염리초등학교 앞,202006,782,779,1561,37.542431,126.946999
마포구,496,마포아트센터 앞,202004,2,2,4,#N/A,#N/A
마포구,497,합정동주민센터 앞,202004,2,1,3,37.551754,126.9123
마포구,497,합정동주민센터 앞,202005,573,568,1141,37.551754,126.9123
마포구,497,합정동주민센터 앞,202006,1426,1391,2817,37.551754,126.9123
마포구,498,연남동주민센터 앞,202004,1,1,2,37.564651,126.922127
마포구,498,연남동주민센터 앞,202005,589,579,1168,37.564651,126.922127
마포구,498,연남동주민센터 앞,202006,1602,1564,3166,37.564651,126.922127
광진구,500, 어린이대공원역 3번출구 앞,201901,1440,1071,2511,37.54707,127.074272
광진구,500, 어린이대공원역 3번출구 앞,201902,1197,946,2143,37.54707,127.074272
광진구,500, 어린이대공원역 3번출구 앞,201903,2201,1816,4017,37.54707,127.074272
광진구,500, 어린이대공원역 3번출구 앞,201904,3060,2640,5700,37.54707,127.074272
광진구,500, 어린이대공원역 3번출구 앞,201905,3994,3717,7711,37.54707,127.074272
광진구,500, 어린이대공원역 3번출구 앞,201906,4024,3809,7833,37.54707,127.074272
광진구,500, 어린이대공원역 3번출구 앞,201907,3385,3219,6604,37.54707,127.074272
광진구,500, 어린이대공원역 3번출구 앞,201908,3230,3183,6413,37.54707,127.074272
광진구,500, 어린이대공원역 3번출구 앞,201909,3181,3098,6279,37.54707,127.074272
광진구,500, 어린이대공원역 3번출구 앞,201910,3847,3824,7671,37.54707,127.074272
광진구,500, 어린이대공원역 3번출구 앞,201911,2663,2633,5296,37.54707,127.074272
광진구,500, 어린이대공원역 3번출구 앞,201912,1513,1462,2975,37.54707,127.074272
광진구,500, 어린이대공원역 3번출구 앞,202001,1278,1110,2388,37.54707,127.074272
광진구,500, 어린이대공원역 3번출구 앞,202002,1156,1061,2217,37.54707,127.074272
광진구,500, 어린이대공원역 3번출구 앞,202003,1863,1801,3664,37.54707,127.074272
광진구,500, 어린이대공원역 3번출구 앞,202004,2545,2496,5041,37.54707,127.074272
광진구,500, 어린이대공원역 3번출구 앞,202005,2611,2613,5224,37.54707,127.074272
광진구,500, 어린이대공원역 3번출구 앞,202006,3178,3113,6291,37.54707,127.074272
광진구,501, 광진구의회 앞,201901,465,414,879,37.537308,127.070351
광진구,501, 광진구의회 앞,201902,464,404,868,37.537308,127.070351
광진구,501, 광진구의회 앞,201903,895,829,1724,37.537308,127.070351
광진구,501, 광진구의회 앞,201904,1328,1237,2565,37.537308,127.070351
광진구,501, 광진구의회 앞,201905,1682,1498,3180,37.537308,127.070351
광진구,501, 광진구의회 앞,201906,1647,1495,3142,37.537308,127.070351
광진구,501, 광진구의회 앞,201907,1660,1500,3160,37.537308,127.070351
광진구,501, 광진구의회 앞,201908,1584,1485,3069,37.537308,127.070351
광진구,501, 광진구의회 앞,201909,1595,1438,3033,37.537308,127.070351
광진구,501, 광진구의회 앞,201910,1734,1565,3299,37.537308,127.070351
광진구,501, 광진구의회 앞,201911,1396,1251,2647,37.537308,127.070351
광진구,501, 광진구의회 앞,201912,1076,982,2058,37.537308,127.070351
광진구,501, 광진구의회 앞,202001,949,851,1800,37.537308,127.070351
광진구,501, 광진구의회 앞,202002,817,704,1521,37.537308,127.070351
광진구,501, 광진구의회 앞,202003,1347,1166,2513,37.537308,127.070351
광진구,501, 광진구의회 앞,202004,1746,1547,3293,37.537308,127.070351
광진구,501, 광진구의회 앞,202005,1801,1611,3412,37.537308,127.070351
광진구,501, 광진구의회 앞,202006,1681,1539,3220,37.537308,127.070351
광진구,502, 뚝섬유원지역 1번출구 앞,201901,1250,1525,2775,37.53186,127.067192
광진구,502, 뚝섬유원지역 1번출구 앞,201902,1597,1915,3512,37.53186,127.067192
광진구,502, 뚝섬유원지역 1번출구 앞,201903,3887,4580,8467,37.53186,127.067192
광진구,502, 뚝섬유원지역 1번출구 앞,201904,8081,9994,18075,37.53186,127.067192
광진구,502, 뚝섬유원지역 1번출구 앞,201905,15588,17773,33361,37.53186,127.067192
광진구,502, 뚝섬유원지역 1번출구 앞,201906,12998,14288,27286,37.53186,127.067192
광진구,502, 뚝섬유원지역 1번출구 앞,201907,10673,11494,22167,37.53186,127.067192
광진구,502, 뚝섬유원지역 1번출구 앞,201908,13863,14592,28455,37.53186,127.067192
광진구,502, 뚝섬유원지역 1번출구 앞,201909,15284,15998,31282,37.53186,127.067192
광진구,502, 뚝섬유원지역 1번출구 앞,201910,13284,14354,27638,37.53186,127.067192
광진구,502, 뚝섬유원지역 1번출구 앞,201911,4995,5594,10589,37.53186,127.067192
광진구,502, 뚝섬유원지역 1번출구 앞,201912,2125,2363,4488,37.53186,127.067192
광진구,502, 뚝섬유원지역 1번출구 앞,202001,2134,2507,4641,37.53186,127.067192
광진구,502, 뚝섬유원지역 1번출구 앞,202002,2814,3262,6076,37.53186,127.067192
광진구,502, 뚝섬유원지역 1번출구 앞,202003,14584,17256,31840,37.53186,127.067192
광진구,502, 뚝섬유원지역 1번출구 앞,202004,17524,20030,37554,37.53186,127.067192
광진구,502, 뚝섬유원지역 1번출구 앞,202005,23174,24256,47430,37.53186,127.067192
광진구,502, 뚝섬유원지역 1번출구 앞,202006,16604,17760,34364,37.53186,127.067192
광진구,503, 더샵스타시티 C동 앞,201901,456,353,809,#N/A,#N/A
광진구,503, 더샵스타시티 C동 앞,201902,414,320,734,#N/A,#N/A
광진구,503, 더샵스타시티 C동 앞,201903,880,715,1595,#N/A,#N/A
광진구,503, 더샵스타시티 C동 앞,201904,1235,980,2215,#N/A,#N/A
광진구,503, 더샵스타시티 C동 앞,201905,1915,1576,3491,#N/A,#N/A
광진구,503, 더샵스타시티 C동 앞,201906,2252,1921,4173,#N/A,#N/A
광진구,503, 더샵스타시티 C동 앞,201907,2404,1927,4331,#N/A,#N/A
광진구,503, 더샵스타시티 C동 앞,201908,2182,1759,3941,#N/A,#N/A
광진구,503, 더샵스타시티 C동 앞,201909,1970,1705,3675,#N/A,#N/A
광진구,503, 더샵스타시티 C동 앞,201910,2377,2075,4452,#N/A,#N/A
광진구,503, 더샵스타시티 C동 앞,201911,1428,1199,2627,#N/A,#N/A
광진구,504, 신자초교입구교차로,201901,717,769,1486,#N/A,#N/A
광진구,504, 신자초교입구교차로,201902,633,693,1326,#N/A,#N/A
광진구,504, 신자초교입구교차로,201903,1222,1297,2519,#N/A,#N/A
광진구,504, 신자초교입구교차로,201904,1655,1752,3407,#N/A,#N/A
광진구,504, 신자초교입구교차로,201905,2809,2916,5725,#N/A,#N/A
광진구,504, 신자초교입구교차로,201906,3203,3199,6402,#N/A,#N/A
광진구,504, 신자초교입구교차로,201907,3519,3591,7110,#N/A,#N/A
광진구,504, 신자초교입구교차로,201908,3663,3718,7381,#N/A,#N/A
광진구,504, 신자초교입구교차로,201909,3057,3049,6106,#N/A,#N/A
광진구,504, 신자초교입구교차로,201910,3571,3577,7148,#N/A,#N/A
광진구,504, 신자초교입구교차로,201911,2340,2400,4740,#N/A,#N/A
광진구,504, 신자초교입구교차로,201912,1329,1376,2705,#N/A,#N/A
광진구,504, 신자초교입구교차로,202001,1212,1254,2466,#N/A,#N/A
광진구,504, 신자초교입구교차로,202002,1125,1157,2282,#N/A,#N/A
광진구,504, 신자초교입구교차로,202003,1839,1890,3729,#N/A,#N/A
광진구,504, 신자초교입구교차로,202004,2552,2538,5090,#N/A,#N/A
광진구,504, 신자초교입구교차로,202005,2937,2911,5848,#N/A,#N/A
광진구,504, 신자초교입구교차로,202006,2519,2571,5090,#N/A,#N/A
광진구,505, 자양사거리 광진아크로텔 앞,201901,1007,1070,2077,37.53701,127.082245
광진구,505, 자양사거리 광진아크로텔 앞,201902,873,943,1816,37.53701,127.082245
광진구,505, 자양사거리 광진아크로텔 앞,201903,1798,1753,3551,37.53701,127.082245
광진구,505, 자양사거리 광진아크로텔 앞,201904,2780,2766,5546,37.53701,127.082245
광진구,505, 자양사거리 광진아크로텔 앞,201905,4430,4363,8793,37.53701,127.082245
광진구,505, 자양사거리 광진아크로텔 앞,201906,5028,4984,10012,37.53701,127.082245
광진구,505, 자양사거리 광진아크로텔 앞,201907,4829,4728,9557,37.53701,127.082245
광진구,505, 자양사거리 광진아크로텔 앞,201908,4853,4804,9657,37.53701,127.082245
광진구,505, 자양사거리 광진아크로텔 앞,201909,4558,4493,9051,37.53701,127.082245
광진구,505, 자양사거리 광진아크로텔 앞,201910,5052,5016,10068,37.53701,127.082245
광진구,505, 자양사거리 광진아크로텔 앞,201911,3300,3224,6524,37.53701,127.082245
광진구,505, 자양사거리 광진아크로텔 앞,201912,2039,2025,4064,37.53701,127.082245
광진구,505, 자양사거리 광진아크로텔 앞,202001,1882,1880,3762,37.53701,127.082245
광진구,505, 자양사거리 광진아크로텔 앞,202002,1787,1772,3559,37.53701,127.082245
광진구,505, 자양사거리 광진아크로텔 앞,202003,2950,2986,5936,37.53701,127.082245
광진구,505, 자양사거리 광진아크로텔 앞,202004,3967,3924,7891,37.53701,127.082245
광진구,505, 자양사거리 광진아크로텔 앞,202005,4226,4167,8393,37.53701,127.082245
광진구,505, 자양사거리 광진아크로텔 앞,202006,4321,4329,8650,37.53701,127.082245
성동구,506, 금호 어울림 아파트 앞,201901,169,158,327,37.549061,127.057793
성동구,506, 금호 어울림 아파트 앞,201902,139,136,275,37.549061,127.057793
성동구,506, 금호 어울림 아파트 앞,201903,229,241,470,37.549061,127.057793
성동구,506, 금호 어울림 아파트 앞,201904,424,436,860,37.549061,127.057793
성동구,506, 금호 어울림 아파트 앞,201905,582,586,1168,37.549061,127.057793
성동구,506, 금호 어울림 아파트 앞,201906,609,621,1230,37.549061,127.057793
성동구,506, 금호 어울림 아파트 앞,201907,533,518,1051,37.549061,127.057793
성동구,506, 금호 어울림 아파트 앞,201908,487,487,974,37.549061,127.057793
성동구,506, 금호 어울림 아파트 앞,201909,490,488,978,37.549061,127.057793
성동구,506, 금호 어울림 아파트 앞,201910,558,561,1119,37.549061,127.057793
성동구,506, 금호 어울림 아파트 앞,201911,327,333,660,37.549061,127.057793
성동구,506, 금호 어울림 아파트 앞,201912,199,204,403,37.549061,127.057793
성동구,506, 금호 어울림 아파트 앞,202001,210,208,418,37.549061,127.057793
성동구,506, 금호 어울림 아파트 앞,202002,220,218,438,37.549061,127.057793
성동구,506, 금호 어울림 아파트 앞,202003,408,378,786,37.549061,127.057793
성동구,506, 금호 어울림 아파트 앞,202004,445,426,871,37.549061,127.057793
성동구,506, 금호 어울림 아파트 앞,202005,489,492,981,37.549061,127.057793
성동구,506, 금호 어울림 아파트 앞,202006,570,577,1147,37.549061,127.057793
성동구,507, 성수아이에스비즈타워 앞,201901,434,468,902,37.548203,127.057114
성동구,507, 성수아이에스비즈타워 앞,201902,370,411,781,37.548203,127.057114
성동구,507, 성수아이에스비즈타워 앞,201903,670,729,1399,37.548203,127.057114
성동구,507, 성수아이에스비즈타워 앞,201904,891,1006,1897,37.548203,127.057114
성동구,507, 성수아이에스비즈타워 앞,201905,1462,1511,2973,37.548203,127.057114
성동구,507, 성수아이에스비즈타워 앞,201906,1626,1654,3280,37.548203,127.057114
성동구,507, 성수아이에스비즈타워 앞,201907,1712,1746,3458,37.548203,127.057114
성동구,507, 성수아이에스비즈타워 앞,201908,1558,1580,3138,37.548203,127.057114
성동구,507, 성수아이에스비즈타워 앞,201909,1647,1698,3345,37.548203,127.057114
성동구,507, 성수아이에스비즈타워 앞,201910,1835,1930,3765,37.548203,127.057114
성동구,507, 성수아이에스비즈타워 앞,201911,1280,1328,2608,37.548203,127.057114
성동구,507, 성수아이에스비즈타워 앞,201912,898,913,1811,37.548203,127.057114
성동구,507, 성수아이에스비즈타워 앞,202001,778,815,1593,37.548203,127.057114
성동구,507, 성수아이에스비즈타워 앞,202002,728,763,1491,37.548203,127.057114
성동구,507, 성수아이에스비즈타워 앞,202003,1022,1031,2053,37.548203,127.057114
성동구,507, 성수아이에스비즈타워 앞,202004,1260,1263,2523,37.548203,127.057114
성동구,507, 성수아이에스비즈타워 앞,202005,1217,1260,2477,37.548203,127.057114
성동구,507, 성수아이에스비즈타워 앞,202006,1410,1490,2900,37.548203,127.057114
성동구,508, 성수아카데미타워 앞,201901,426,358,784,37.545166,127.05751
성동구,508, 성수아카데미타워 앞,201902,331,280,611,37.545166,127.05751
성동구,508, 성수아카데미타워 앞,201903,590,487,1077,37.545166,127.05751
성동구,508, 성수아카데미타워 앞,201904,822,684,1506,37.545166,127.05751
성동구,508, 성수아카데미타워 앞,201905,1248,1199,2447,37.545166,127.05751
성동구,508, 성수아카데미타워 앞,201906,1293,1243,2536,37.545166,127.05751
성동구,508, 성수아카데미타워 앞,201907,1357,1263,2620,37.545166,127.05751
성동구,508, 성수아카데미타워 앞,201908,1300,1265,2565,37.545166,127.05751
성동구,508, 성수아카데미타워 앞,201909,1373,1350,2723,37.545166,127.05751
성동구,508, 성수아카데미타워 앞,201910,1585,1515,3100,37.545166,127.05751
성동구,508, 성수아카데미타워 앞,201911,1266,1156,2422,37.545166,127.05751
성동구,508, 성수아카데미타워 앞,201912,856,717,1573,37.545166,127.05751
성동구,508, 성수아카데미타워 앞,202001,714,666,1380,37.545166,127.05751
성동구,508, 성수아카데미타워 앞,202002,721,652,1373,37.545166,127.05751
성동구,508, 성수아카데미타워 앞,202003,1128,1105,2233,37.545166,127.05751
성동구,508, 성수아카데미타워 앞,202004,1401,1373,2774,37.545166,127.05751
성동구,508, 성수아카데미타워 앞,202005,1349,1307,2656,37.545166,127.05751
성동구,508, 성수아카데미타워 앞,202006,1533,1492,3025,37.545166,127.05751
성동구,509, 이마트 버스정류소 옆,201901,944,1021,1965,37.539654,127.052589
성동구,509, 이마트 버스정류소 옆,201902,910,999,1909,37.539654,127.052589
성동구,509, 이마트 버스정류소 옆,201903,1565,1787,3352,37.539654,127.052589
성동구,509, 이마트 버스정류소 옆,201904,2249,2466,4715,37.539654,127.052589
성동구,509, 이마트 버스정류소 옆,201905,3419,3544,6963,37.539654,127.052589
성동구,509, 이마트 버스정류소 옆,201906,3554,3750,7304,37.539654,127.052589
성동구,509, 이마트 버스정류소 옆,201907,3594,3777,7371,37.539654,127.052589
성동구,509, 이마트 버스정류소 옆,201908,3421,3567,6988,37.539654,127.052589
성동구,509, 이마트 버스정류소 옆,201909,3081,3259,6340,37.539654,127.052589
성동구,509, 이마트 버스정류소 옆,201910,3731,3797,7528,37.539654,127.052589
성동구,509, 이마트 버스정류소 옆,201911,2512,2614,5126,37.539654,127.052589
성동구,509, 이마트 버스정류소 옆,201912,1624,1735,3359,37.539654,127.052589
성동구,509, 이마트 버스정류소 옆,202001,1407,1471,2878,37.539654,127.052589
성동구,509, 이마트 버스정류소 옆,202002,1391,1437,2828,37.539654,127.052589
성동구,509, 이마트 버스정류소 옆,202003,2295,2382,4677,37.539654,127.052589
성동구,509, 이마트 버스정류소 옆,202004,3109,3121,6230,37.539654,127.052589
성동구,509, 이마트 버스정류소 옆,202005,3248,3260,6508,37.539654,127.052589
성동구,509, 이마트 버스정류소 옆,202006,3518,3589,7107,37.539654,127.052589
성동구,510, 서울숲 남문 버스정류소 옆,201901,99,110,209,37.541222,127.0438
성동구,510, 서울숲 남문 버스정류소 옆,201902,146,163,309,37.541222,127.0438
성동구,510, 서울숲 남문 버스정류소 옆,201903,449,517,966,37.541222,127.0438
성동구,510, 서울숲 남문 버스정류소 옆,201904,1123,1213,2336,37.541222,127.0438
성동구,510, 서울숲 남문 버스정류소 옆,201905,1956,1938,3894,37.541222,127.0438
성동구,510, 서울숲 남문 버스정류소 옆,201906,1649,1657,3306,37.541222,127.0438
성동구,510, 서울숲 남문 버스정류소 옆,201907,1270,1270,2540,37.541222,127.0438
성동구,510, 서울숲 남문 버스정류소 옆,201908,1461,1515,2976,37.541222,127.0438
성동구,510, 서울숲 남문 버스정류소 옆,201909,1576,1572,3148,37.541222,127.0438
성동구,510, 서울숲 남문 버스정류소 옆,201910,1704,1770,3474,37.541222,127.0438
성동구,510, 서울숲 남문 버스정류소 옆,201911,843,919,1762,37.541222,127.0438
성동구,510, 서울숲 남문 버스정류소 옆,201912,269,285,554,37.541222,127.0438
성동구,510, 서울숲 남문 버스정류소 옆,202001,279,278,557,37.541222,127.0438
성동구,510, 서울숲 남문 버스정류소 옆,202002,361,409,770,37.541222,127.0438
성동구,510, 서울숲 남문 버스정류소 옆,202003,2186,2468,4654,37.541222,127.0438
성동구,510, 서울숲 남문 버스정류소 옆,202004,2879,3072,5951,37.541222,127.0438
성동구,510, 서울숲 남문 버스정류소 옆,202005,2944,2954,5898,37.541222,127.0438
성동구,510, 서울숲 남문 버스정류소 옆,202006,1637,1585,3222,37.541222,127.0438
성동구,511, 서울숲역 4번 출구 옆,201901,317,420,737,37.544582,127.044609
성동구,511, 서울숲역 4번 출구 옆,201902,397,466,863,37.544582,127.044609
성동구,511, 서울숲역 4번 출구 옆,201903,1024,1132,2156,37.544582,127.044609
성동구,511, 서울숲역 4번 출구 옆,201904,2263,2240,4503,37.544582,127.044609
성동구,511, 서울숲역 4번 출구 옆,201905,3549,3460,7009,37.544582,127.044609
성동구,511, 서울숲역 4번 출구 옆,201906,3046,2992,6038,37.544582,127.044609
성동구,511, 서울숲역 4번 출구 옆,201907,2254,2212,4466,37.544582,127.044609
성동구,511, 서울숲역 4번 출구 옆,201908,2740,2760,5500,37.544582,127.044609
성동구,511, 서울숲역 4번 출구 옆,201909,2689,2710,5399,37.544582,127.044609
성동구,511, 서울숲역 4번 출구 옆,201910,3293,3313,6606,37.544582,127.044609
성동구,511, 서울숲역 4번 출구 옆,201911,1616,1697,3313,37.544582,127.044609
성동구,511, 서울숲역 4번 출구 옆,201912,764,780,1544,37.544582,127.044609
성동구,511, 서울숲역 4번 출구 옆,202001,580,638,1218,37.544582,127.044609
성동구,511, 서울숲역 4번 출구 옆,202002,644,681,1325,37.544582,127.044609
성동구,511, 서울숲역 4번 출구 옆,202003,2275,2341,4616,37.544582,127.044609
성동구,511, 서울숲역 4번 출구 옆,202004,2909,2925,5834,37.544582,127.044609
성동구,511, 서울숲역 4번 출구 옆,202005,2807,2734,5541,37.544582,127.044609
성동구,511, 서울숲역 4번 출구 옆,202006,1307,1283,2590,37.544582,127.044609
성동구,512, 뚝섬역 1번 출구 옆,201901,667,622,1289,37.548561,127.045006
성동구,512, 뚝섬역 1번 출구 옆,201902,692,646,1338,37.548561,127.045006
성동구,512, 뚝섬역 1번 출구 옆,201903,1356,1256,2612,37.548561,127.045006
성동구,512, 뚝섬역 1번 출구 옆,201904,2259,2056,4315,37.548561,127.045006
성동구,512, 뚝섬역 1번 출구 옆,201905,3799,3694,7493,37.548561,127.045006
성동구,512, 뚝섬역 1번 출구 옆,201906,3838,3741,7579,37.548561,127.045006
성동구,512, 뚝섬역 1번 출구 옆,201907,3111,3054,6165,37.548561,127.045006
성동구,512, 뚝섬역 1번 출구 옆,201908,1920,1879,3799,37.548561,127.045006
성동구,512, 뚝섬역 1번 출구 옆,201909,3232,3179,6411,37.548561,127.045006
성동구,512, 뚝섬역 1번 출구 옆,201910,3815,3858,7673,37.548561,127.045006
성동구,512, 뚝섬역 1번 출구 옆,201911,2285,2270,4555,37.548561,127.045006
성동구,512, 뚝섬역 1번 출구 옆,201912,1234,1250,2484,37.548561,127.045006
성동구,512, 뚝섬역 1번 출구 옆,202001,1161,1104,2265,37.548561,127.045006
성동구,512, 뚝섬역 1번 출구 옆,202002,1177,1142,2319,37.548561,127.045006
성동구,512, 뚝섬역 1번 출구 옆,202003,3143,2988,6131,37.548561,127.045006
성동구,512, 뚝섬역 1번 출구 옆,202004,4172,4212,8384,37.548561,127.045006
성동구,512, 뚝섬역 1번 출구 옆,202005,4207,4208,8415,37.548561,127.045006
성동구,512, 뚝섬역 1번 출구 옆,202006,3595,3561,7156,37.548561,127.045006
성동구,513, 뚝섬역 5번 출구 정류소 옆,201901,710,767,1477,37.546307,127.049805
성동구,513, 뚝섬역 5번 출구 정류소 옆,201902,620,642,1262,37.546307,127.049805
성동구,513, 뚝섬역 5번 출구 정류소 옆,201903,1344,1373,2717,37.546307,127.049805
성동구,513, 뚝섬역 5번 출구 정류소 옆,201904,1921,2008,3929,37.546307,127.049805
성동구,513, 뚝섬역 5번 출구 정류소 옆,201905,3138,3160,6298,37.546307,127.049805
성동구,513, 뚝섬역 5번 출구 정류소 옆,201906,3014,2970,5984,37.546307,127.049805
성동구,513, 뚝섬역 5번 출구 정류소 옆,201907,2971,2957,5928,37.546307,127.049805
성동구,513, 뚝섬역 5번 출구 정류소 옆,201908,3091,3096,6187,37.546307,127.049805
성동구,513, 뚝섬역 5번 출구 정류소 옆,201909,2616,2625,5241,37.546307,127.049805
성동구,513, 뚝섬역 5번 출구 정류소 옆,201910,3314,3353,6667,37.546307,127.049805
성동구,513, 뚝섬역 5번 출구 정류소 옆,201911,2160,2098,4258,37.546307,127.049805
성동구,513, 뚝섬역 5번 출구 정류소 옆,201912,1282,1261,2543,37.546307,127.049805
성동구,513, 뚝섬역 5번 출구 정류소 옆,202001,1121,1145,2266,37.546307,127.049805
성동구,513, 뚝섬역 5번 출구 정류소 옆,202002,1157,1155,2312,37.546307,127.049805
성동구,513, 뚝섬역 5번 출구 정류소 옆,202003,2223,2211,4434,37.546307,127.049805
성동구,513, 뚝섬역 5번 출구 정류소 옆,202004,2951,2925,5876,37.546307,127.049805
성동구,513, 뚝섬역 5번 출구 정류소 옆,202005,3178,3207,6385,37.546307,127.049805
성동구,513, 뚝섬역 5번 출구 정류소 옆,202006,3118,3132,6250,37.546307,127.049805
성동구,514, 성수사거리 버스정류장 앞,201901,852,900,1752,37.54258,127.063309
성동구,514, 성수사거리 버스정류장 앞,201902,675,723,1398,37.54258,127.063309
성동구,514, 성수사거리 버스정류장 앞,201903,1129,1225,2354,37.54258,127.063309
성동구,514, 성수사거리 버스정류장 앞,201904,1545,1580,3125,37.54258,127.063309
성동구,514, 성수사거리 버스정류장 앞,201905,2091,2192,4283,37.54258,127.063309
성동구,514, 성수사거리 버스정류장 앞,201906,2255,2397,4652,37.54258,127.063309
성동구,514, 성수사거리 버스정류장 앞,201907,2371,2449,4820,37.54258,127.063309
성동구,514, 성수사거리 버스정류장 앞,201908,2206,2230,4436,37.54258,127.063309
성동구,514, 성수사거리 버스정류장 앞,201909,2021,2058,4079,37.54258,127.063309
성동구,514, 성수사거리 버스정류장 앞,201910,2594,2616,5210,37.54258,127.063309
성동구,514, 성수사거리 버스정류장 앞,201911,1816,2023,3839,37.54258,127.063309
성동구,514, 성수사거리 버스정류장 앞,201912,1304,1387,2691,37.54258,127.063309
성동구,514, 성수사거리 버스정류장 앞,202001,1001,1077,2078,37.54258,127.063309
성동구,514, 성수사거리 버스정류장 앞,202002,1035,1078,2113,37.54258,127.063309
성동구,514, 성수사거리 버스정류장 앞,202003,1562,1565,3127,37.54258,127.063309
성동구,514, 성수사거리 버스정류장 앞,202004,2085,2068,4153,37.54258,127.063309
성동구,514, 성수사거리 버스정류장 앞,202005,1970,1979,3949,37.54258,127.063309
성동구,514, 성수사거리 버스정류장 앞,202006,2170,2161,4331,37.54258,127.063309
광진구,515, 광양중학교 앞,201901,174,176,350,37.530235,127.08683
광진구,515, 광양중학교 앞,201902,211,217,428,37.530235,127.08683
광진구,515, 광양중학교 앞,201903,418,403,821,37.530235,127.08683
광진구,515, 광양중학교 앞,201904,725,695,1420,37.530235,127.08683
광진구,515, 광양중학교 앞,201905,1267,1298,2565,37.530235,127.08683
광진구,515, 광양중학교 앞,201906,1386,1379,2765,37.530235,127.08683
광진구,515, 광양중학교 앞,201907,1362,1397,2759,37.530235,127.08683
광진구,515, 광양중학교 앞,201908,1328,1347,2675,37.530235,127.08683
광진구,515, 광양중학교 앞,201909,1228,1267,2495,37.530235,127.08683
광진구,515, 광양중학교 앞,201910,1246,1245,2491,37.530235,127.08683
광진구,515, 광양중학교 앞,201911,699,672,1371,37.530235,127.08683
광진구,515, 광양중학교 앞,201912,388,386,774,37.530235,127.08683
광진구,515, 광양중학교 앞,202001,364,366,730,37.530235,127.08683
광진구,515, 광양중학교 앞,202002,364,361,725,37.530235,127.08683
광진구,515, 광양중학교 앞,202003,896,895,1791,37.530235,127.08683
광진구,515, 광양중학교 앞,202004,1134,1132,2266,37.530235,127.08683
광진구,515, 광양중학교 앞,202005,1359,1374,2733,37.530235,127.08683
광진구,515, 광양중학교 앞,202006,1504,1499,3003,37.530235,127.08683
광진구,516, 광진메디칼 앞,201901,392,388,780,37.548405,127.069366
광진구,516, 광진메디칼 앞,201902,302,325,627,37.548405,127.069366
광진구,516, 광진메디칼 앞,201903,606,593,1199,37.548405,127.069366
광진구,516, 광진메디칼 앞,201904,1011,978,1989,37.548405,127.069366
광진구,516, 광진메디칼 앞,201905,1410,1357,2767,37.548405,127.069366
광진구,516, 광진메디칼 앞,201906,1652,1606,3258,37.548405,127.069366
광진구,516, 광진메디칼 앞,201907,1558,1550,3108,37.548405,127.069366
광진구,516, 광진메디칼 앞,201908,1508,1483,2991,37.548405,127.069366
광진구,516, 광진메디칼 앞,201909,1332,1307,2639,37.548405,127.069366
광진구,516, 광진메디칼 앞,201910,1685,1636,3321,37.548405,127.069366
광진구,516, 광진메디칼 앞,201911,1106,1070,2176,37.548405,127.069366
광진구,516, 광진메디칼 앞,201912,685,686,1371,37.548405,127.069366
광진구,516, 광진메디칼 앞,202001,672,630,1302,37.548405,127.069366
광진구,516, 광진메디칼 앞,202002,561,554,1115,37.548405,127.069366
광진구,516, 광진메디칼 앞,202003,849,845,1694,37.548405,127.069366
광진구,516, 광진메디칼 앞,202004,1157,1148,2305,37.548405,127.069366
광진구,516, 광진메디칼 앞,202005,1293,1257,2550,37.548405,127.069366
광진구,516, 광진메디칼 앞,202006,1375,1351,2726,37.548405,127.069366
성동구,518, 청계천 박물관 앞,201901,343,320,663,37.571526,127.035355
성동구,518, 청계천 박물관 앞,201902,322,267,589,37.571526,127.035355
성동구,518, 청계천 박물관 앞,201903,563,568,1131,37.571526,127.035355
성동구,518, 청계천 박물관 앞,201904,761,761,1522,37.571526,127.035355
성동구,518, 청계천 박물관 앞,201905,1058,1048,2106,37.571526,127.035355
성동구,518, 청계천 박물관 앞,201906,1091,1087,2178,37.571526,127.035355
성동구,518, 청계천 박물관 앞,201907,1251,1217,2468,37.571526,127.035355
성동구,518, 청계천 박물관 앞,201908,1040,1023,2063,37.571526,127.035355
성동구,518, 청계천 박물관 앞,201909,934,932,1866,37.571526,127.035355
성동구,518, 청계천 박물관 앞,201910,1204,1207,2411,37.571526,127.035355
성동구,518, 청계천 박물관 앞,201911,902,895,1797,37.571526,127.035355
성동구,518, 청계천 박물관 앞,201912,542,566,1108,37.571526,127.035355
성동구,518, 청계천 박물관 앞,202001,464,448,912,37.571526,127.035355
성동구,518, 청계천 박물관 앞,202002,562,549,1111,37.571526,127.035355
성동구,518, 청계천 박물관 앞,202003,824,815,1639,37.571526,127.035355
성동구,518, 청계천 박물관 앞,202004,1006,998,2004,37.571526,127.035355
성동구,518, 청계천 박물관 앞,202005,932,897,1829,37.571526,127.035355
성동구,518, 청계천 박물관 앞,202006,1103,1087,2190,37.571526,127.035355
성동구,519, 양지사거리,201901,337,266,603,37.566994,127.029915
성동구,519, 양지사거리,201902,332,273,605,37.566994,127.029915
성동구,519, 양지사거리,201903,609,498,1107,37.566994,127.029915
성동구,519, 양지사거리,201904,845,599,1444,37.566994,127.029915
성동구,519, 양지사거리,201905,1139,888,2027,37.566994,127.029915
성동구,519, 양지사거리,201906,1236,960,2196,37.566994,127.029915
성동구,519, 양지사거리,201907,1140,848,1988,37.566994,127.029915
성동구,519, 양지사거리,201908,1009,853,1862,37.566994,127.029915
성동구,519, 양지사거리,201909,933,850,1783,37.566994,127.029915
성동구,519, 양지사거리,201910,1079,984,2063,37.566994,127.029915
성동구,519, 양지사거리,201911,816,654,1470,37.566994,127.029915
성동구,519, 양지사거리,201912,561,405,966,37.566994,127.029915
성동구,519, 양지사거리,202001,520,321,841,37.566994,127.029915
성동구,519, 양지사거리,202002,443,335,778,37.566994,127.029915
성동구,519, 양지사거리,202003,779,600,1379,37.566994,127.029915
성동구,519, 양지사거리,202004,873,758,1631,37.566994,127.029915
성동구,519, 양지사거리,202005,1052,903,1955,37.566994,127.029915
성동구,519, 양지사거리,202006,989,836,1825,37.566994,127.029915
성동구,520, 상왕십리역 4번 출구 앞,201901,401,307,708,37.563858,127.030319
성동구,520, 상왕십리역 4번 출구 앞,201902,358,275,633,37.563858,127.030319
성동구,520, 상왕십리역 4번 출구 앞,201903,588,477,1065,37.563858,127.030319
성동구,520, 상왕십리역 4번 출구 앞,201904,827,707,1534,37.563858,127.030319
성동구,520, 상왕십리역 4번 출구 앞,201905,472,490,962,37.563858,127.030319
성동구,520, 상왕십리역 4번 출구 앞,201906,930,886,1816,37.563858,127.030319
성동구,520, 상왕십리역 4번 출구 앞,201907,1018,930,1948,37.563858,127.030319
성동구,520, 상왕십리역 4번 출구 앞,201908,968,935,1903,37.563858,127.030319
성동구,520, 상왕십리역 4번 출구 앞,201909,772,762,1534,37.563858,127.030319
성동구,520, 상왕십리역 4번 출구 앞,201910,914,890,1804,37.563858,127.030319
성동구,520, 상왕십리역 4번 출구 앞,201911,668,639,1307,37.563858,127.030319
성동구,520, 상왕십리역 4번 출구 앞,201912,436,425,861,37.563858,127.030319
성동구,520, 상왕십리역 4번 출구 앞,202001,423,420,843,37.563858,127.030319
성동구,520, 상왕십리역 4번 출구 앞,202002,518,443,961,37.563858,127.030319
성동구,520, 상왕십리역 4번 출구 앞,202003,662,644,1306,37.563858,127.030319
성동구,520, 상왕십리역 4번 출구 앞,202004,814,804,1618,37.563858,127.030319
성동구,520, 상왕십리역 4번 출구 앞,202005,712,713,1425,37.563858,127.030319
성동구,520, 상왕십리역 4번 출구 앞,202006,858,848,1706,37.563858,127.030319
성동구,521, 왕십리역 11번 출구 앞,201901,594,641,1235,37.561447,127.03492
성동구,521, 왕십리역 11번 출구 앞,201902,549,561,1110,37.561447,127.03492
성동구,521, 왕십리역 11번 출구 앞,201903,987,1012,1999,37.561447,127.03492
성동구,521, 왕십리역 11번 출구 앞,201904,1437,1447,2884,37.561447,127.03492
성동구,521, 왕십리역 11번 출구 앞,201905,2272,2256,4528,37.561447,127.03492
성동구,521, 왕십리역 11번 출구 앞,201906,2200,2199,4399,37.561447,127.03492
성동구,521, 왕십리역 11번 출구 앞,201907,2225,2233,4458,37.561447,127.03492
성동구,521, 왕십리역 11번 출구 앞,201908,1948,1949,3897,37.561447,127.03492
성동구,521, 왕십리역 11번 출구 앞,201909,1922,1974,3896,37.561447,127.03492
성동구,521, 왕십리역 11번 출구 앞,201910,2309,2307,4616,37.561447,127.03492
성동구,521, 왕십리역 11번 출구 앞,201911,1512,1532,3044,37.561447,127.03492
성동구,521, 왕십리역 11번 출구 앞,201912,915,919,1834,37.561447,127.03492
성동구,521, 왕십리역 11번 출구 앞,202001,890,896,1786,37.561447,127.03492
성동구,521, 왕십리역 11번 출구 앞,202002,787,790,1577,37.561447,127.03492
성동구,521, 왕십리역 11번 출구 앞,202003,1402,1404,2806,37.561447,127.03492
성동구,521, 왕십리역 11번 출구 앞,202004,1949,1960,3909,37.561447,127.03492
성동구,521, 왕십리역 11번 출구 앞,202005,2138,2139,4277,37.561447,127.03492
성동구,521, 왕십리역 11번 출구 앞,202006,2124,2120,4244,37.561447,127.03492
성동구,522, 금호역 1번출구 앞,201901,90,104,194,37.548641,127.016426
성동구,522, 금호역 1번출구 앞,201902,117,110,227,37.548641,127.016426
성동구,522, 금호역 1번출구 앞,201903,132,152,284,37.548641,127.016426
성동구,522, 금호역 1번출구 앞,201904,210,212,422,37.548641,127.016426
성동구,522, 금호역 1번출구 앞,201905,370,364,734,37.548641,127.016426
성동구,522, 금호역 1번출구 앞,201906,454,457,911,37.548641,127.016426
성동구,522, 금호역 1번출구 앞,201907,379,395,774,37.548641,127.016426
성동구,522, 금호역 1번출구 앞,201908,313,300,613,37.548641,127.016426
성동구,522, 금호역 1번출구 앞,201909,311,302,613,37.548641,127.016426
성동구,522, 금호역 1번출구 앞,201910,421,424,845,37.548641,127.016426
성동구,522, 금호역 1번출구 앞,201911,272,283,555,37.548641,127.016426
성동구,522, 금호역 1번출구 앞,201912,145,149,294,37.548641,127.016426
성동구,522, 금호역 1번출구 앞,202001,144,149,293,37.548641,127.016426
성동구,522, 금호역 1번출구 앞,202002,123,124,247,37.548641,127.016426
성동구,522, 금호역 1번출구 앞,202003,223,214,437,37.548641,127.016426
성동구,522, 금호역 1번출구 앞,202004,342,341,683,37.548641,127.016426
성동구,522, 금호역 1번출구 앞,202005,441,432,873,37.548641,127.016426
성동구,522, 금호역 1번출구 앞,202006,426,417,843,37.548641,127.016426
성동구,523, 옥수동성당 옆,201901,64,11,75,37.543663,127.014061
성동구,523, 옥수동성당 옆,201902,62,17,79,37.543663,127.014061
성동구,523, 옥수동성당 옆,201903,127,28,155,37.543663,127.014061
성동구,523, 옥수동성당 옆,201904,139,57,196,37.543663,127.014061
성동구,523, 옥수동성당 옆,201905,157,64,221,37.543663,127.014061
성동구,523, 옥수동성당 옆,201906,168,76,244,37.543663,127.014061
성동구,523, 옥수동성당 옆,201907,114,52,166,37.543663,127.014061
성동구,523, 옥수동성당 옆,201908,92,46,138,37.543663,127.014061
성동구,523, 옥수동성당 옆,201909,85,45,130,37.543663,127.014061
성동구,523, 옥수동성당 옆,201910,154,58,212,37.543663,127.014061
성동구,523, 옥수동성당 옆,201911,108,44,152,37.543663,127.014061
성동구,523, 옥수동성당 옆,201912,86,27,113,37.543663,127.014061
성동구,523, 옥수동성당 옆,202001,77,17,94,37.543663,127.014061
성동구,523, 옥수동성당 옆,202002,69,27,96,37.543663,127.014061
성동구,523, 옥수동성당 옆,202003,93,41,134,37.543663,127.014061
성동구,523, 옥수동성당 옆,202004,75,51,126,37.543663,127.014061
성동구,523, 옥수동성당 옆,202005,79,65,144,37.543663,127.014061
성동구,523, 옥수동성당 옆,202006,69,55,124,37.543663,127.014061
성동구,524, 래미안금호하이리버 아파트 102동 옆,201901,159,77,236,37.5522,127.025055
성동구,524, 래미안금호하이리버 아파트 102동 옆,201902,147,73,220,37.5522,127.025055
성동구,524, 래미안금호하이리버 아파트 102동 옆,201903,237,155,392,37.5522,127.025055
성동구,524, 래미안금호하이리버 아파트 102동 옆,201904,359,293,652,37.5522,127.025055
성동구,524, 래미안금호하이리버 아파트 102동 옆,201905,542,486,1028,37.5522,127.025055
성동구,524, 래미안금호하이리버 아파트 102동 옆,201906,542,472,1014,37.5522,127.025055
성동구,524, 래미안금호하이리버 아파트 102동 옆,201907,489,392,881,37.5522,127.025055
성동구,524, 래미안금호하이리버 아파트 102동 옆,201908,454,373,827,37.5522,127.025055
성동구,524, 래미안금호하이리버 아파트 102동 옆,201909,386,369,755,37.5522,127.025055
성동구,524, 래미안금호하이리버 아파트 102동 옆,201910,410,380,790,37.5522,127.025055
성동구,524, 래미안금호하이리버 아파트 102동 옆,201911,273,262,535,37.5522,127.025055
성동구,524, 래미안금호하이리버 아파트 102동 옆,201912,236,173,409,37.5522,127.025055
성동구,524, 래미안금호하이리버 아파트 102동 옆,202001,179,140,319,37.5522,127.025055
성동구,524, 래미안금호하이리버 아파트 102동 옆,202002,114,86,200,37.5522,127.025055
성동구,524, 래미안금호하이리버 아파트 102동 옆,202003,381,316,697,37.5522,127.025055
성동구,524, 래미안금호하이리버 아파트 102동 옆,202004,550,521,1071,37.5522,127.025055
성동구,524, 래미안금호하이리버 아파트 102동 옆,202005,572,553,1125,37.5522,127.025055
성동구,524, 래미안금호하이리버 아파트 102동 옆,202006,560,536,1096,37.5522,127.025055
성동구,525, 한양대병원사거리,201901,734,639,1373,37.558052,127.040352
성동구,525, 한양대병원사거리,201902,786,671,1457,37.558052,127.040352
성동구,525, 한양대병원사거리,201903,1817,1743,3560,37.558052,127.040352
성동구,525, 한양대병원사거리,201904,2849,2729,5578,37.558052,127.040352
성동구,525, 한양대병원사거리,201905,4478,4342,8820,37.558052,127.040352
성동구,525, 한양대병원사거리,201906,3842,3813,7655,37.558052,127.040352
성동구,525, 한양대병원사거리,201907,3373,3337,6710,37.558052,127.040352
성동구,525, 한양대병원사거리,201908,3086,3067,6153,37.558052,127.040352
성동구,525, 한양대병원사거리,201909,3369,3504,6873,37.558052,127.040352
성동구,525, 한양대병원사거리,201910,3920,3957,7877,37.558052,127.040352
성동구,525, 한양대병원사거리,201911,2275,2302,4577,37.558052,127.040352
성동구,525, 한양대병원사거리,201912,1151,1077,2228,37.558052,127.040352
성동구,525, 한양대병원사거리,202001,1156,1056,2212,37.558052,127.040352
성동구,525, 한양대병원사거리,202002,1212,1171,2383,37.558052,127.040352
성동구,525, 한양대병원사거리,202003,3122,3153,6275,37.558052,127.040352
성동구,525, 한양대병원사거리,202004,4204,4230,8434,37.558052,127.040352
성동구,525, 한양대병원사거리,202005,4290,4310,8600,37.558052,127.040352
성동구,525, 한양대병원사거리,202006,3178,3182,6360,37.558052,127.040352
성동구,526, 용답토속공원 앞,201901,401,467,868,37.563511,127.056725
성동구,526, 용답토속공원 앞,201902,292,367,659,37.563511,127.056725
성동구,526, 용답토속공원 앞,201903,666,682,1348,37.563511,127.056725
성동구,526, 용답토속공원 앞,201904,939,949,1888,37.563511,127.056725
성동구,526, 용답토속공원 앞,201905,1283,1302,2585,37.563511,127.056725
성동구,526, 용답토속공원 앞,201906,1388,1433,2821,37.563511,127.056725
성동구,526, 용답토속공원 앞,201907,1379,1497,2876,37.563511,127.056725
성동구,526, 용답토속공원 앞,201908,1503,1556,3059,37.563511,127.056725
성동구,526, 용답토속공원 앞,201909,1330,1338,2668,37.563511,127.056725
성동구,526, 용답토속공원 앞,201910,1539,1613,3152,37.563511,127.056725
성동구,526, 용답토속공원 앞,201911,1049,1094,2143,37.563511,127.056725
성동구,526, 용답토속공원 앞,201912,713,767,1480,37.563511,127.056725
성동구,526, 용답토속공원 앞,202001,533,545,1078,37.563511,127.056725
성동구,526, 용답토속공원 앞,202002,588,571,1159,37.563511,127.056725
성동구,526, 용답토속공원 앞,202003,911,897,1808,37.563511,127.056725
성동구,526, 용답토속공원 앞,202004,1327,1351,2678,37.563511,127.056725
성동구,526, 용답토속공원 앞,202005,1278,1299,2577,37.563511,127.056725
성동구,526, 용답토속공원 앞,202006,1190,1250,2440,37.563511,127.056725
성동구,529, 장한평역 8번 출구 앞,201901,565,470,1035,37.561371,127.06366
성동구,529, 장한평역 8번 출구 앞,201902,410,403,813,37.561371,127.06366
성동구,529, 장한평역 8번 출구 앞,201903,795,636,1431,37.561371,127.06366
성동구,529, 장한평역 8번 출구 앞,201904,977,839,1816,37.561371,127.06366
성동구,529, 장한평역 8번 출구 앞,201905,1660,1264,2924,37.561371,127.06366
성동구,529, 장한평역 8번 출구 앞,201906,1697,1438,3135,37.561371,127.06366
성동구,529, 장한평역 8번 출구 앞,201907,1690,1333,3023,37.561371,127.06366
성동구,529, 장한평역 8번 출구 앞,201908,1538,1277,2815,37.561371,127.06366
성동구,529, 장한평역 8번 출구 앞,201909,1402,1121,2523,37.561371,127.06366
성동구,529, 장한평역 8번 출구 앞,201910,1710,1539,3249,37.561371,127.06366
성동구,529, 장한평역 8번 출구 앞,201911,1297,1093,2390,37.561371,127.06366
성동구,529, 장한평역 8번 출구 앞,201912,795,694,1489,37.561371,127.06366
성동구,529, 장한평역 8번 출구 앞,202001,651,573,1224,37.561371,127.06366
성동구,529, 장한평역 8번 출구 앞,202002,650,556,1206,37.561371,127.06366
성동구,529, 장한평역 8번 출구 앞,202003,1085,838,1923,37.561371,127.06366
성동구,529, 장한평역 8번 출구 앞,202004,1103,1041,2144,37.561371,127.06366
성동구,529, 장한평역 8번 출구 앞,202005,1148,1130,2278,37.561371,127.06366
성동구,529, 장한평역 8번 출구 앞,202006,1275,1201,2476,37.561371,127.06366
성동구,530, 청계벽산아파트 앞,201901,387,396,783,37.568748,127.030403
성동구,530, 청계벽산아파트 앞,201902,328,356,684,37.568748,127.030403
성동구,530, 청계벽산아파트 앞,201903,693,673,1366,37.568748,127.030403
성동구,530, 청계벽산아파트 앞,201904,893,887,1780,37.568748,127.030403
성동구,530, 청계벽산아파트 앞,201905,1548,1510,3058,37.568748,127.030403
성동구,530, 청계벽산아파트 앞,201906,1564,1545,3109,37.568748,127.030403
성동구,530, 청계벽산아파트 앞,201907,1754,1843,3597,37.568748,127.030403
성동구,530, 청계벽산아파트 앞,201908,1660,1735,3395,37.568748,127.030403
성동구,530, 청계벽산아파트 앞,201909,1448,1477,2925,37.568748,127.030403
성동구,530, 청계벽산아파트 앞,201910,1733,1758,3491,37.568748,127.030403
성동구,530, 청계벽산아파트 앞,201911,1195,1231,2426,37.568748,127.030403
성동구,530, 청계벽산아파트 앞,201912,811,851,1662,37.568748,127.030403
성동구,530, 청계벽산아파트 앞,202001,756,822,1578,37.568748,127.030403
성동구,530, 청계벽산아파트 앞,202002,859,887,1746,37.568748,127.030403
성동구,530, 청계벽산아파트 앞,202003,1374,1380,2754,37.568748,127.030403
성동구,530, 청계벽산아파트 앞,202004,1656,1663,3319,37.568748,127.030403
성동구,530, 청계벽산아파트 앞,202005,1951,1959,3910,37.568748,127.030403
성동구,530, 청계벽산아파트 앞,202006,2063,2079,4142,37.568748,127.030403
성동구,533, 우리은행 금호동 지점 앞,201901,99,132,231,37.548149,127.021088
성동구,533, 우리은행 금호동 지점 앞,201902,78,116,194,37.548149,127.021088
성동구,533, 우리은행 금호동 지점 앞,201903,163,253,416,37.548149,127.021088
성동구,533, 우리은행 금호동 지점 앞,201904,294,452,746,37.548149,127.021088
성동구,533, 우리은행 금호동 지점 앞,201905,587,617,1204,37.548149,127.021088
성동구,533, 우리은행 금호동 지점 앞,201906,609,719,1328,37.548149,127.021088
성동구,533, 우리은행 금호동 지점 앞,201907,535,669,1204,37.548149,127.021088
성동구,533, 우리은행 금호동 지점 앞,201908,486,589,1075,37.548149,127.021088
성동구,533, 우리은행 금호동 지점 앞,201909,535,626,1161,37.548149,127.021088
성동구,533, 우리은행 금호동 지점 앞,201910,535,676,1211,37.548149,127.021088
성동구,533, 우리은행 금호동 지점 앞,201911,301,408,709,37.548149,127.021088
성동구,533, 우리은행 금호동 지점 앞,201912,178,273,451,37.548149,127.021088
성동구,533, 우리은행 금호동 지점 앞,202001,137,216,353,37.548149,127.021088
성동구,533, 우리은행 금호동 지점 앞,202002,117,197,314,37.548149,127.021088
성동구,533, 우리은행 금호동 지점 앞,202003,345,374,719,37.548149,127.021088
성동구,533, 우리은행 금호동 지점 앞,202004,580,629,1209,37.548149,127.021088
성동구,533, 우리은행 금호동 지점 앞,202005,752,772,1524,37.548149,127.021088
성동구,533, 우리은행 금호동 지점 앞,202006,712,725,1437,37.548149,127.021088
성동구,534, 금호사거리,201901,149,123,272,37.548634,127.025726
성동구,534, 금호사거리,201902,122,118,240,37.548634,127.025726
성동구,534, 금호사거리,201903,261,200,461,37.548634,127.025726
성동구,534, 금호사거리,201904,339,325,664,37.548634,127.025726
성동구,534, 금호사거리,201905,442,409,851,37.548634,127.025726
성동구,534, 금호사거리,201906,496,472,968,37.548634,127.025726
성동구,534, 금호사거리,201907,427,412,839,37.548634,127.025726
성동구,534, 금호사거리,201908,388,367,755,37.548634,127.025726
성동구,534, 금호사거리,201909,336,342,678,37.548634,127.025726
성동구,534, 금호사거리,201910,410,416,826,37.548634,127.025726
성동구,534, 금호사거리,201911,281,286,567,37.548634,127.025726
성동구,534, 금호사거리,201912,247,228,475,37.548634,127.025726
성동구,534, 금호사거리,202001,210,191,401,37.548634,127.025726
성동구,534, 금호사거리,202002,192,175,367,37.548634,127.025726
성동구,534, 금호사거리,202003,282,286,568,37.548634,127.025726
성동구,534, 금호사거리,202004,432,433,865,37.548634,127.025726
성동구,534, 금호사거리,202005,396,397,793,37.548634,127.025726
성동구,534, 금호사거리,202006,395,394,789,37.548634,127.025726
성동구,535, 응봉삼거리,201901,231,115,346,37.553986,127.033592
성동구,535, 응봉삼거리,201902,208,107,315,37.553986,127.033592
성동구,535, 응봉삼거리,201903,386,216,602,37.553986,127.033592
성동구,535, 응봉삼거리,201904,649,399,1048,37.553986,127.033592
성동구,535, 응봉삼거리,201905,727,559,1286,37.553986,127.033592
성동구,535, 응봉삼거리,201906,785,589,1374,37.553986,127.033592
성동구,535, 응봉삼거리,201907,791,534,1325,37.553986,127.033592
성동구,535, 응봉삼거리,201908,792,503,1295,37.553986,127.033592
성동구,535, 응봉삼거리,201909,598,468,1066,37.553986,127.033592
성동구,535, 응봉삼거리,201910,881,723,1604,37.553986,127.033592
성동구,535, 응봉삼거리,201911,569,381,950,37.553986,127.033592
성동구,535, 응봉삼거리,201912,513,216,729,37.553986,127.033592
성동구,535, 응봉삼거리,202001,374,173,547,37.553986,127.033592
성동구,535, 응봉삼거리,202002,385,214,599,37.553986,127.033592
성동구,535, 응봉삼거리,202003,549,355,904,37.553986,127.033592
성동구,535, 응봉삼거리,202004,787,553,1340,37.553986,127.033592
성동구,535, 응봉삼거리,202005,818,648,1466,37.553986,127.033592
성동구,535, 응봉삼거리,202006,770,584,1354,37.553986,127.033592
성동구,536, 행당역 2번출구 앞,201901,201,257,458,37.55735,127.029213
성동구,536, 행당역 2번출구 앞,201902,213,263,476,37.55735,127.029213
성동구,536, 행당역 2번출구 앞,201903,499,522,1021,37.55735,127.029213
성동구,536, 행당역 2번출구 앞,201904,749,878,1627,37.55735,127.029213
성동구,536, 행당역 2번출구 앞,201905,1163,1155,2318,37.55735,127.029213
성동구,536, 행당역 2번출구 앞,201906,1216,1238,2454,37.55735,127.029213
성동구,536, 행당역 2번출구 앞,201907,1132,1130,2262,37.55735,127.029213
성동구,536, 행당역 2번출구 앞,201908,965,1009,1974,37.55735,127.029213
성동구,536, 행당역 2번출구 앞,201909,968,1004,1972,37.55735,127.029213
성동구,536, 행당역 2번출구 앞,201910,1049,1073,2122,37.55735,127.029213
성동구,536, 행당역 2번출구 앞,201911,646,678,1324,37.55735,127.029213
성동구,536, 행당역 2번출구 앞,201912,431,555,986,37.55735,127.029213
성동구,536, 행당역 2번출구 앞,202001,370,434,804,37.55735,127.029213
성동구,536, 행당역 2번출구 앞,202002,363,406,769,37.55735,127.029213
성동구,536, 행당역 2번출구 앞,202003,818,854,1672,37.55735,127.029213
성동구,536, 행당역 2번출구 앞,202004,1204,1228,2432,37.55735,127.029213
성동구,536, 행당역 2번출구 앞,202005,1272,1278,2550,37.55735,127.029213
성동구,536, 행당역 2번출구 앞,202006,1285,1300,2585,37.55735,127.029213
성동구,537, 한양대후문역 부근,201901,357,332,689,37.560356,127.041397
성동구,537, 한양대후문역 부근,201902,301,307,608,37.560356,127.041397
성동구,537, 한양대후문역 부근,201903,643,664,1307,37.560356,127.041397
성동구,537, 한양대후문역 부근,201904,1127,1133,2260,37.560356,127.041397
성동구,537, 한양대후문역 부근,201905,1882,1899,3781,37.560356,127.041397
성동구,537, 한양대후문역 부근,201906,1659,1659,3318,37.560356,127.041397
성동구,537, 한양대후문역 부근,201907,1707,1704,3411,37.560356,127.041397
성동구,537, 한양대후문역 부근,201908,1495,1502,2997,37.560356,127.041397
성동구,537, 한양대후문역 부근,201909,1537,1565,3102,37.560356,127.041397
성동구,537, 한양대후문역 부근,201910,1880,1881,3761,37.560356,127.041397
성동구,537, 한양대후문역 부근,201911,1194,1199,2393,37.560356,127.041397
성동구,537, 한양대후문역 부근,201912,551,565,1116,37.560356,127.041397
성동구,537, 한양대후문역 부근,202001,473,470,943,37.560356,127.041397
성동구,537, 한양대후문역 부근,202002,532,547,1079,37.560356,127.041397
성동구,537, 한양대후문역 부근,202003,1338,1359,2697,37.560356,127.041397
성동구,537, 한양대후문역 부근,202004,1701,1706,3407,37.560356,127.041397
성동구,537, 한양대후문역 부근,202005,2092,2077,4169,37.560356,127.041397
성동구,537, 한양대후문역 부근,202006,1990,1987,3977,37.560356,127.041397
성동구,538, 답십리역 8번출구 앞,201901,305,325,630,37.56765,127.051155
성동구,538, 답십리역 8번출구 앞,201902,315,339,654,37.56765,127.051155
성동구,538, 답십리역 8번출구 앞,201903,570,534,1104,37.56765,127.051155
성동구,538, 답십리역 8번출구 앞,201904,900,826,1726,37.56765,127.051155
성동구,538, 답십리역 8번출구 앞,201905,1217,1133,2350,37.56765,127.051155
성동구,538, 답십리역 8번출구 앞,201906,1149,1145,2294,37.56765,127.051155
성동구,538, 답십리역 8번출구 앞,201907,1102,1054,2156,37.56765,127.051155
성동구,538, 답십리역 8번출구 앞,201908,1047,1018,2065,37.56765,127.051155
성동구,538, 답십리역 8번출구 앞,201909,942,905,1847,37.56765,127.051155
성동구,538, 답십리역 8번출구 앞,201910,1233,1225,2458,37.56765,127.051155
성동구,538, 답십리역 8번출구 앞,201911,784,763,1547,37.56765,127.051155
성동구,538, 답십리역 8번출구 앞,201912,430,468,898,37.56765,127.051155
성동구,538, 답십리역 8번출구 앞,202001,363,371,734,37.56765,127.051155
성동구,538, 답십리역 8번출구 앞,202002,326,336,662,37.56765,127.051155
성동구,538, 답십리역 8번출구 앞,202003,565,574,1139,37.56765,127.051155
성동구,538, 답십리역 8번출구 앞,202004,635,633,1268,37.56765,127.051155
성동구,538, 답십리역 8번출구 앞,202005,802,809,1611,37.56765,127.051155
성동구,538, 답십리역 8번출구 앞,202006,1085,1106,2191,37.56765,127.051155
광진구,539, 군자교교차로,201901,321,287,608,37.559795,127.074203
광진구,539, 군자교교차로,201902,353,349,702,37.559795,127.074203
광진구,539, 군자교교차로,201903,810,791,1601,37.559795,127.074203
광진구,539, 군자교교차로,201904,1378,1431,2809,37.559795,127.074203
광진구,539, 군자교교차로,201905,2086,2067,4153,37.559795,127.074203
광진구,539, 군자교교차로,201906,2119,2128,4247,37.559795,127.074203
광진구,539, 군자교교차로,201907,1930,1933,3863,37.559795,127.074203
광진구,539, 군자교교차로,201908,1980,1950,3930,37.559795,127.074203
광진구,539, 군자교교차로,201909,1815,1809,3624,37.559795,127.074203
광진구,539, 군자교교차로,201910,1924,1909,3833,37.559795,127.074203
광진구,539, 군자교교차로,201911,1054,1045,2099,37.559795,127.074203
광진구,539, 군자교교차로,201912,548,528,1076,37.559795,127.074203
광진구,539, 군자교교차로,202001,581,569,1150,37.559795,127.074203
광진구,539, 군자교교차로,202002,640,615,1255,37.559795,127.074203
광진구,539, 군자교교차로,202003,1589,1624,3213,37.559795,127.074203
광진구,539, 군자교교차로,202004,2402,2394,4796,37.559795,127.074203
광진구,539, 군자교교차로,202005,2599,2607,5206,37.559795,127.074203
광진구,539, 군자교교차로,202006,2651,2633,5284,37.559795,127.074203
광진구,540, 군자역 7번출구 베스트샵 앞,201901,761,820,1581,37.55603,127.078644
광진구,540, 군자역 7번출구 베스트샵 앞,201902,536,549,1085,37.55603,127.078644
광진구,540, 군자역 7번출구 베스트샵 앞,201903,1069,1098,2167,37.55603,127.078644
광진구,540, 군자역 7번출구 베스트샵 앞,201904,1642,1686,3328,37.55603,127.078644
광진구,540, 군자역 7번출구 베스트샵 앞,201905,2551,2526,5077,37.55603,127.078644
광진구,540, 군자역 7번출구 베스트샵 앞,201906,2584,2609,5193,37.55603,127.078644
광진구,540, 군자역 7번출구 베스트샵 앞,201907,2556,2560,5116,37.55603,127.078644
광진구,540, 군자역 7번출구 베스트샵 앞,201908,2338,2328,4666,37.55603,127.078644
광진구,540, 군자역 7번출구 베스트샵 앞,201909,2088,2078,4166,37.55603,127.078644
광진구,540, 군자역 7번출구 베스트샵 앞,201910,2492,2500,4992,37.55603,127.078644
광진구,540, 군자역 7번출구 베스트샵 앞,201911,1599,1606,3205,37.55603,127.078644
광진구,540, 군자역 7번출구 베스트샵 앞,201912,933,937,1870,37.55603,127.078644
광진구,540, 군자역 7번출구 베스트샵 앞,202001,737,732,1469,37.55603,127.078644
광진구,540, 군자역 7번출구 베스트샵 앞,202002,651,653,1304,37.55603,127.078644
광진구,540, 군자역 7번출구 베스트샵 앞,202003,1250,1249,2499,37.55603,127.078644
광진구,540, 군자역 7번출구 베스트샵 앞,202004,1847,1844,3691,37.55603,127.078644
광진구,540, 군자역 7번출구 베스트샵 앞,202005,2138,2139,4277,37.55603,127.078644
광진구,540, 군자역 7번출구 베스트샵 앞,202006,2406,2383,4789,37.55603,127.078644
광진구,542, 강변역 4번출구 뒤,201901,398,428,826,37.535465,127.094482
광진구,542, 강변역 4번출구 뒤,201902,411,420,831,37.535465,127.094482
광진구,542, 강변역 4번출구 뒤,201903,911,950,1861,37.535465,127.094482
광진구,542, 강변역 4번출구 뒤,201904,1520,1536,3056,37.535465,127.094482
광진구,542, 강변역 4번출구 뒤,201905,2743,2813,5556,37.535465,127.094482
광진구,542, 강변역 4번출구 뒤,201906,2776,2762,5538,37.535465,127.094482
광진구,542, 강변역 4번출구 뒤,201907,2304,2294,4598,37.535465,127.094482
광진구,542, 강변역 4번출구 뒤,201908,2304,2305,4609,37.535465,127.094482
광진구,542, 강변역 4번출구 뒤,201909,2399,2378,4777,37.535465,127.094482
광진구,542, 강변역 4번출구 뒤,201910,2653,2657,5310,37.535465,127.094482
광진구,542, 강변역 4번출구 뒤,201911,1308,1316,2624,37.535465,127.094482
광진구,542, 강변역 4번출구 뒤,201912,638,630,1268,37.535465,127.094482
광진구,542, 강변역 4번출구 뒤,202001,703,698,1401,37.535465,127.094482
광진구,542, 강변역 4번출구 뒤,202002,606,616,1222,37.535465,127.094482
광진구,542, 강변역 4번출구 뒤,202003,1861,1871,3732,37.535465,127.094482
광진구,542, 강변역 4번출구 뒤,202004,2451,2441,4892,37.535465,127.094482
광진구,542, 강변역 4번출구 뒤,202005,2875,2868,5743,37.535465,127.094482
광진구,542, 강변역 4번출구 뒤,202006,3127,3108,6235,37.535465,127.094482
광진구,543, 구의공원(테크노마트 앞),201901,416,366,782,37.535969,127.094673
광진구,543, 구의공원(테크노마트 앞),201902,461,391,852,37.535969,127.094673
광진구,543, 구의공원(테크노마트 앞),201903,679,621,1300,37.535969,127.094673
광진구,543, 구의공원(테크노마트 앞),201904,1297,1196,2493,37.535969,127.094673
광진구,543, 구의공원(테크노마트 앞),201905,1966,1811,3777,37.535969,127.094673
광진구,543, 구의공원(테크노마트 앞),201906,2094,1977,4071,37.535969,127.094673
광진구,543, 구의공원(테크노마트 앞),201907,1867,1789,3656,37.535969,127.094673
광진구,543, 구의공원(테크노마트 앞),201908,1865,1737,3602,37.535969,127.094673
광진구,543, 구의공원(테크노마트 앞),201909,1789,1688,3477,37.535969,127.094673
광진구,543, 구의공원(테크노마트 앞),201910,2090,1966,4056,37.535969,127.094673
광진구,543, 구의공원(테크노마트 앞),201911,1272,1208,2480,37.535969,127.094673
광진구,543, 구의공원(테크노마트 앞),201912,768,755,1523,37.535969,127.094673
광진구,543, 구의공원(테크노마트 앞),202001,767,758,1525,37.535969,127.094673
광진구,543, 구의공원(테크노마트 앞),202002,700,685,1385,37.535969,127.094673
광진구,543, 구의공원(테크노마트 앞),202003,1319,1266,2585,37.535969,127.094673
광진구,543, 구의공원(테크노마트 앞),202004,1533,1527,3060,37.535969,127.094673
광진구,543, 구의공원(테크노마트 앞),202005,1597,1585,3182,37.535969,127.094673
광진구,543, 구의공원(테크노마트 앞),202006,1054,1069,2123,37.535969,127.094673
광진구,544, 광남중학교,201901,139,166,305,37.54073,127.102905
광진구,544, 광남중학교,201902,228,261,489,37.54073,127.102905
광진구,544, 광남중학교,201903,428,449,877,37.54073,127.102905
광진구,544, 광남중학교,201904,695,774,1469,37.54073,127.102905
광진구,544, 광남중학교,201905,1075,1085,2160,37.54073,127.102905
광진구,544, 광남중학교,201906,1156,1158,2314,37.54073,127.102905
광진구,544, 광남중학교,201907,989,1020,2009,37.54073,127.102905
광진구,544, 광남중학교,201908,1181,1222,2403,37.54073,127.102905
광진구,544, 광남중학교,201909,1164,1229,2393,37.54073,127.102905
광진구,544, 광남중학교,201910,1155,1153,2308,37.54073,127.102905
광진구,544, 광남중학교,201911,588,600,1188,37.54073,127.102905
광진구,544, 광남중학교,201912,331,328,659,37.54073,127.102905
광진구,544, 광남중학교,202001,280,294,574,37.54073,127.102905
광진구,544, 광남중학교,202002,309,342,651,37.54073,127.102905
광진구,544, 광남중학교,202003,1422,1420,2842,37.54073,127.102905
광진구,544, 광남중학교,202004,1878,1899,3777,37.54073,127.102905
광진구,544, 광남중학교,202005,1918,1916,3834,37.54073,127.102905
광진구,544, 광남중학교,202006,1657,1676,3333,37.54073,127.102905
광진구,546, 잠실대교북단 교차로,201901,347,413,760,37.532478,127.085091
광진구,546, 잠실대교북단 교차로,201902,408,420,828,37.532478,127.085091
광진구,546, 잠실대교북단 교차로,201903,826,799,1625,37.532478,127.085091
광진구,546, 잠실대교북단 교차로,201904,1149,1232,2381,37.532478,127.085091
광진구,546, 잠실대교북단 교차로,201905,1785,1813,3598,37.532478,127.085091
광진구,546, 잠실대교북단 교차로,201906,2038,2042,4080,37.532478,127.085091
광진구,546, 잠실대교북단 교차로,201907,1756,1771,3527,37.532478,127.085091
광진구,546, 잠실대교북단 교차로,201908,1703,1694,3397,37.532478,127.085091
광진구,546, 잠실대교북단 교차로,201909,1713,1737,3450,37.532478,127.085091
광진구,546, 잠실대교북단 교차로,201910,2057,2078,4135,37.532478,127.085091
광진구,546, 잠실대교북단 교차로,201911,1395,1381,2776,37.532478,127.085091
광진구,546, 잠실대교북단 교차로,201912,879,878,1757,37.532478,127.085091
광진구,546, 잠실대교북단 교차로,202001,735,738,1473,37.532478,127.085091
광진구,546, 잠실대교북단 교차로,202002,642,664,1306,37.532478,127.085091
광진구,546, 잠실대교북단 교차로,202003,1231,1217,2448,37.532478,127.085091
광진구,546, 잠실대교북단 교차로,202004,1588,1580,3168,37.532478,127.085091
광진구,546, 잠실대교북단 교차로,202005,1714,1722,3436,37.532478,127.085091
광진구,546, 잠실대교북단 교차로,202006,1797,1809,3606,37.532478,127.085091
광진구,548, 자양나들목,201901,662,527,1189,37.52977,127.07486
광진구,548, 자양나들목,201902,570,527,1097,37.52977,127.07486
광진구,548, 자양나들목,201903,1115,986,2101,37.52977,127.07486
광진구,548, 자양나들목,201904,1748,1603,3351,37.52977,127.07486
광진구,548, 자양나들목,201905,2759,2636,5395,37.52977,127.07486
광진구,548, 자양나들목,201906,2433,2390,4823,37.52977,127.07486
광진구,548, 자양나들목,201907,2456,2373,4829,37.52977,127.07486
광진구,548, 자양나들목,201908,2672,2688,5360,37.52977,127.07486
광진구,548, 자양나들목,201909,2563,2451,5014,37.52977,127.07486
광진구,548, 자양나들목,201910,2682,2674,5356,37.52977,127.07486
광진구,548, 자양나들목,201911,1567,1519,3086,37.52977,127.07486
광진구,548, 자양나들목,201912,992,931,1923,37.52977,127.07486
광진구,548, 자양나들목,202001,968,883,1851,37.52977,127.07486
광진구,548, 자양나들목,202002,895,865,1760,37.52977,127.07486
광진구,548, 자양나들목,202003,2110,2118,4228,37.52977,127.07486
광진구,548, 자양나들목,202004,2504,2532,5036,37.52977,127.07486
광진구,548, 자양나들목,202005,2531,2558,5089,37.52977,127.07486
광진구,548, 자양나들목,202006,2410,2444,4854,37.52977,127.07486
광진구,549, 아차산역 3번출구,201901,712,723,1435,37.551224,127.089706
광진구,549, 아차산역 3번출구,201902,638,675,1313,37.551224,127.089706
광진구,549, 아차산역 3번출구,201903,1091,1141,2232,37.551224,127.089706
광진구,549, 아차산역 3번출구,201904,1634,1710,3344,37.551224,127.089706
광진구,549, 아차산역 3번출구,201905,2814,2886,5700,37.551224,127.089706
광진구,549, 아차산역 3번출구,201906,2880,2927,5807,37.551224,127.089706
광진구,549, 아차산역 3번출구,201907,2670,2661,5331,37.551224,127.089706
광진구,549, 아차산역 3번출구,201908,2575,2574,5149,37.551224,127.089706
광진구,549, 아차산역 3번출구,201909,2630,2659,5289,37.551224,127.089706
광진구,549, 아차산역 3번출구,201910,2522,2637,5159,37.551224,127.089706
광진구,549, 아차산역 3번출구,201911,63,83,146,37.551224,127.089706
광진구,549, 아차산역 3번출구,201912,879,872,1751,37.551224,127.089706
광진구,549, 아차산역 3번출구,202001,828,825,1653,37.551224,127.089706
광진구,549, 아차산역 3번출구,202002,798,792,1590,37.551224,127.089706
광진구,549, 아차산역 3번출구,202003,1739,1810,3549,37.551224,127.089706
광진구,549, 아차산역 3번출구,202004,2522,2518,5040,37.551224,127.089706
광진구,549, 아차산역 3번출구,202005,2649,2630,5279,37.551224,127.089706
광진구,549, 아차산역 3번출구,202006,2862,2851,5713,37.551224,127.089706
성동구,550, 서울시설공단 앞,201901,433,466,899,37.57164,127.03566
성동구,550, 서울시설공단 앞,201902,393,369,762,37.57164,127.03566
성동구,550, 서울시설공단 앞,201903,627,623,1250,37.57164,127.03566
성동구,550, 서울시설공단 앞,201904,923,862,1785,37.57164,127.03566
성동구,550, 서울시설공단 앞,201905,1235,1219,2454,37.57164,127.03566
성동구,550, 서울시설공단 앞,201906,1325,1250,2575,37.57164,127.03566
성동구,550, 서울시설공단 앞,201907,1329,1263,2592,37.57164,127.03566
성동구,550, 서울시설공단 앞,201908,1316,1228,2544,37.57164,127.03566
성동구,550, 서울시설공단 앞,201909,1215,1056,2271,37.57164,127.03566
성동구,550, 서울시설공단 앞,201910,1496,1350,2846,37.57164,127.03566
성동구,550, 서울시설공단 앞,201911,935,891,1826,37.57164,127.03566
성동구,550, 서울시설공단 앞,201912,618,618,1236,37.57164,127.03566
성동구,550, 서울시설공단 앞,202001,574,577,1151,37.57164,127.03566
성동구,550, 서울시설공단 앞,202002,683,653,1336,37.57164,127.03566
성동구,550, 서울시설공단 앞,202003,880,883,1763,37.57164,127.03566
성동구,550, 서울시설공단 앞,202004,1183,1194,2377,37.57164,127.03566
성동구,550, 서울시설공단 앞,202005,1168,1164,2332,37.57164,127.03566
성동구,550, 서울시설공단 앞,202006,1306,1299,2605,37.57164,127.03566
광진구,551, 구의삼성쉐르빌 앞,201901,621,743,1364,37.540062,127.094498
광진구,551, 구의삼성쉐르빌 앞,201902,683,719,1402,37.540062,127.094498
광진구,551, 구의삼성쉐르빌 앞,201903,1076,1129,2205,37.540062,127.094498
광진구,551, 구의삼성쉐르빌 앞,201904,1633,1676,3309,37.540062,127.094498
광진구,551, 구의삼성쉐르빌 앞,201905,2446,2468,4914,37.540062,127.094498
광진구,551, 구의삼성쉐르빌 앞,201906,2752,2772,5524,37.540062,127.094498
광진구,551, 구의삼성쉐르빌 앞,201907,3020,3019,6039,37.540062,127.094498
광진구,551, 구의삼성쉐르빌 앞,201908,2972,2977,5949,37.540062,127.094498
광진구,551, 구의삼성쉐르빌 앞,201909,2567,2583,5150,37.540062,127.094498
광진구,551, 구의삼성쉐르빌 앞,201910,3263,3281,6544,37.540062,127.094498
광진구,551, 구의삼성쉐르빌 앞,201911,2176,2256,4432,37.540062,127.094498
광진구,551, 구의삼성쉐르빌 앞,201912,1376,1373,2749,37.540062,127.094498
광진구,551, 구의삼성쉐르빌 앞,202001,1059,1140,2199,37.540062,127.094498
광진구,551, 구의삼성쉐르빌 앞,202002,976,1088,2064,37.540062,127.094498
광진구,551, 구의삼성쉐르빌 앞,202003,1924,2000,3924,37.540062,127.094498
광진구,551, 구의삼성쉐르빌 앞,202004,2580,2577,5157,37.540062,127.094498
광진구,551, 구의삼성쉐르빌 앞,202005,3062,3079,6141,37.540062,127.094498
광진구,551, 구의삼성쉐르빌 앞,202006,3488,3531,7019,37.540062,127.094498
광진구,552, 대림아크로리버 앞,201901,150,158,308,37.536579,127.092972
광진구,552, 대림아크로리버 앞,201902,135,147,282,37.536579,127.092972
광진구,552, 대림아크로리버 앞,201903,332,351,683,37.536579,127.092972
광진구,552, 대림아크로리버 앞,201904,586,559,1145,37.536579,127.092972
광진구,552, 대림아크로리버 앞,201905,916,883,1799,37.536579,127.092972
광진구,552, 대림아크로리버 앞,201906,1045,981,2026,37.536579,127.092972
광진구,552, 대림아크로리버 앞,201907,947,880,1827,37.536579,127.092972
광진구,552, 대림아크로리버 앞,201908,962,923,1885,37.536579,127.092972
광진구,552, 대림아크로리버 앞,201909,1002,999,2001,37.536579,127.092972
광진구,552, 대림아크로리버 앞,201910,1021,989,2010,37.536579,127.092972
광진구,552, 대림아크로리버 앞,201911,636,607,1243,37.536579,127.092972
광진구,552, 대림아크로리버 앞,201912,318,310,628,37.536579,127.092972
광진구,552, 대림아크로리버 앞,202001,267,267,534,37.536579,127.092972
광진구,552, 대림아크로리버 앞,202002,312,284,596,37.536579,127.092972
광진구,552, 대림아크로리버 앞,202003,444,456,900,37.536579,127.092972
광진구,552, 대림아크로리버 앞,202004,823,816,1639,37.536579,127.092972
광진구,552, 대림아크로리버 앞,202005,990,986,1976,37.536579,127.092972
광진구,552, 대림아크로리버 앞,202006,1078,1078,2156,37.536579,127.092972
광진구,553, 중곡 성원APT 앞,201901,231,213,444,37.571255,127.079803
광진구,553, 중곡 성원APT 앞,201902,210,201,411,37.571255,127.079803
광진구,553, 중곡 성원APT 앞,201903,475,488,963,37.571255,127.079803
광진구,553, 중곡 성원APT 앞,201904,789,807,1596,37.571255,127.079803
광진구,553, 중곡 성원APT 앞,201905,1191,1334,2525,37.571255,127.079803
광진구,553, 중곡 성원APT 앞,201906,1240,1380,2620,37.571255,127.079803
광진구,553, 중곡 성원APT 앞,201907,1084,1309,2393,37.571255,127.079803
광진구,553, 중곡 성원APT 앞,201908,1136,1389,2525,37.571255,127.079803
광진구,553, 중곡 성원APT 앞,201909,1164,1351,2515,37.571255,127.079803
광진구,553, 중곡 성원APT 앞,201910,1347,1474,2821,37.571255,127.079803
광진구,553, 중곡 성원APT 앞,201911,676,714,1390,37.571255,127.079803
광진구,553, 중곡 성원APT 앞,201912,337,321,658,37.571255,127.079803
광진구,553, 중곡 성원APT 앞,202001,421,397,818,37.571255,127.079803
광진구,553, 중곡 성원APT 앞,202002,529,431,960,37.571255,127.079803
광진구,553, 중곡 성원APT 앞,202003,1133,1151,2284,37.571255,127.079803
광진구,553, 중곡 성원APT 앞,202004,1729,1758,3487,37.571255,127.079803
광진구,553, 중곡 성원APT 앞,202005,1847,1908,3755,37.571255,127.079803
광진구,553, 중곡 성원APT 앞,202006,1658,1722,3380,37.571255,127.079803
광진구,555, 구의3동주민센터,201901,227,257,484,37.537849,127.092171
광진구,555, 구의3동주민센터,201902,193,193,386,37.537849,127.092171
광진구,555, 구의3동주민센터,201903,437,440,877,37.537849,127.092171
광진구,555, 구의3동주민센터,201904,722,682,1404,37.537849,127.092171
광진구,555, 구의3동주민센터,201905,1257,1227,2484,37.537849,127.092171
광진구,555, 구의3동주민센터,201906,1316,1236,2552,37.537849,127.092171
광진구,555, 구의3동주민센터,201907,1129,1091,2220,37.537849,127.092171
광진구,555, 구의3동주민센터,201908,1093,1045,2138,37.537849,127.092171
광진구,555, 구의3동주민센터,201909,1149,1112,2261,37.537849,127.092171
광진구,555, 구의3동주민센터,201910,1256,1223,2479,37.537849,127.092171
광진구,555, 구의3동주민센터,201911,726,664,1390,37.537849,127.092171
광진구,555, 구의3동주민센터,201912,381,374,755,37.537849,127.092171
광진구,555, 구의3동주민센터,202001,303,302,605,37.537849,127.092171
광진구,555, 구의3동주민센터,202002,294,324,618,37.537849,127.092171
광진구,555, 구의3동주민센터,202003,714,754,1468,37.537849,127.092171
광진구,555, 구의3동주민센터,202004,988,986,1974,37.537849,127.092171
광진구,555, 구의3동주민센터,202005,1063,1065,2128,37.537849,127.092171
광진구,555, 구의3동주민센터,202006,1068,1066,2134,37.537849,127.092171
성동구,556, 달맞이공원,201901,33,14,47,37.542053,127.020401
성동구,556, 달맞이공원,201902,54,41,95,37.542053,127.020401
성동구,556, 달맞이공원,201903,103,73,176,37.542053,127.020401
성동구,556, 달맞이공원,201904,238,228,466,37.542053,127.020401
성동구,556, 달맞이공원,201905,269,248,517,37.542053,127.020401
성동구,556, 달맞이공원,201906,232,226,458,37.542053,127.020401
성동구,556, 달맞이공원,201907,179,171,350,37.542053,127.020401
성동구,556, 달맞이공원,201908,186,175,361,37.542053,127.020401
성동구,556, 달맞이공원,201909,196,193,389,37.542053,127.020401
성동구,556, 달맞이공원,201910,183,159,342,37.542053,127.020401
성동구,556, 달맞이공원,201911,81,87,168,37.542053,127.020401
성동구,556, 달맞이공원,201912,52,46,98,37.542053,127.020401
성동구,556, 달맞이공원,202001,66,61,127,37.542053,127.020401
성동구,556, 달맞이공원,202002,79,81,160,37.542053,127.020401
성동구,556, 달맞이공원,202003,304,287,591,37.542053,127.020401
성동구,556, 달맞이공원,202004,346,338,684,37.542053,127.020401
성동구,556, 달맞이공원,202005,251,252,503,37.542053,127.020401
성동구,556, 달맞이공원,202006,183,178,361,37.542053,127.020401
성동구,557, 도선동 주민센터 앞,201901,309,351,660,37.567642,127.025696
성동구,557, 도선동 주민센터 앞,201902,297,338,635,37.567642,127.025696
성동구,557, 도선동 주민센터 앞,201903,590,608,1198,37.567642,127.025696
성동구,557, 도선동 주민센터 앞,201904,811,824,1635,37.567642,127.025696
성동구,557, 도선동 주민센터 앞,201905,1194,1166,2360,37.567642,127.025696
성동구,557, 도선동 주민센터 앞,201906,1273,1267,2540,37.567642,127.025696
성동구,557, 도선동 주민센터 앞,201907,1368,1430,2798,37.567642,127.025696
성동구,557, 도선동 주민센터 앞,201908,1271,1322,2593,37.567642,127.025696
성동구,557, 도선동 주민센터 앞,201909,1143,1158,2301,37.567642,127.025696
성동구,557, 도선동 주민센터 앞,201910,1402,1392,2794,37.567642,127.025696
성동구,557, 도선동 주민센터 앞,201911,956,955,1911,37.567642,127.025696
성동구,557, 도선동 주민센터 앞,201912,582,606,1188,37.567642,127.025696
성동구,557, 도선동 주민센터 앞,202001,488,519,1007,37.567642,127.025696
성동구,557, 도선동 주민센터 앞,202002,426,450,876,37.567642,127.025696
성동구,557, 도선동 주민센터 앞,202003,796,784,1580,37.567642,127.025696
성동구,557, 도선동 주민센터 앞,202004,1037,1053,2090,37.567642,127.025696
성동구,557, 도선동 주민센터 앞,202005,1127,1138,2265,37.567642,127.025696
성동구,557, 도선동 주민센터 앞,202006,1156,1171,2327,37.567642,127.025696
성동구,558, 성동광진 교육지원청 앞,201901,441,459,900,37.564606,127.036522
성동구,558, 성동광진 교육지원청 앞,201902,415,414,829,37.564606,127.036522
성동구,558, 성동광진 교육지원청 앞,201903,817,715,1532,37.564606,127.036522
성동구,558, 성동광진 교육지원청 앞,201904,1299,1157,2456,37.564606,127.036522
성동구,558, 성동광진 교육지원청 앞,201905,1854,1624,3478,37.564606,127.036522
성동구,558, 성동광진 교육지원청 앞,201906,1948,1794,3742,37.564606,127.036522
성동구,558, 성동광진 교육지원청 앞,201907,1858,1679,3537,37.564606,127.036522
성동구,558, 성동광진 교육지원청 앞,201908,1801,1555,3356,37.564606,127.036522
성동구,558, 성동광진 교육지원청 앞,201909,1646,1563,3209,37.564606,127.036522
성동구,558, 성동광진 교육지원청 앞,201910,1972,1869,3841,37.564606,127.036522
성동구,558, 성동광진 교육지원청 앞,201911,1411,1301,2712,37.564606,127.036522
성동구,558, 성동광진 교육지원청 앞,201912,814,815,1629,37.564606,127.036522
성동구,558, 성동광진 교육지원청 앞,202001,624,654,1278,37.564606,127.036522
성동구,558, 성동광진 교육지원청 앞,202002,576,559,1135,37.564606,127.036522
성동구,558, 성동광진 교육지원청 앞,202003,1120,1010,2130,37.564606,127.036522
성동구,558, 성동광진 교육지원청 앞,202004,1561,1493,3054,37.564606,127.036522
성동구,558, 성동광진 교육지원청 앞,202005,1716,1680,3396,37.564606,127.036522
성동구,558, 성동광진 교육지원청 앞,202006,1782,1753,3535,37.564606,127.036522
성동구,559, 왕십리역 4번 출구 건너편,201901,465,539,1004,37.561096,127.036797
성동구,559, 왕십리역 4번 출구 건너편,201902,480,531,1011,37.561096,127.036797
성동구,559, 왕십리역 4번 출구 건너편,201903,1071,1151,2222,37.561096,127.036797
성동구,559, 왕십리역 4번 출구 건너편,201904,1734,1806,3540,37.561096,127.036797
성동구,559, 왕십리역 4번 출구 건너편,201905,2877,2850,5727,37.561096,127.036797
성동구,559, 왕십리역 4번 출구 건너편,201906,3016,3022,6038,37.561096,127.036797
성동구,559, 왕십리역 4번 출구 건너편,201907,2712,2707,5419,37.561096,127.036797
성동구,559, 왕십리역 4번 출구 건너편,201908,2430,2438,4868,37.561096,127.036797
성동구,559, 왕십리역 4번 출구 건너편,201909,2411,2462,4873,37.561096,127.036797
성동구,559, 왕십리역 4번 출구 건너편,201910,3161,3172,6333,37.561096,127.036797
성동구,559, 왕십리역 4번 출구 건너편,201911,1942,2018,3960,37.561096,127.036797
성동구,559, 왕십리역 4번 출구 건너편,201912,1098,1235,2333,37.561096,127.036797
성동구,559, 왕십리역 4번 출구 건너편,202001,1025,1184,2209,37.561096,127.036797
성동구,559, 왕십리역 4번 출구 건너편,202002,947,975,1922,37.561096,127.036797
성동구,559, 왕십리역 4번 출구 건너편,202003,1785,1775,3560,37.561096,127.036797
성동구,559, 왕십리역 4번 출구 건너편,202004,2376,2390,4766,37.561096,127.036797
성동구,559, 왕십리역 4번 출구 건너편,202005,2515,2541,5056,37.561096,127.036797
성동구,559, 왕십리역 4번 출구 건너편,202006,2331,2341,4672,37.561096,127.036797
성동구,560, 비전교회 앞,201901,493,531,1024,37.551205,127.068932
성동구,560, 비전교회 앞,201902,419,421,840,37.551205,127.068932
성동구,560, 비전교회 앞,201903,797,768,1565,37.551205,127.068932
성동구,560, 비전교회 앞,201904,1033,1080,2113,37.551205,127.068932
성동구,560, 비전교회 앞,201905,1492,1583,3075,37.551205,127.068932
성동구,560, 비전교회 앞,201906,1761,1806,3567,37.551205,127.068932
성동구,560, 비전교회 앞,201907,1694,1760,3454,37.551205,127.068932
성동구,560, 비전교회 앞,201908,1639,1679,3318,37.551205,127.068932
성동구,560, 비전교회 앞,201909,1472,1487,2959,37.551205,127.068932
성동구,560, 비전교회 앞,201910,1683,1698,3381,37.551205,127.068932
성동구,560, 비전교회 앞,201911,1217,1233,2450,37.551205,127.068932
성동구,560, 비전교회 앞,201912,797,832,1629,37.551205,127.068932
성동구,560, 비전교회 앞,202001,770,774,1544,37.551205,127.068932
성동구,560, 비전교회 앞,202002,638,618,1256,37.551205,127.068932
성동구,560, 비전교회 앞,202003,1107,1103,2210,37.551205,127.068932
성동구,560, 비전교회 앞,202004,1518,1539,3057,37.551205,127.068932
성동구,560, 비전교회 앞,202005,1677,1688,3365,37.551205,127.068932
성동구,560, 비전교회 앞,202006,1819,1802,3621,37.551205,127.068932
성동구,561, 서울숲역 2번출구 앞,201901,366,375,741,37.542816,127.04467
성동구,561, 서울숲역 2번출구 앞,201902,290,296,586,37.542816,127.04467
성동구,561, 서울숲역 2번출구 앞,201903,676,655,1331,37.542816,127.04467
성동구,561, 서울숲역 2번출구 앞,201904,1212,1155,2367,37.542816,127.04467
성동구,561, 서울숲역 2번출구 앞,201905,1777,1722,3499,37.542816,127.04467
성동구,561, 서울숲역 2번출구 앞,201906,1674,1638,3312,37.542816,127.04467
성동구,561, 서울숲역 2번출구 앞,201907,1591,1509,3100,37.542816,127.04467
성동구,561, 서울숲역 2번출구 앞,201908,1582,1585,3167,37.542816,127.04467
성동구,561, 서울숲역 2번출구 앞,201909,1547,1532,3079,37.542816,127.04467
성동구,561, 서울숲역 2번출구 앞,201910,1837,1844,3681,37.542816,127.04467
성동구,561, 서울숲역 2번출구 앞,201911,1313,1299,2612,37.542816,127.04467
성동구,561, 서울숲역 2번출구 앞,201912,732,685,1417,37.542816,127.04467
성동구,561, 서울숲역 2번출구 앞,202001,621,662,1283,37.542816,127.04467
성동구,561, 서울숲역 2번출구 앞,202002,724,734,1458,37.542816,127.04467
성동구,561, 서울숲역 2번출구 앞,202003,1593,1620,3213,37.542816,127.04467
성동구,561, 서울숲역 2번출구 앞,202004,1976,2001,3977,37.542816,127.04467
성동구,561, 서울숲역 2번출구 앞,202005,2215,2166,4381,37.542816,127.04467
성동구,561, 서울숲역 2번출구 앞,202006,2007,1975,3982,37.542816,127.04467
성동구,562, 군자지하보도 앞,201901,352,313,665,37.559246,127.07341
성동구,562, 군자지하보도 앞,201902,298,256,554,37.559246,127.07341
성동구,562, 군자지하보도 앞,201903,529,513,1042,37.559246,127.07341
성동구,562, 군자지하보도 앞,201904,962,925,1887,37.559246,127.07341
성동구,562, 군자지하보도 앞,201905,1473,1482,2955,37.559246,127.07341
성동구,562, 군자지하보도 앞,201906,1443,1468,2911,37.559246,127.07341
성동구,562, 군자지하보도 앞,201907,1438,1451,2889,37.559246,127.07341
성동구,562, 군자지하보도 앞,201908,1422,1423,2845,37.559246,127.07341
성동구,562, 군자지하보도 앞,201909,1317,1330,2647,37.559246,127.07341
성동구,562, 군자지하보도 앞,201910,1433,1427,2860,37.559246,127.07341
성동구,562, 군자지하보도 앞,201911,994,994,1988,37.559246,127.07341
성동구,562, 군자지하보도 앞,201912,624,591,1215,37.559246,127.07341
성동구,562, 군자지하보도 앞,202001,524,521,1045,37.559246,127.07341
성동구,562, 군자지하보도 앞,202002,570,568,1138,37.559246,127.07341
성동구,562, 군자지하보도 앞,202003,865,855,1720,37.559246,127.07341
성동구,562, 군자지하보도 앞,202004,1227,1217,2444,37.559246,127.07341
성동구,562, 군자지하보도 앞,202005,1167,1181,2348,37.559246,127.07341
성동구,562, 군자지하보도 앞,202006,1359,1351,2710,37.559246,127.07341
성동구,563, 성동세무서 건너편,201901,900,1300,2200,37.547913,127.062752
성동구,563, 성동세무서 건너편,201902,675,899,1574,37.547913,127.062752
성동구,563, 성동세무서 건너편,201903,1047,1460,2507,37.547913,127.062752
성동구,563, 성동세무서 건너편,201904,1397,1765,3162,37.547913,127.062752
성동구,563, 성동세무서 건너편,201905,1804,2025,3829,37.547913,127.062752
성동구,563, 성동세무서 건너편,201906,1845,2128,3973,37.547913,127.062752
성동구,563, 성동세무서 건너편,201907,2069,2489,4558,37.547913,127.062752
성동구,563, 성동세무서 건너편,201908,1957,2206,4163,37.547913,127.062752
성동구,563, 성동세무서 건너편,201909,1779,2113,3892,37.547913,127.062752
성동구,563, 성동세무서 건너편,201910,2019,2385,4404,37.547913,127.062752
성동구,563, 성동세무서 건너편,201911,1654,2114,3768,37.547913,127.062752
성동구,563, 성동세무서 건너편,201912,1137,1506,2643,37.547913,127.062752
성동구,563, 성동세무서 건너편,202001,1035,1361,2396,37.547913,127.062752
성동구,563, 성동세무서 건너편,202002,980,1242,2222,37.547913,127.062752
성동구,563, 성동세무서 건너편,202003,1380,1551,2931,37.547913,127.062752
성동구,563, 성동세무서 건너편,202004,1653,1748,3401,37.547913,127.062752
성동구,563, 성동세무서 건너편,202005,1680,1826,3506,37.547913,127.062752
성동구,563, 성동세무서 건너편,202006,1911,2285,4196,37.547913,127.062752
성동구,564, 금호역 3번출구,201901,62,12,74,37.547928,127.015572
성동구,564, 금호역 3번출구,201902,48,24,72,37.547928,127.015572
성동구,564, 금호역 3번출구,201903,72,29,101,37.547928,127.015572
성동구,564, 금호역 3번출구,201904,141,78,219,37.547928,127.015572
성동구,564, 금호역 3번출구,201905,178,147,325,37.547928,127.015572
성동구,564, 금호역 3번출구,201906,140,84,224,37.547928,127.015572
성동구,564, 금호역 3번출구,201907,121,53,174,37.547928,127.015572
성동구,564, 금호역 3번출구,201908,117,63,180,37.547928,127.015572
성동구,564, 금호역 3번출구,201909,92,78,170,37.547928,127.015572
성동구,564, 금호역 3번출구,201910,160,98,258,37.547928,127.015572
성동구,564, 금호역 3번출구,201911,83,21,104,37.547928,127.015572
성동구,564, 금호역 3번출구,201912,42,36,78,37.547928,127.015572
성동구,564, 금호역 3번출구,202001,63,32,95,37.547928,127.015572
성동구,564, 금호역 3번출구,202002,47,37,84,37.547928,127.015572
성동구,564, 금호역 3번출구,202003,140,75,215,37.547928,127.015572
성동구,564, 금호역 3번출구,202004,137,117,254,37.547928,127.015572
성동구,564, 금호역 3번출구,202005,115,108,223,37.547928,127.015572
성동구,564, 금호역 3번출구,202006,122,119,241,37.547928,127.015572
성동구,565, 옥수역 3번출구,201901,599,722,1321,37.541363,127.017662
성동구,565, 옥수역 3번출구,201902,644,757,1401,37.541363,127.017662
성동구,565, 옥수역 3번출구,201903,1400,1673,3073,37.541363,127.017662
성동구,565, 옥수역 3번출구,201904,2524,2994,5518,37.541363,127.017662
성동구,565, 옥수역 3번출구,201905,4544,5009,9553,37.541363,127.017662
성동구,565, 옥수역 3번출구,201906,4847,5200,10047,37.541363,127.017662
성동구,565, 옥수역 3번출구,201907,4344,4679,9023,37.541363,127.017662
성동구,565, 옥수역 3번출구,201908,4789,5272,10061,37.541363,127.017662
성동구,565, 옥수역 3번출구,201909,5274,5535,10809,37.541363,127.017662
성동구,565, 옥수역 3번출구,201910,5328,5675,11003,37.541363,127.017662
성동구,565, 옥수역 3번출구,201911,2699,2910,5609,37.541363,127.017662
성동구,565, 옥수역 3번출구,201912,1183,1365,2548,37.541363,127.017662
성동구,565, 옥수역 3번출구,202001,1222,1304,2526,37.541363,127.017662
성동구,565, 옥수역 3번출구,202002,1451,1576,3027,37.541363,127.017662
성동구,565, 옥수역 3번출구,202003,5063,5501,10564,37.541363,127.017662
성동구,565, 옥수역 3번출구,202004,7015,7585,14600,37.541363,127.017662
성동구,565, 옥수역 3번출구,202005,7893,8428,16321,37.541363,127.017662
성동구,565, 옥수역 3번출구,202006,7661,8083,15744,37.541363,127.017662
성동구,567, 성수역 2번출구 앞,201901,1293,1167,2460,37.54459,127.057083
성동구,567, 성수역 2번출구 앞,201902,1026,879,1905,37.54459,127.057083
성동구,567, 성수역 2번출구 앞,201903,1844,1561,3405,37.54459,127.057083
성동구,567, 성수역 2번출구 앞,201904,2494,2033,4527,37.54459,127.057083
성동구,567, 성수역 2번출구 앞,201905,3344,2774,6118,37.54459,127.057083
성동구,567, 성수역 2번출구 앞,201906,3341,2871,6212,37.54459,127.057083
성동구,567, 성수역 2번출구 앞,201907,3337,2890,6227,37.54459,127.057083
성동구,567, 성수역 2번출구 앞,201908,3194,2812,6006,37.54459,127.057083
성동구,567, 성수역 2번출구 앞,201909,2869,2581,5450,37.54459,127.057083
성동구,567, 성수역 2번출구 앞,201910,3553,3206,6759,37.54459,127.057083
성동구,567, 성수역 2번출구 앞,201911,2893,2452,5345,37.54459,127.057083
성동구,567, 성수역 2번출구 앞,201912,1969,1660,3629,37.54459,127.057083
성동구,567, 성수역 2번출구 앞,202001,1786,1486,3272,37.54459,127.057083
성동구,567, 성수역 2번출구 앞,202002,1586,1467,3053,37.54459,127.057083
성동구,567, 성수역 2번출구 앞,202003,2157,1987,4144,37.54459,127.057083
성동구,567, 성수역 2번출구 앞,202004,2745,2500,5245,37.54459,127.057083
성동구,567, 성수역 2번출구 앞,202005,2810,2554,5364,37.54459,127.057083
성동구,567, 성수역 2번출구 앞,202006,2926,2659,5585,37.54459,127.057083
성동구,568, 청계8가사거리 부근,201901,896,985,1881,37.571102,127.02356
성동구,568, 청계8가사거리 부근,201902,790,840,1630,37.571102,127.02356
성동구,568, 청계8가사거리 부근,201903,1465,1538,3003,37.571102,127.02356
성동구,568, 청계8가사거리 부근,201904,1995,1987,3982,37.571102,127.02356
성동구,568, 청계8가사거리 부근,201905,2980,2930,5910,37.571102,127.02356
성동구,568, 청계8가사거리 부근,201906,3268,3282,6550,37.571102,127.02356
성동구,568, 청계8가사거리 부근,201907,3060,3149,6209,37.571102,127.02356
성동구,568, 청계8가사거리 부근,201908,2999,3130,6129,37.571102,127.02356
성동구,568, 청계8가사거리 부근,201909,2973,2956,5929,37.571102,127.02356
성동구,568, 청계8가사거리 부근,201910,3399,3402,6801,37.571102,127.02356
성동구,568, 청계8가사거리 부근,201911,2460,2459,4919,37.571102,127.02356
성동구,568, 청계8가사거리 부근,201912,1521,1583,3104,37.571102,127.02356
성동구,568, 청계8가사거리 부근,202001,1237,1372,2609,37.571102,127.02356
성동구,568, 청계8가사거리 부근,202002,1336,1400,2736,37.571102,127.02356
성동구,568, 청계8가사거리 부근,202003,2369,2362,4731,37.571102,127.02356
성동구,568, 청계8가사거리 부근,202004,3076,3061,6137,37.571102,127.02356
성동구,568, 청계8가사거리 부근,202005,2902,2906,5808,37.571102,127.02356
성동구,568, 청계8가사거리 부근,202006,3191,3197,6388,37.571102,127.02356
성동구,569, 응봉현대아파트 정류소,201901,88,68,156,37.549583,127.030243
성동구,569, 응봉현대아파트 정류소,201902,60,48,108,37.549583,127.030243
성동구,569, 응봉현대아파트 정류소,201903,145,93,238,37.549583,127.030243
성동구,569, 응봉현대아파트 정류소,201904,222,170,392,37.549583,127.030243
성동구,569, 응봉현대아파트 정류소,201905,278,259,537,37.549583,127.030243
성동구,569, 응봉현대아파트 정류소,201906,331,280,611,37.549583,127.030243
성동구,569, 응봉현대아파트 정류소,201907,308,256,564,37.549583,127.030243
성동구,569, 응봉현대아파트 정류소,201908,300,265,565,37.549583,127.030243
성동구,569, 응봉현대아파트 정류소,201909,322,304,626,37.549583,127.030243
성동구,569, 응봉현대아파트 정류소,201910,320,310,630,37.549583,127.030243
성동구,569, 응봉현대아파트 정류소,201911,172,173,345,37.549583,127.030243
성동구,569, 응봉현대아파트 정류소,201912,109,102,211,37.549583,127.030243
성동구,569, 응봉현대아파트 정류소,202001,130,129,259,37.549583,127.030243
성동구,569, 응봉현대아파트 정류소,202002,110,111,221,37.549583,127.030243
성동구,569, 응봉현대아파트 정류소,202003,232,232,464,37.549583,127.030243
성동구,569, 응봉현대아파트 정류소,202004,330,338,668,37.549583,127.030243
성동구,569, 응봉현대아파트 정류소,202005,350,348,698,37.549583,127.030243
성동구,569, 응봉현대아파트 정류소,202006,371,364,735,37.549583,127.030243
광진구,571, 어린이대공원역6번출구,201901,674,408,1082,37.548496,127.07476
광진구,571, 어린이대공원역6번출구,201902,640,408,1048,37.548496,127.07476
광진구,571, 어린이대공원역6번출구,201903,1365,963,2328,37.548496,127.07476
광진구,571, 어린이대공원역6번출구,201904,1906,1406,3312,37.548496,127.07476
광진구,571, 어린이대공원역6번출구,201905,2102,1754,3856,37.548496,127.07476
광진구,571, 어린이대공원역6번출구,201906,1847,1631,3478,37.548496,127.07476
광진구,571, 어린이대공원역6번출구,201907,1651,1429,3080,37.548496,127.07476
광진구,571, 어린이대공원역6번출구,201908,1443,1341,2784,37.548496,127.07476
광진구,571, 어린이대공원역6번출구,201909,1720,1591,3311,37.548496,127.07476
광진구,571, 어린이대공원역6번출구,201910,1939,1858,3797,37.548496,127.07476
광진구,571, 어린이대공원역6번출구,201911,1470,1387,2857,37.548496,127.07476
광진구,571, 어린이대공원역6번출구,201912,877,831,1708,37.548496,127.07476
광진구,571, 어린이대공원역6번출구,202001,651,556,1207,37.548496,127.07476
광진구,571, 어린이대공원역6번출구,202002,694,610,1304,37.548496,127.07476
광진구,571, 어린이대공원역6번출구,202003,1133,877,2010,37.548496,127.07476
광진구,571, 어린이대공원역6번출구,202004,977,962,1939,37.548496,127.07476
광진구,571, 어린이대공원역6번출구,202005,1048,1028,2076,37.548496,127.07476
광진구,571, 어린이대공원역6번출구,202006,1023,942,1965,37.548496,127.07476
광진구,572, 국립정신 건강센터 앞,201901,116,56,172,37.56538,127.08651
광진구,572, 국립정신 건강센터 앞,201902,146,66,212,37.56538,127.08651
광진구,572, 국립정신 건강센터 앞,201903,298,147,445,37.56538,127.08651
광진구,572, 국립정신 건강센터 앞,201904,365,219,584,37.56538,127.08651
광진구,572, 국립정신 건강센터 앞,201905,573,258,831,37.56538,127.08651
광진구,572, 국립정신 건강센터 앞,201906,610,320,930,37.56538,127.08651
광진구,572, 국립정신 건강센터 앞,201907,658,312,970,37.56538,127.08651
광진구,572, 국립정신 건강센터 앞,201908,622,279,901,37.56538,127.08651
광진구,572, 국립정신 건강센터 앞,201909,690,386,1076,37.56538,127.08651
광진구,572, 국립정신 건강센터 앞,201910,757,393,1150,37.56538,127.08651
광진구,572, 국립정신 건강센터 앞,201911,523,231,754,37.56538,127.08651
광진구,572, 국립정신 건강센터 앞,201912,290,126,416,37.56538,127.08651
광진구,572, 국립정신 건강센터 앞,202001,308,111,419,37.56538,127.08651
광진구,572, 국립정신 건강센터 앞,202002,299,125,424,37.56538,127.08651
광진구,572, 국립정신 건강센터 앞,202003,453,219,672,37.56538,127.08651
광진구,572, 국립정신 건강센터 앞,202004,556,286,842,37.56538,127.08651
광진구,572, 국립정신 건강센터 앞,202005,523,285,808,37.56538,127.08651
광진구,572, 국립정신 건강센터 앞,202006,789,402,1191,37.56538,127.08651
광진구,573, 구의문주차장 앞,201901,670,664,1334,37.545231,127.084732
광진구,573, 구의문주차장 앞,201902,511,534,1045,37.545231,127.084732
광진구,573, 구의문주차장 앞,201903,906,846,1752,37.545231,127.084732
광진구,573, 구의문주차장 앞,201904,1553,1418,2971,37.545231,127.084732
광진구,573, 구의문주차장 앞,201905,2150,2092,4242,37.545231,127.084732
광진구,573, 구의문주차장 앞,201906,2203,2164,4367,37.545231,127.084732
광진구,573, 구의문주차장 앞,201907,1987,1916,3903,37.545231,127.084732
광진구,573, 구의문주차장 앞,201908,1830,1780,3610,37.545231,127.084732
광진구,573, 구의문주차장 앞,201909,1752,1689,3441,37.545231,127.084732
광진구,573, 구의문주차장 앞,201910,2079,2032,4111,37.545231,127.084732
광진구,573, 구의문주차장 앞,201911,1494,1440,2934,37.545231,127.084732
광진구,573, 구의문주차장 앞,201912,993,934,1927,37.545231,127.084732
광진구,573, 구의문주차장 앞,202001,838,744,1582,37.545231,127.084732
광진구,573, 구의문주차장 앞,202002,792,777,1569,37.545231,127.084732
광진구,573, 구의문주차장 앞,202003,1262,1265,2527,37.545231,127.084732
광진구,573, 구의문주차장 앞,202004,1547,1541,3088,37.545231,127.084732
광진구,573, 구의문주차장 앞,202005,1521,1494,3015,37.545231,127.084732
광진구,573, 구의문주차장 앞,202006,1899,1888,3787,37.545231,127.084732
광진구,574, 아차산역4번출구,201901,632,365,997,37.551849,127.088982
광진구,574, 아차산역4번출구,201902,720,369,1089,37.551849,127.088982
광진구,574, 아차산역4번출구,201903,1279,757,2036,37.551849,127.088982
광진구,574, 아차산역4번출구,201904,1923,1262,3185,37.551849,127.088982
광진구,574, 아차산역4번출구,201905,2444,1755,4199,37.551849,127.088982
광진구,574, 아차산역4번출구,201906,2495,1873,4368,37.551849,127.088982
광진구,574, 아차산역4번출구,201907,2165,1565,3730,37.551849,127.088982
광진구,574, 아차산역4번출구,201908,1894,1332,3226,37.551849,127.088982
광진구,574, 아차산역4번출구,201909,1942,1455,3397,37.551849,127.088982
광진구,574, 아차산역4번출구,201910,2617,1940,4557,37.551849,127.088982
광진구,574, 아차산역4번출구,201911,3097,2466,5563,37.551849,127.088982
광진구,574, 아차산역4번출구,201912,1091,667,1758,37.551849,127.088982
광진구,574, 아차산역4번출구,202001,1001,568,1569,37.551849,127.088982
광진구,574, 아차산역4번출구,202002,994,590,1584,37.551849,127.088982
광진구,574, 아차산역4번출구,202003,1905,1267,3172,37.551849,127.088982
광진구,574, 아차산역4번출구,202004,2491,1848,4339,37.551849,127.088982
광진구,574, 아차산역4번출구,202005,2296,1859,4155,37.551849,127.088982
광진구,574, 아차산역4번출구,202006,2400,1889,4289,37.551849,127.088982
광진구,575, 중앙농협 중곡지점,201901,72,58,130,37.564293,127.086937
광진구,575, 중앙농협 중곡지점,201902,55,53,108,37.564293,127.086937
광진구,575, 중앙농협 중곡지점,201903,128,129,257,37.564293,127.086937
광진구,575, 중앙농협 중곡지점,201904,210,197,407,37.564293,127.086937
광진구,575, 중앙농협 중곡지점,201905,334,331,665,37.564293,127.086937
광진구,575, 중앙농협 중곡지점,201906,476,465,941,37.564293,127.086937
광진구,575, 중앙농협 중곡지점,201907,421,419,840,37.564293,127.086937
광진구,575, 중앙농협 중곡지점,201908,346,341,687,37.564293,127.086937
광진구,575, 중앙농협 중곡지점,201909,326,324,650,37.564293,127.086937
광진구,575, 중앙농협 중곡지점,201910,455,454,909,37.564293,127.086937
광진구,575, 중앙농협 중곡지점,201911,304,280,584,37.564293,127.086937
광진구,575, 중앙농협 중곡지점,201912,161,145,306,37.564293,127.086937
광진구,575, 중앙농협 중곡지점,202001,110,115,225,37.564293,127.086937
광진구,575, 중앙농협 중곡지점,202002,168,146,314,37.564293,127.086937
광진구,575, 중앙농협 중곡지점,202003,209,199,408,37.564293,127.086937
광진구,575, 중앙농협 중곡지점,202004,349,347,696,37.564293,127.086937
광진구,575, 중앙농협 중곡지점,202005,480,479,959,37.564293,127.086937
광진구,575, 중앙농협 중곡지점,202006,596,589,1185,37.564293,127.086937
광진구,576, 광나루역 3번 출구,201901,317,337,654,37.54483,127.104263
광진구,576, 광나루역 3번 출구,201902,314,333,647,37.54483,127.104263
광진구,576, 광나루역 3번 출구,201903,581,640,1221,37.54483,127.104263
광진구,576, 광나루역 3번 출구,201904,966,997,1963,37.54483,127.104263
광진구,576, 광나루역 3번 출구,201905,1649,1737,3386,37.54483,127.104263
광진구,576, 광나루역 3번 출구,201906,1839,1915,3754,37.54483,127.104263
광진구,576, 광나루역 3번 출구,201907,1574,1594,3168,37.54483,127.104263
광진구,576, 광나루역 3번 출구,201908,1660,1678,3338,37.54483,127.104263
광진구,576, 광나루역 3번 출구,201909,1554,1560,3114,37.54483,127.104263
광진구,576, 광나루역 3번 출구,201910,1756,1793,3549,37.54483,127.104263
광진구,576, 광나루역 3번 출구,201911,1173,1199,2372,37.54483,127.104263
광진구,576, 광나루역 3번 출구,201912,676,703,1379,37.54483,127.104263
광진구,576, 광나루역 3번 출구,202001,641,660,1301,37.54483,127.104263
광진구,576, 광나루역 3번 출구,202002,602,660,1262,37.54483,127.104263
광진구,576, 광나루역 3번 출구,202003,1331,1367,2698,37.54483,127.104263
광진구,576, 광나루역 3번 출구,202004,1858,1877,3735,37.54483,127.104263
광진구,576, 광나루역 3번 출구,202005,2023,2035,4058,37.54483,127.104263
광진구,576, 광나루역 3번 출구,202006,2213,2227,4440,37.54483,127.104263
광진구,577, 광진청소년수련관,201901,362,322,684,37.546547,127.106133
광진구,577, 광진청소년수련관,201902,401,373,774,37.546547,127.106133
광진구,577, 광진청소년수련관,201903,799,805,1604,37.546547,127.106133
광진구,577, 광진청소년수련관,201904,1254,1350,2604,37.546547,127.106133
광진구,577, 광진청소년수련관,201905,2093,2291,4384,37.546547,127.106133
광진구,577, 광진청소년수련관,201906,2246,2311,4557,37.546547,127.106133
광진구,577, 광진청소년수련관,201907,2057,2087,4144,37.546547,127.106133
광진구,577, 광진청소년수련관,201908,2077,2125,4202,37.546547,127.106133
광진구,577, 광진청소년수련관,201909,1979,2019,3998,37.546547,127.106133
광진구,577, 광진청소년수련관,201910,2451,2472,4923,37.546547,127.106133
광진구,577, 광진청소년수련관,201911,1368,1389,2757,37.546547,127.106133
광진구,577, 광진청소년수련관,201912,724,723,1447,37.546547,127.106133
광진구,577, 광진청소년수련관,202001,693,718,1411,37.546547,127.106133
광진구,577, 광진청소년수련관,202002,559,605,1164,37.546547,127.106133
광진구,577, 광진청소년수련관,202003,1278,1362,2640,37.546547,127.106133
광진구,577, 광진청소년수련관,202004,1865,1915,3780,37.546547,127.106133
광진구,577, 광진청소년수련관,202005,2237,2316,4553,37.546547,127.106133
광진구,577, 광진청소년수련관,202006,2347,2456,4803,37.546547,127.106133
성동구,578, 성동세무서 부근,201901,551,644,1195,37.548286,127.062088
성동구,578, 성동세무서 부근,201902,432,494,926,37.548286,127.062088
성동구,578, 성동세무서 부근,201903,913,982,1895,37.548286,127.062088
성동구,578, 성동세무서 부근,201904,1255,1356,2611,37.548286,127.062088
성동구,578, 성동세무서 부근,201905,2031,2057,4088,37.548286,127.062088
성동구,578, 성동세무서 부근,201906,1665,1708,3373,37.548286,127.062088
성동구,578, 성동세무서 부근,201907,1801,1840,3641,37.548286,127.062088
성동구,578, 성동세무서 부근,201908,1510,1512,3022,37.548286,127.062088
성동구,578, 성동세무서 부근,201909,1461,1475,2936,37.548286,127.062088
성동구,578, 성동세무서 부근,201910,1840,1918,3758,37.548286,127.062088
성동구,578, 성동세무서 부근,201911,1313,1339,2652,37.548286,127.062088
성동구,578, 성동세무서 부근,201912,893,917,1810,37.548286,127.062088
성동구,578, 성동세무서 부근,202001,783,797,1580,37.548286,127.062088
성동구,578, 성동세무서 부근,202002,821,841,1662,37.548286,127.062088
성동구,578, 성동세무서 부근,202003,1198,1212,2410,37.548286,127.062088
성동구,578, 성동세무서 부근,202004,1504,1531,3035,37.548286,127.062088
성동구,578, 성동세무서 부근,202005,1508,1540,3048,37.548286,127.062088
성동구,578, 성동세무서 부근,202006,1570,1604,3174,37.548286,127.062088
성동구,579, 마장역 4번출구,201901,381,392,773,37.565205,127.041847
성동구,579, 마장역 4번출구,201902,305,307,612,37.565205,127.041847
성동구,579, 마장역 4번출구,201903,659,624,1283,37.565205,127.041847
성동구,579, 마장역 4번출구,201904,970,957,1927,37.565205,127.041847
성동구,579, 마장역 4번출구,201905,1465,1458,2923,37.565205,127.041847
성동구,579, 마장역 4번출구,201906,1560,1564,3124,37.565205,127.041847
성동구,579, 마장역 4번출구,201907,1638,1643,3281,37.565205,127.041847
성동구,579, 마장역 4번출구,201908,1548,1557,3105,37.565205,127.041847
성동구,579, 마장역 4번출구,201909,1600,1577,3177,37.565205,127.041847
성동구,579, 마장역 4번출구,201910,1885,1913,3798,37.565205,127.041847
성동구,579, 마장역 4번출구,201911,1256,1263,2519,37.565205,127.041847
성동구,579, 마장역 4번출구,201912,693,724,1417,37.565205,127.041847
성동구,579, 마장역 4번출구,202001,643,710,1353,37.565205,127.041847
성동구,579, 마장역 4번출구,202002,627,657,1284,37.565205,127.041847
성동구,579, 마장역 4번출구,202003,1146,1169,2315,37.565205,127.041847
성동구,579, 마장역 4번출구,202004,1550,1542,3092,37.565205,127.041847
성동구,579, 마장역 4번출구,202005,1753,1769,3522,37.565205,127.041847
성동구,579, 마장역 4번출구,202006,1505,1512,3017,37.565205,127.041847
성동구,580, 신금호역 3번출구 뒤,201901,52,7,59,#N/A,#N/A
성동구,580, 신금호역 3번출구 뒤,201902,54,21,75,#N/A,#N/A
성동구,580, 신금호역 3번출구 뒤,201903,76,31,107,#N/A,#N/A
성동구,580, 신금호역 3번출구 뒤,201904,122,65,187,#N/A,#N/A
성동구,580, 신금호역 3번출구 뒤,201905,105,63,168,#N/A,#N/A
성동구,580, 신금호역 3번출구 뒤,201906,146,93,239,#N/A,#N/A
성동구,580, 신금호역 3번출구 뒤,201907,120,51,171,#N/A,#N/A
성동구,580, 신금호역 3번출구 뒤,201908,110,63,173,#N/A,#N/A
성동구,580, 신금호역 3번출구 뒤,201909,106,91,197,#N/A,#N/A
성동구,580, 신금호역 3번출구 뒤,201910,127,124,251,#N/A,#N/A
성동구,580, 신금호역 3번출구 뒤,201911,96,68,164,#N/A,#N/A
성동구,580, 신금호역 3번출구 뒤,201912,82,34,116,#N/A,#N/A
성동구,580, 신금호역 3번출구 뒤,202001,33,34,67,#N/A,#N/A
성동구,580, 신금호역 3번출구 뒤,202002,39,27,66,#N/A,#N/A
성동구,580, 신금호역 3번출구 뒤,202003,74,70,144,#N/A,#N/A
성동구,580, 신금호역 3번출구 뒤,202004,10,9,19,#N/A,#N/A
성동구,580, 신금호역 3번출구 뒤,202005,3,2,5,#N/A,#N/A
성동구,581, 용답초등학교,201901,223,233,456,37.561012,127.054237
성동구,581, 용답초등학교,201902,195,233,428,37.561012,127.054237
성동구,581, 용답초등학교,201903,419,431,850,37.561012,127.054237
성동구,581, 용답초등학교,201904,590,613,1203,37.561012,127.054237
성동구,581, 용답초등학교,201905,680,676,1356,37.561012,127.054237
성동구,581, 용답초등학교,201906,740,783,1523,37.561012,127.054237
성동구,581, 용답초등학교,201907,685,770,1455,37.561012,127.054237
성동구,581, 용답초등학교,201908,637,641,1278,37.561012,127.054237
성동구,581, 용답초등학교,201909,577,585,1162,37.561012,127.054237
성동구,581, 용답초등학교,201910,668,681,1349,37.561012,127.054237
성동구,581, 용답초등학교,201911,458,514,972,37.561012,127.054237
성동구,581, 용답초등학교,201912,318,333,651,37.561012,127.054237
성동구,581, 용답초등학교,202001,264,311,575,37.561012,127.054237
성동구,581, 용답초등학교,202002,298,330,628,37.561012,127.054237
성동구,581, 용답초등학교,202003,442,396,838,37.561012,127.054237
성동구,581, 용답초등학교,202004,540,542,1082,37.561012,127.054237
성동구,581, 용답초등학교,202005,681,680,1361,37.561012,127.054237
성동구,581, 용답초등학교,202006,1306,1432,2738,37.561012,127.054237
성동구,582, 경일중학교 앞,201901,360,393,753,37.543179,127.04908
성동구,582, 경일중학교 앞,201902,323,360,683,37.543179,127.04908
성동구,582, 경일중학교 앞,201903,627,685,1312,37.543179,127.04908
성동구,582, 경일중학교 앞,201904,1027,1081,2108,37.543179,127.04908
성동구,582, 경일중학교 앞,201905,1598,1641,3239,37.543179,127.04908
성동구,582, 경일중학교 앞,201906,1610,1697,3307,37.543179,127.04908
성동구,582, 경일중학교 앞,201907,1677,1723,3400,37.543179,127.04908
성동구,582, 경일중학교 앞,201908,1649,1663,3312,37.543179,127.04908
성동구,582, 경일중학교 앞,201909,1463,1480,2943,37.543179,127.04908
성동구,582, 경일중학교 앞,201910,1750,1759,3509,37.543179,127.04908
성동구,582, 경일중학교 앞,201911,1157,1192,2349,37.543179,127.04908
성동구,582, 경일중학교 앞,201912,728,772,1500,37.543179,127.04908
성동구,582, 경일중학교 앞,202001,612,677,1289,37.543179,127.04908
성동구,582, 경일중학교 앞,202002,602,643,1245,37.543179,127.04908
성동구,582, 경일중학교 앞,202003,1117,1140,2257,37.543179,127.04908
성동구,582, 경일중학교 앞,202004,1443,1484,2927,37.543179,127.04908
성동구,582, 경일중학교 앞,202005,1498,1533,3031,37.543179,127.04908
성동구,582, 경일중학교 앞,202006,1503,1504,3007,37.543179,127.04908
성동구,583, 청계천 생태교실 앞,201901,567,561,1128,37.56797,127.04689
성동구,583, 청계천 생태교실 앞,201902,740,677,1417,37.56797,127.04689
성동구,583, 청계천 생태교실 앞,201903,1369,1354,2723,37.56797,127.04689
성동구,583, 청계천 생태교실 앞,201904,2642,2768,5410,37.56797,127.04689
성동구,583, 청계천 생태교실 앞,201905,4476,4479,8955,37.56797,127.04689
성동구,583, 청계천 생태교실 앞,201906,4813,4953,9766,37.56797,127.04689
성동구,583, 청계천 생태교실 앞,201907,3955,4220,8175,37.56797,127.04689
성동구,583, 청계천 생태교실 앞,201908,4537,4788,9325,37.56797,127.04689
성동구,583, 청계천 생태교실 앞,201909,4575,4588,9163,37.56797,127.04689
성동구,583, 청계천 생태교실 앞,201910,5172,5179,10351,37.56797,127.04689
성동구,583, 청계천 생태교실 앞,201911,2284,2256,4540,37.56797,127.04689
성동구,583, 청계천 생태교실 앞,201912,1035,1032,2067,37.56797,127.04689
성동구,583, 청계천 생태교실 앞,202001,1117,1095,2212,37.56797,127.04689
성동구,583, 청계천 생태교실 앞,202002,1220,1219,2439,37.56797,127.04689
성동구,583, 청계천 생태교실 앞,202003,5333,5372,10705,37.56797,127.04689
성동구,583, 청계천 생태교실 앞,202004,7817,7915,15732,37.56797,127.04689
성동구,583, 청계천 생태교실 앞,202005,8057,8118,16175,37.56797,127.04689
성동구,583, 청계천 생태교실 앞,202006,8297,8536,16833,37.56797,127.04689
광진구,584, 광진광장 교통섬,201901,895,734,1629,37.547829,127.072632
광진구,584, 광진광장 교통섬,201902,743,558,1301,37.547829,127.072632
광진구,584, 광진광장 교통섬,201903,1404,1092,2496,37.547829,127.072632
광진구,584, 광진광장 교통섬,201904,2170,1598,3768,37.547829,127.072632
광진구,584, 광진광장 교통섬,201905,3162,2303,5465,37.547829,127.072632
광진구,584, 광진광장 교통섬,201906,3302,2580,5882,37.547829,127.072632
광진구,584, 광진광장 교통섬,201907,2996,2343,5339,37.547829,127.072632
광진구,584, 광진광장 교통섬,201908,2585,2113,4698,37.547829,127.072632
광진구,584, 광진광장 교통섬,201909,2597,2119,4716,37.547829,127.072632
광진구,584, 광진광장 교통섬,201910,2862,2369,5231,37.547829,127.072632
광진구,584, 광진광장 교통섬,201911,2313,1787,4100,37.547829,127.072632
광진구,584, 광진광장 교통섬,201912,1385,1165,2550,37.547829,127.072632
광진구,584, 광진광장 교통섬,202001,1185,944,2129,37.547829,127.072632
광진구,584, 광진광장 교통섬,202002,1123,824,1947,37.547829,127.072632
광진구,584, 광진광장 교통섬,202003,1810,1312,3122,37.547829,127.072632
광진구,584, 광진광장 교통섬,202004,2183,1826,4009,37.547829,127.072632
광진구,584, 광진광장 교통섬,202005,2280,2113,4393,37.547829,127.072632
광진구,584, 광진광장 교통섬,202006,2864,2447,5311,37.547829,127.072632
성동구,585, 성수2가1동 공영주차장 인근,201901,510,580,1090,37.536808,127.055489
성동구,585, 성수2가1동 공영주차장 인근,201902,521,551,1072,37.536808,127.055489
성동구,585, 성수2가1동 공영주차장 인근,201903,1018,1191,2209,37.536808,127.055489
성동구,585, 성수2가1동 공영주차장 인근,201904,1656,1749,3405,37.536808,127.055489
성동구,585, 성수2가1동 공영주차장 인근,201905,2776,2827,5603,37.536808,127.055489
성동구,585, 성수2가1동 공영주차장 인근,201906,2855,2947,5802,37.536808,127.055489
성동구,585, 성수2가1동 공영주차장 인근,201907,2917,3014,5931,37.536808,127.055489
성동구,585, 성수2가1동 공영주차장 인근,201908,3106,3151,6257,37.536808,127.055489
성동구,585, 성수2가1동 공영주차장 인근,201909,2981,3092,6073,37.536808,127.055489
성동구,585, 성수2가1동 공영주차장 인근,201910,3474,3559,7033,37.536808,127.055489
성동구,585, 성수2가1동 공영주차장 인근,201911,2195,2274,4469,37.536808,127.055489
성동구,585, 성수2가1동 공영주차장 인근,201912,1274,1310,2584,37.536808,127.055489
성동구,585, 성수2가1동 공영주차장 인근,202001,1006,1055,2061,37.536808,127.055489
성동구,585, 성수2가1동 공영주차장 인근,202002,927,982,1909,37.536808,127.055489
성동구,585, 성수2가1동 공영주차장 인근,202003,1964,2009,3973,37.536808,127.055489
성동구,585, 성수2가1동 공영주차장 인근,202004,2759,2805,5564,37.536808,127.055489
성동구,585, 성수2가1동 공영주차장 인근,202005,3021,3078,6099,37.536808,127.055489
성동구,585, 성수2가1동 공영주차장 인근,202006,3224,3254,6478,37.536808,127.055489
성동구,586, 마장동 주민센터,201901,260,258,518,37.565941,127.045395
성동구,586, 마장동 주민센터,201902,243,242,485,37.565941,127.045395
성동구,586, 마장동 주민센터,201903,388,377,765,37.565941,127.045395
성동구,586, 마장동 주민센터,201904,514,477,991,37.565941,127.045395
성동구,586, 마장동 주민센터,201905,647,642,1289,37.565941,127.045395
성동구,586, 마장동 주민센터,201906,803,772,1575,37.565941,127.045395
성동구,586, 마장동 주민센터,201907,783,784,1567,37.565941,127.045395
성동구,586, 마장동 주민센터,201908,766,761,1527,37.565941,127.045395
성동구,586, 마장동 주민센터,201909,655,635,1290,37.565941,127.045395
성동구,586, 마장동 주민센터,201910,759,768,1527,37.565941,127.045395
성동구,586, 마장동 주민센터,201911,427,437,864,37.565941,127.045395
성동구,586, 마장동 주민센터,201912,285,314,599,37.565941,127.045395
성동구,586, 마장동 주민센터,202001,281,322,603,37.565941,127.045395
성동구,586, 마장동 주민센터,202002,307,320,627,37.565941,127.045395
성동구,586, 마장동 주민센터,202003,655,652,1307,37.565941,127.045395
성동구,586, 마장동 주민센터,202004,748,742,1490,37.565941,127.045395
성동구,586, 마장동 주민센터,202005,950,950,1900,37.565941,127.045395
성동구,586, 마장동 주민센터,202006,1178,1175,2353,37.565941,127.045395
성동구,587, 유니베라 앞,201901,425,439,864,37.545418,127.052643
성동구,587, 유니베라 앞,201902,356,355,711,37.545418,127.052643
성동구,587, 유니베라 앞,201903,601,606,1207,37.545418,127.052643
성동구,587, 유니베라 앞,201904,972,984,1956,37.545418,127.052643
성동구,587, 유니베라 앞,201905,1299,1302,2601,37.545418,127.052643
성동구,587, 유니베라 앞,201906,1451,1442,2893,37.545418,127.052643
성동구,587, 유니베라 앞,201907,1391,1378,2769,37.545418,127.052643
성동구,587, 유니베라 앞,201908,1212,1179,2391,37.545418,127.052643
성동구,587, 유니베라 앞,201909,1242,1253,2495,37.545418,127.052643
성동구,587, 유니베라 앞,201910,1520,1541,3061,37.545418,127.052643
성동구,587, 유니베라 앞,201911,1109,1101,2210,37.545418,127.052643
성동구,587, 유니베라 앞,201912,697,678,1375,37.545418,127.052643
성동구,587, 유니베라 앞,202001,617,634,1251,37.545418,127.052643
성동구,587, 유니베라 앞,202002,566,585,1151,37.545418,127.052643
성동구,587, 유니베라 앞,202003,1018,992,2010,37.545418,127.052643
성동구,587, 유니베라 앞,202004,1469,1472,2941,37.545418,127.052643
성동구,587, 유니베라 앞,202005,1497,1536,3033,37.545418,127.052643
성동구,587, 유니베라 앞,202006,1602,1733,3335,37.545418,127.052643
광진구,588, 뚝섬 유원지역,201901,306,349,655,37.532688,127.067497
광진구,588, 뚝섬 유원지역,201902,340,329,669,37.532688,127.067497
광진구,588, 뚝섬 유원지역,201903,739,792,1531,37.532688,127.067497
광진구,588, 뚝섬 유원지역,201904,1398,1370,2768,37.532688,127.067497
광진구,588, 뚝섬 유원지역,201905,2496,2409,4905,37.532688,127.067497
광진구,588, 뚝섬 유원지역,201906,2155,2084,4239,37.532688,127.067497
광진구,588, 뚝섬 유원지역,201907,1982,1975,3957,37.532688,127.067497
광진구,588, 뚝섬 유원지역,201908,2209,2186,4395,37.532688,127.067497
광진구,588, 뚝섬 유원지역,201909,2078,2059,4137,37.532688,127.067497
광진구,588, 뚝섬 유원지역,201910,2342,2284,4626,37.532688,127.067497
광진구,588, 뚝섬 유원지역,201911,1392,1400,2792,37.532688,127.067497
광진구,588, 뚝섬 유원지역,201912,850,804,1654,37.532688,127.067497
광진구,588, 뚝섬 유원지역,202001,893,789,1682,37.532688,127.067497
광진구,588, 뚝섬 유원지역,202002,788,786,1574,37.532688,127.067497
광진구,588, 뚝섬 유원지역,202003,2343,2358,4701,37.532688,127.067497
광진구,588, 뚝섬 유원지역,202004,2774,2764,5538,37.532688,127.067497
광진구,588, 뚝섬 유원지역,202005,2796,2724,5520,37.532688,127.067497
광진구,588, 뚝섬 유원지역,202006,2498,2430,4928,37.532688,127.067497
성동구,589, 성수역3번출구,201901,655,670,1325,37.544159,127.056656
성동구,589, 성수역3번출구,201902,664,676,1340,37.544159,127.056656
성동구,589, 성수역3번출구,201903,1318,1350,2668,37.544159,127.056656
성동구,589, 성수역3번출구,201904,2194,2259,4453,37.544159,127.056656
성동구,589, 성수역3번출구,201905,3286,3419,6705,37.544159,127.056656
성동구,589, 성수역3번출구,201906,3368,3444,6812,37.544159,127.056656
성동구,589, 성수역3번출구,201907,3281,3313,6594,37.544159,127.056656
성동구,589, 성수역3번출구,201908,3202,3186,6388,37.544159,127.056656
성동구,589, 성수역3번출구,201909,3004,3037,6041,37.544159,127.056656
성동구,589, 성수역3번출구,201910,3837,3850,7687,37.544159,127.056656
성동구,589, 성수역3번출구,201911,2731,2765,5496,37.544159,127.056656
성동구,589, 성수역3번출구,201912,1951,1977,3928,37.544159,127.056656
성동구,589, 성수역3번출구,202001,1410,1444,2854,37.544159,127.056656
성동구,589, 성수역3번출구,202002,1414,1416,2830,37.544159,127.056656
성동구,589, 성수역3번출구,202003,2420,2443,4863,37.544159,127.056656
성동구,589, 성수역3번출구,202004,3241,3294,6535,37.544159,127.056656
성동구,589, 성수역3번출구,202005,3420,3519,6939,37.544159,127.056656
성동구,589, 성수역3번출구,202006,3707,3869,7576,37.544159,127.056656
광진구,590, 건국대학교 (입학정보관),201901,1124,1154,2278,37.53989,127.073364
광진구,590, 건국대학교 (입학정보관),201902,939,939,1878,37.53989,127.073364
광진구,590, 건국대학교 (입학정보관),201903,2661,2672,5333,37.53989,127.073364
광진구,590, 건국대학교 (입학정보관),201904,4082,4134,8216,37.53989,127.073364
광진구,590, 건국대학교 (입학정보관),201905,5241,5241,10482,37.53989,127.073364
광진구,590, 건국대학교 (입학정보관),201906,5023,5026,10049,37.53989,127.073364
광진구,590, 건국대학교 (입학정보관),201907,3468,3463,6931,37.53989,127.073364
광진구,590, 건국대학교 (입학정보관),201908,3080,3102,6182,37.53989,127.073364
광진구,590, 건국대학교 (입학정보관),201909,4256,4248,8504,37.53989,127.073364
광진구,590, 건국대학교 (입학정보관),201910,5242,5241,10483,37.53989,127.073364
광진구,590, 건국대학교 (입학정보관),201911,3914,3937,7851,37.53989,127.073364
광진구,590, 건국대학교 (입학정보관),201912,2092,2111,4203,37.53989,127.073364
광진구,590, 건국대학교 (입학정보관),202001,1214,1312,2526,37.53989,127.073364
광진구,590, 건국대학교 (입학정보관),202002,1126,1143,2269,37.53989,127.073364
광진구,590, 건국대학교 (입학정보관),202003,1603,1601,3204,37.53989,127.073364
광진구,590, 건국대학교 (입학정보관),202004,1949,1931,3880,37.53989,127.073364
광진구,590, 건국대학교 (입학정보관),202005,2223,2244,4467,37.53989,127.073364
광진구,590, 건국대학교 (입학정보관),202006,2606,2618,5224,37.53989,127.073364
광진구,591, 건국대학교 (행정관),201901,311,344,655,37.542778,127.075371
광진구,591, 건국대학교 (행정관),201902,302,302,604,37.542778,127.075371
광진구,591, 건국대학교 (행정관),201903,701,748,1449,37.542778,127.075371
광진구,591, 건국대학교 (행정관),201904,1189,1232,2421,37.542778,127.075371
광진구,591, 건국대학교 (행정관),201905,1424,1419,2843,37.542778,127.075371
광진구,591, 건국대학교 (행정관),201906,1327,1379,2706,37.542778,127.075371
광진구,591, 건국대학교 (행정관),201907,832,835,1667,37.542778,127.075371
광진구,591, 건국대학교 (행정관),201908,728,726,1454,37.542778,127.075371
광진구,591, 건국대학교 (행정관),201909,1052,1052,2104,37.542778,127.075371
광진구,591, 건국대학교 (행정관),201910,1462,1484,2946,37.542778,127.075371
광진구,591, 건국대학교 (행정관),201911,928,959,1887,37.542778,127.075371
광진구,591, 건국대학교 (행정관),201912,486,497,983,37.542778,127.075371
광진구,591, 건국대학교 (행정관),202001,290,318,608,37.542778,127.075371
광진구,591, 건국대학교 (행정관),202002,218,220,438,37.542778,127.075371
광진구,591, 건국대학교 (행정관),202003,185,185,370,37.542778,127.075371
광진구,591, 건국대학교 (행정관),202004,213,214,427,37.542778,127.075371
광진구,591, 건국대학교 (행정관),202005,268,265,533,37.542778,127.075371
광진구,591, 건국대학교 (행정관),202006,315,307,622,37.542778,127.075371
광진구,592, 건국대학교 학생회관,201901,522,620,1142,37.541912,127.077637
광진구,592, 건국대학교 학생회관,201902,444,522,966,37.541912,127.077637
광진구,592, 건국대학교 학생회관,201903,2087,2494,4581,37.541912,127.077637
광진구,592, 건국대학교 학생회관,201904,3393,3809,7202,37.541912,127.077637
광진구,592, 건국대학교 학생회관,201905,4420,4625,9045,37.541912,127.077637
광진구,592, 건국대학교 학생회관,201906,3725,3949,7674,37.541912,127.077637
광진구,592, 건국대학교 학생회관,201907,2224,2366,4590,37.541912,127.077637
광진구,592, 건국대학교 학생회관,201908,2241,2288,4529,37.541912,127.077637
광진구,592, 건국대학교 학생회관,201909,3598,3784,7382,37.541912,127.077637
광진구,592, 건국대학교 학생회관,201910,3822,4036,7858,37.541912,127.077637
광진구,592, 건국대학교 학생회관,201911,2931,3181,6112,37.541912,127.077637
광진구,592, 건국대학교 학생회관,201912,1458,1531,2989,37.541912,127.077637
광진구,592, 건국대학교 학생회관,202001,653,758,1411,37.541912,127.077637
광진구,592, 건국대학교 학생회관,202002,575,595,1170,37.541912,127.077637
광진구,592, 건국대학교 학생회관,202003,868,811,1679,37.541912,127.077637
광진구,592, 건국대학교 학생회관,202004,1202,1152,2354,37.541912,127.077637
광진구,592, 건국대학교 학생회관,202005,1213,1234,2447,37.541912,127.077637
광진구,592, 건국대학교 학생회관,202006,1567,1605,3172,37.541912,127.077637
광진구,593,자양중앙나들목,201901,515,557,1072,37.528587,127.077873
광진구,593,자양중앙나들목,201902,400,449,849,37.528587,127.077873
광진구,593,자양중앙나들목,201903,778,863,1641,37.528587,127.077873
광진구,593,자양중앙나들목,201904,1161,1374,2535,37.528587,127.077873
광진구,593,자양중앙나들목,201905,2038,2381,4419,37.528587,127.077873
광진구,593,자양중앙나들목,201906,2147,2494,4641,37.528587,127.077873
광진구,593,자양중앙나들목,201907,2133,2652,4785,37.528587,127.077873
광진구,593,자양중앙나들목,201908,2376,2829,5205,37.528587,127.077873
광진구,593,자양중앙나들목,201909,2115,2463,4578,37.528587,127.077873
광진구,593,자양중앙나들목,201910,2528,2821,5349,37.528587,127.077873
광진구,593,자양중앙나들목,201911,1516,1707,3223,37.528587,127.077873
광진구,593,자양중앙나들목,201912,980,1100,2080,37.528587,127.077873
광진구,593,자양중앙나들목,202001,926,988,1914,37.528587,127.077873
광진구,593,자양중앙나들목,202002,855,972,1827,37.528587,127.077873
광진구,593,자양중앙나들목,202003,1802,2160,3962,37.528587,127.077873
광진구,593,자양중앙나들목,202004,2059,2326,4385,37.528587,127.077873
광진구,593,자양중앙나들목,202005,2679,2950,5629,37.528587,127.077873
광진구,593,자양중앙나들목,202006,2714,2974,5688,37.528587,127.077873
성동구,594, 중랑물재생센터(서울새활용플라자),201901,238,326,564,37.558365,127.056908
성동구,594, 중랑물재생센터(서울새활용플라자),201902,198,217,415,37.558365,127.056908
성동구,594, 중랑물재생센터(서울새활용플라자),201903,287,326,613,37.558365,127.056908
성동구,594, 중랑물재생센터(서울새활용플라자),201904,417,410,827,37.558365,127.056908
성동구,594, 중랑물재생센터(서울새활용플라자),201905,539,559,1098,37.558365,127.056908
성동구,594, 중랑물재생센터(서울새활용플라자),201906,548,521,1069,37.558365,127.056908
성동구,594, 중랑물재생센터(서울새활용플라자),201907,613,664,1277,37.558365,127.056908
성동구,594, 중랑물재생센터(서울새활용플라자),201908,525,617,1142,37.558365,127.056908
성동구,594, 중랑물재생센터(서울새활용플라자),201909,480,674,1154,37.558365,127.056908
성동구,594, 중랑물재생센터(서울새활용플라자),201910,588,755,1343,37.558365,127.056908
성동구,594, 중랑물재생센터(서울새활용플라자),201911,419,633,1052,37.558365,127.056908
성동구,594, 중랑물재생센터(서울새활용플라자),201912,334,457,791,37.558365,127.056908
성동구,594, 중랑물재생센터(서울새활용플라자),202001,260,364,624,37.558365,127.056908
성동구,594, 중랑물재생센터(서울새활용플라자),202002,280,338,618,37.558365,127.056908
성동구,594, 중랑물재생센터(서울새활용플라자),202003,396,452,848,37.558365,127.056908
성동구,594, 중랑물재생센터(서울새활용플라자),202004,488,543,1031,37.558365,127.056908
성동구,594, 중랑물재생센터(서울새활용플라자),202005,467,550,1017,37.558365,127.056908
성동구,594, 중랑물재생센터(서울새활용플라자),202006,559,689,1248,37.558365,127.056908
동대문구,600, 휘경2동 주민센터,201901,43,41,84,37.589912,127.06868
동대문구,600, 휘경2동 주민센터,201902,42,34,76,37.589912,127.06868
동대문구,600, 휘경2동 주민센터,201903,69,63,132,37.589912,127.06868
동대문구,600, 휘경2동 주민센터,201904,168,147,315,37.589912,127.06868
동대문구,600, 휘경2동 주민센터,201905,246,173,419,37.589912,127.06868
동대문구,600, 휘경2동 주민센터,201906,225,161,386,37.589912,127.06868
동대문구,600, 휘경2동 주민센터,201907,171,140,311,37.589912,127.06868
동대문구,600, 휘경2동 주민센터,201908,235,211,446,37.589912,127.06868
동대문구,600, 휘경2동 주민센터,201909,143,123,266,37.589912,127.06868
동대문구,600, 휘경2동 주민센터,201910,198,173,371,37.589912,127.06868
동대문구,600, 휘경2동 주민센터,201911,149,123,272,37.589912,127.06868
동대문구,600, 휘경2동 주민센터,201912,63,52,115,37.589912,127.06868
동대문구,600, 휘경2동 주민센터,202001,56,54,110,37.589912,127.06868
동대문구,600, 휘경2동 주민센터,202002,86,78,164,37.589912,127.06868
동대문구,600, 휘경2동 주민센터,202003,141,125,266,37.589912,127.06868
동대문구,600, 휘경2동 주민센터,202004,219,208,427,37.589912,127.06868
동대문구,600, 휘경2동 주민센터,202005,331,324,655,37.589912,127.06868
동대문구,600, 휘경2동 주민센터,202006,401,353,754,37.589912,127.06868
동대문구,601, 용신동주민센터,201901,235,224,459,37.575947,127.037361
동대문구,601, 용신동주민센터,201902,227,231,458,37.575947,127.037361
동대문구,601, 용신동주민센터,201903,362,341,703,37.575947,127.037361
동대문구,601, 용신동주민센터,201904,473,478,951,37.575947,127.037361
동대문구,601, 용신동주민센터,201905,763,735,1498,37.575947,127.037361
동대문구,601, 용신동주민센터,201906,885,885,1770,37.575947,127.037361
동대문구,601, 용신동주민센터,201907,834,844,1678,37.575947,127.037361
동대문구,601, 용신동주민센터,201908,864,907,1771,37.575947,127.037361
동대문구,601, 용신동주민센터,201909,778,808,1586,37.575947,127.037361
동대문구,601, 용신동주민센터,201910,965,973,1938,37.575947,127.037361
동대문구,601, 용신동주민센터,201911,711,696,1407,37.575947,127.037361
동대문구,601, 용신동주민센터,201912,395,418,813,37.575947,127.037361
동대문구,601, 용신동주민센터,202001,397,410,807,37.575947,127.037361
동대문구,601, 용신동주민센터,202002,365,368,733,37.575947,127.037361
동대문구,601, 용신동주민센터,202003,540,491,1031,37.575947,127.037361
동대문구,601, 용신동주민센터,202004,764,715,1479,37.575947,127.037361
동대문구,601, 용신동주민센터,202005,783,734,1517,37.575947,127.037361
동대문구,601, 용신동주민센터,202006,935,822,1757,37.575947,127.037361
동대문구,602, 장안동 사거리,201901,747,933,1680,37.572174,127.071388
동대문구,602, 장안동 사거리,201902,726,887,1613,37.572174,127.071388
동대문구,602, 장안동 사거리,201903,1315,1741,3056,37.572174,127.071388
동대문구,602, 장안동 사거리,201904,1901,2492,4393,37.572174,127.071388
동대문구,602, 장안동 사거리,201905,3454,4114,7568,37.572174,127.071388
동대문구,602, 장안동 사거리,201906,3705,4496,8201,37.572174,127.071388
동대문구,602, 장안동 사거리,201907,3667,4271,7938,37.572174,127.071388
동대문구,602, 장안동 사거리,201908,3742,4319,8061,37.572174,127.071388
동대문구,602, 장안동 사거리,201909,3781,4300,8081,37.572174,127.071388
동대문구,602, 장안동 사거리,201910,4080,5052,9132,37.572174,127.071388
동대문구,602, 장안동 사거리,201911,2567,3253,5820,37.572174,127.071388
동대문구,602, 장안동 사거리,201912,1621,2016,3637,37.572174,127.071388
동대문구,602, 장안동 사거리,202001,1429,1915,3344,37.572174,127.071388
동대문구,602, 장안동 사거리,202002,1391,1802,3193,37.572174,127.071388
동대문구,602, 장안동 사거리,202003,2645,3169,5814,37.572174,127.071388
동대문구,602, 장안동 사거리,202004,4041,4444,8485,37.572174,127.071388
동대문구,602, 장안동 사거리,202005,4584,4838,9422,37.572174,127.071388
동대문구,602, 장안동 사거리,202006,4210,4761,8971,37.572174,127.071388
동대문구,604, 답십리초등학교 옆 공원,201901,166,190,356,37.569656,127.055962
동대문구,604, 답십리초등학교 옆 공원,201902,172,213,385,37.569656,127.055962
동대문구,604, 답십리초등학교 옆 공원,201903,344,333,677,37.569656,127.055962
동대문구,604, 답십리초등학교 옆 공원,201904,531,556,1087,37.569656,127.055962
동대문구,604, 답십리초등학교 옆 공원,201905,727,841,1568,37.569656,127.055962
동대문구,604, 답십리초등학교 옆 공원,201906,922,1014,1936,37.569656,127.055962
동대문구,604, 답십리초등학교 옆 공원,201907,870,1007,1877,37.569656,127.055962
동대문구,604, 답십리초등학교 옆 공원,201908,790,898,1688,37.569656,127.055962
동대문구,604, 답십리초등학교 옆 공원,201909,880,900,1780,37.569656,127.055962
동대문구,604, 답십리초등학교 옆 공원,201910,916,1001,1917,37.569656,127.055962
동대문구,604, 답십리초등학교 옆 공원,201911,666,704,1370,37.569656,127.055962
동대문구,604, 답십리초등학교 옆 공원,201912,449,467,916,37.569656,127.055962
동대문구,604, 답십리초등학교 옆 공원,202001,335,362,697,37.569656,127.055962
동대문구,604, 답십리초등학교 옆 공원,202002,356,334,690,37.569656,127.055962
동대문구,604, 답십리초등학교 옆 공원,202003,577,587,1164,37.569656,127.055962
동대문구,604, 답십리초등학교 옆 공원,202004,885,907,1792,37.569656,127.055962
동대문구,604, 답십리초등학교 옆 공원,202005,964,966,1930,37.569656,127.055962
동대문구,604, 답십리초등학교 옆 공원,202006,982,1049,2031,37.569656,127.055962
동대문구,605, 신설동역8번출구,201901,271,267,538,37.5742,127.026497
동대문구,605, 신설동역8번출구,201902,204,233,437,37.5742,127.026497
동대문구,605, 신설동역8번출구,201903,467,475,942,37.5742,127.026497
동대문구,605, 신설동역8번출구,201904,698,702,1400,37.5742,127.026497
동대문구,605, 신설동역8번출구,201905,1029,1031,2060,37.5742,127.026497
동대문구,605, 신설동역8번출구,201906,1221,1220,2441,37.5742,127.026497
동대문구,605, 신설동역8번출구,201907,1456,1443,2899,37.5742,127.026497
동대문구,605, 신설동역8번출구,201908,1279,1276,2555,37.5742,127.026497
동대문구,605, 신설동역8번출구,201909,1122,1145,2267,37.5742,127.026497
동대문구,605, 신설동역8번출구,201910,1436,1466,2902,37.5742,127.026497
동대문구,605, 신설동역8번출구,201911,1034,1085,2119,37.5742,127.026497
동대문구,605, 신설동역8번출구,201912,448,501,949,37.5742,127.026497
동대문구,605, 신설동역8번출구,202001,505,576,1081,37.5742,127.026497
동대문구,605, 신설동역8번출구,202002,438,464,902,37.5742,127.026497
동대문구,605, 신설동역8번출구,202003,782,800,1582,37.5742,127.026497
동대문구,605, 신설동역8번출구,202004,893,899,1792,37.5742,127.026497
동대문구,605, 신설동역8번출구,202005,1127,1105,2232,37.5742,127.026497
동대문구,605, 신설동역8번출구,202006,1329,1319,2648,37.5742,127.026497
동대문구,606, 휘경공고앞,201901,70,102,172,37.584625,127.07029
동대문구,606, 휘경공고앞,201902,118,126,244,37.584625,127.07029
동대문구,606, 휘경공고앞,201903,284,341,625,37.584625,127.07029
동대문구,606, 휘경공고앞,201904,444,503,947,37.584625,127.07029
동대문구,606, 휘경공고앞,201905,602,736,1338,37.584625,127.07029
동대문구,606, 휘경공고앞,201906,622,751,1373,37.584625,127.07029
동대문구,606, 휘경공고앞,201907,668,850,1518,37.584625,127.07029
동대문구,606, 휘경공고앞,201908,749,873,1622,37.584625,127.07029
동대문구,606, 휘경공고앞,201909,771,821,1592,37.584625,127.07029
동대문구,606, 휘경공고앞,201910,977,1037,2014,37.584625,127.07029
동대문구,606, 휘경공고앞,201911,666,695,1361,37.584625,127.07029
동대문구,606, 휘경공고앞,201912,348,402,750,37.584625,127.07029
동대문구,606, 휘경공고앞,202001,295,329,624,37.584625,127.07029
동대문구,606, 휘경공고앞,202002,303,324,627,37.584625,127.07029
동대문구,606, 휘경공고앞,202003,735,778,1513,37.584625,127.07029
동대문구,606, 휘경공고앞,202004,1082,1112,2194,37.584625,127.07029
동대문구,606, 휘경공고앞,202005,1228,1276,2504,37.584625,127.07029
동대문구,606, 휘경공고앞,202006,1330,1442,2772,37.584625,127.07029
동대문구,607, 신이문역 2번출구,201901,0,9,9,37.602711,127.067863
동대문구,607, 신이문역 2번출구,201902,0,3,3,37.602711,127.067863
동대문구,607, 신이문역 2번출구,201903,55,75,130,37.602711,127.067863
동대문구,607, 신이문역 2번출구,201904,480,567,1047,37.602711,127.067863
동대문구,607, 신이문역 2번출구,201905,841,1020,1861,37.602711,127.067863
동대문구,607, 신이문역 2번출구,201906,900,1063,1963,37.602711,127.067863
동대문구,607, 신이문역 2번출구,201907,907,1101,2008,37.602711,127.067863
동대문구,607, 신이문역 2번출구,201908,881,1039,1920,37.602711,127.067863
동대문구,607, 신이문역 2번출구,201909,908,1064,1972,37.602711,127.067863
동대문구,607, 신이문역 2번출구,201910,1060,1201,2261,37.602711,127.067863
동대문구,607, 신이문역 2번출구,201911,655,765,1420,37.602711,127.067863
동대문구,607, 신이문역 2번출구,201912,349,412,761,37.602711,127.067863
동대문구,607, 신이문역 2번출구,202001,278,336,614,37.602711,127.067863
동대문구,607, 신이문역 2번출구,202002,323,429,752,37.602711,127.067863
동대문구,607, 신이문역 2번출구,202003,996,1052,2048,37.602711,127.067863
동대문구,607, 신이문역 2번출구,202004,1297,1340,2637,37.602711,127.067863
동대문구,607, 신이문역 2번출구,202005,1555,1677,3232,37.602711,127.067863
동대문구,607, 신이문역 2번출구,202006,1183,1328,2511,37.602711,127.067863
동대문구,608, 전농삼성아파트,201901,110,152,262,37.58131,127.055344
동대문구,608, 전농삼성아파트,201902,71,113,184,37.58131,127.055344
동대문구,608, 전농삼성아파트,201903,168,245,413,37.58131,127.055344
동대문구,608, 전농삼성아파트,201904,151,209,360,37.58131,127.055344
동대문구,608, 전농삼성아파트,201905,377,414,791,37.58131,127.055344
동대문구,608, 전농삼성아파트,201906,363,364,727,37.58131,127.055344
동대문구,608, 전농삼성아파트,201907,385,403,788,37.58131,127.055344
동대문구,608, 전농삼성아파트,201908,368,369,737,37.58131,127.055344
동대문구,608, 전농삼성아파트,201909,370,347,717,37.58131,127.055344
동대문구,608, 전농삼성아파트,201910,354,353,707,37.58131,127.055344
동대문구,608, 전농삼성아파트,201911,186,192,378,37.58131,127.055344
동대문구,608, 전농삼성아파트,201912,132,135,267,37.58131,127.055344
동대문구,608, 전농삼성아파트,202001,127,128,255,37.58131,127.055344
동대문구,608, 전농삼성아파트,202002,128,119,247,37.58131,127.055344
동대문구,608, 전농삼성아파트,202003,180,176,356,37.58131,127.055344
동대문구,608, 전농삼성아파트,202004,303,302,605,37.58131,127.055344
동대문구,608, 전농삼성아파트,202005,301,301,602,37.58131,127.055344
동대문구,608, 전농삼성아파트,202006,294,297,591,37.58131,127.055344
동대문구,609, 제기2교,201901,529,545,1074,37.587791,127.037361
동대문구,609, 제기2교,201902,409,418,827,37.587791,127.037361
동대문구,609, 제기2교,201903,947,872,1819,37.587791,127.037361
동대문구,609, 제기2교,201904,1231,1176,2407,37.587791,127.037361
동대문구,609, 제기2교,201905,1934,1733,3667,37.587791,127.037361
동대문구,609, 제기2교,201906,2104,1947,4051,37.587791,127.037361
동대문구,609, 제기2교,201907,2120,2030,4150,37.587791,127.037361
동대문구,609, 제기2교,201908,1979,1897,3876,37.587791,127.037361
동대문구,609, 제기2교,201909,2097,1909,4006,37.587791,127.037361
동대문구,609, 제기2교,201910,2458,2208,4666,37.587791,127.037361
동대문구,609, 제기2교,201911,1541,1377,2918,37.587791,127.037361
동대문구,609, 제기2교,201912,949,977,1926,37.587791,127.037361
동대문구,609, 제기2교,202001,736,826,1562,37.587791,127.037361
동대문구,609, 제기2교,202002,830,841,1671,37.587791,127.037361
동대문구,609, 제기2교,202003,1552,1494,3046,37.587791,127.037361
동대문구,609, 제기2교,202004,2159,1999,4158,37.587791,127.037361
동대문구,609, 제기2교,202005,2320,2243,4563,37.587791,127.037361
동대문구,609, 제기2교,202006,2451,2287,4738,37.587791,127.037361
동대문구,610, 동대문중 교차로,201901,178,173,351,37.573086,127.052162
동대문구,610, 동대문중 교차로,201902,169,149,318,37.573086,127.052162
동대문구,610, 동대문중 교차로,201903,333,252,585,37.573086,127.052162
동대문구,610, 동대문중 교차로,201904,481,412,893,37.573086,127.052162
동대문구,610, 동대문중 교차로,201905,762,700,1462,37.573086,127.052162
동대문구,610, 동대문중 교차로,201906,742,724,1466,37.573086,127.052162
동대문구,610, 동대문중 교차로,201907,735,679,1414,37.573086,127.052162
동대문구,610, 동대문중 교차로,201908,703,658,1361,37.573086,127.052162
동대문구,610, 동대문중 교차로,201909,772,756,1528,37.573086,127.052162
동대문구,610, 동대문중 교차로,201910,866,816,1682,37.573086,127.052162
동대문구,610, 동대문중 교차로,201911,593,562,1155,37.573086,127.052162
동대문구,610, 동대문중 교차로,201912,419,408,827,37.573086,127.052162
동대문구,610, 동대문중 교차로,202001,371,352,723,37.573086,127.052162
동대문구,610, 동대문중 교차로,202002,350,355,705,37.573086,127.052162
동대문구,610, 동대문중 교차로,202003,508,510,1018,37.573086,127.052162
동대문구,610, 동대문중 교차로,202004,779,771,1550,37.573086,127.052162
동대문구,610, 동대문중 교차로,202005,836,826,1662,37.573086,127.052162
동대문구,610, 동대문중 교차로,202006,982,968,1950,37.573086,127.052162
동대문구,612, 시립동부병원 앞 사거리,201901,479,477,956,37.573666,127.030815
동대문구,612, 시립동부병원 앞 사거리,201902,384,380,764,37.573666,127.030815
동대문구,612, 시립동부병원 앞 사거리,201903,721,734,1455,37.573666,127.030815
동대문구,612, 시립동부병원 앞 사거리,201904,995,999,1994,37.573666,127.030815
동대문구,612, 시립동부병원 앞 사거리,201905,1630,1612,3242,37.573666,127.030815
동대문구,612, 시립동부병원 앞 사거리,201906,1717,1735,3452,37.573666,127.030815
동대문구,612, 시립동부병원 앞 사거리,201907,1965,2018,3983,37.573666,127.030815
동대문구,612, 시립동부병원 앞 사거리,201908,1927,1923,3850,37.573666,127.030815
동대문구,612, 시립동부병원 앞 사거리,201909,1635,1667,3302,37.573666,127.030815
동대문구,612, 시립동부병원 앞 사거리,201910,2044,2093,4137,37.573666,127.030815
동대문구,612, 시립동부병원 앞 사거리,201911,1435,1482,2917,37.573666,127.030815
동대문구,612, 시립동부병원 앞 사거리,201912,841,986,1827,37.573666,127.030815
동대문구,612, 시립동부병원 앞 사거리,202001,828,936,1764,37.573666,127.030815
동대문구,612, 시립동부병원 앞 사거리,202002,882,902,1784,37.573666,127.030815
동대문구,612, 시립동부병원 앞 사거리,202003,1227,1175,2402,37.573666,127.030815
동대문구,612, 시립동부병원 앞 사거리,202004,1465,1411,2876,37.573666,127.030815
동대문구,612, 시립동부병원 앞 사거리,202005,1745,1650,3395,37.573666,127.030815
동대문구,612, 시립동부병원 앞 사거리,202006,1968,1944,3912,37.573666,127.030815
동대문구,613, 신설동역 10번출구 앞,201901,594,616,1210,37.575272,127.023468
동대문구,613, 신설동역 10번출구 앞,201902,543,548,1091,37.575272,127.023468
동대문구,613, 신설동역 10번출구 앞,201903,977,1080,2057,37.575272,127.023468
동대문구,613, 신설동역 10번출구 앞,201904,1360,1442,2802,37.575272,127.023468
동대문구,613, 신설동역 10번출구 앞,201905,2081,2094,4175,37.575272,127.023468
동대문구,613, 신설동역 10번출구 앞,201906,2251,2263,4514,37.575272,127.023468
동대문구,613, 신설동역 10번출구 앞,201907,2271,2283,4554,37.575272,127.023468
동대문구,613, 신설동역 10번출구 앞,201908,2148,2175,4323,37.575272,127.023468
동대문구,613, 신설동역 10번출구 앞,201909,1781,1784,3565,37.575272,127.023468
동대문구,613, 신설동역 10번출구 앞,201910,2178,2189,4367,37.575272,127.023468
동대문구,613, 신설동역 10번출구 앞,201911,1648,1671,3319,37.575272,127.023468
동대문구,613, 신설동역 10번출구 앞,201912,1174,1189,2363,37.575272,127.023468
동대문구,613, 신설동역 10번출구 앞,202001,971,1069,2040,37.575272,127.023468
동대문구,613, 신설동역 10번출구 앞,202002,1011,1055,2066,37.575272,127.023468
동대문구,613, 신설동역 10번출구 앞,202003,1233,1209,2442,37.575272,127.023468
동대문구,613, 신설동역 10번출구 앞,202004,1572,1547,3119,37.575272,127.023468
동대문구,613, 신설동역 10번출구 앞,202005,1679,1651,3330,37.575272,127.023468
동대문구,613, 신설동역 10번출구 앞,202006,1904,1865,3769,37.575272,127.023468
동대문구,614, 용두동 사거리,201901,701,665,1366,37.577686,127.031013
동대문구,614, 용두동 사거리,201902,549,553,1102,37.577686,127.031013
동대문구,614, 용두동 사거리,201903,1185,1045,2230,37.577686,127.031013
동대문구,614, 용두동 사거리,201904,1698,1477,3175,37.577686,127.031013
동대문구,614, 용두동 사거리,201905,2241,2071,4312,37.577686,127.031013
동대문구,614, 용두동 사거리,201906,2503,2246,4749,37.577686,127.031013
동대문구,614, 용두동 사거리,201907,2429,2151,4580,37.577686,127.031013
동대문구,614, 용두동 사거리,201908,2617,2452,5069,37.577686,127.031013
동대문구,614, 용두동 사거리,201909,2063,1778,3841,37.577686,127.031013
동대문구,614, 용두동 사거리,201910,2408,2094,4502,37.577686,127.031013
동대문구,614, 용두동 사거리,201911,1532,1319,2851,37.577686,127.031013
동대문구,614, 용두동 사거리,201912,917,764,1681,37.577686,127.031013
동대문구,614, 용두동 사거리,202001,720,673,1393,37.577686,127.031013
동대문구,614, 용두동 사거리,202002,760,729,1489,37.577686,127.031013
동대문구,614, 용두동 사거리,202003,1327,1193,2520,37.577686,127.031013
동대문구,614, 용두동 사거리,202004,1875,1635,3510,37.577686,127.031013
동대문구,614, 용두동 사거리,202005,1838,1774,3612,37.577686,127.031013
동대문구,614, 용두동 사거리,202006,2278,1982,4260,37.577686,127.031013
동대문구,615, 용두동 레미안허브리츠아파트 앞,201901,267,283,550,37.576382,127.03511
동대문구,615, 용두동 레미안허브리츠아파트 앞,201902,240,240,480,37.576382,127.03511
동대문구,615, 용두동 레미안허브리츠아파트 앞,201903,472,530,1002,37.576382,127.03511
동대문구,615, 용두동 레미안허브리츠아파트 앞,201904,752,684,1436,37.576382,127.03511
동대문구,615, 용두동 레미안허브리츠아파트 앞,201905,1093,1054,2147,37.576382,127.03511
동대문구,615, 용두동 래미안허브리츠아파트 앞,201906,1164,1137,2301,37.576382,127.03511
동대문구,615, 용두동 래미안허브리츠아파트 앞,201907,1108,1127,2235,37.576382,127.03511
동대문구,615, 용두동 래미안허브리츠아파트 앞,201908,1338,1309,2647,37.576382,127.03511
동대문구,615, 용두동 래미안허브리츠아파트 앞,201909,1139,1121,2260,37.576382,127.03511
동대문구,615, 용두동 래미안허브리츠아파트 앞,201910,1268,1234,2502,37.576382,127.03511
동대문구,615, 용두동 래미안허브리츠아파트 앞,201911,795,746,1541,37.576382,127.03511
동대문구,615, 용두동 래미안허브리츠아파트 앞,201912,552,484,1036,37.576382,127.03511
동대문구,615, 용두동 래미안허브리츠아파트 앞,202001,457,396,853,37.576382,127.03511
동대문구,615, 용두동 래미안허브리츠아파트 앞,202002,421,408,829,37.576382,127.03511
동대문구,615, 용두동 래미안허브리츠아파트 앞,202003,980,853,1833,37.576382,127.03511
동대문구,615, 용두동 래미안허브리츠아파트 앞,202004,1453,1348,2801,37.576382,127.03511
동대문구,615, 용두동 래미안허브리츠아파트 앞,202005,1481,1342,2823,37.576382,127.03511
동대문구,615, 용두동 래미안허브리츠아파트 앞,202006,1765,1694,3459,37.576382,127.03511
동대문구,616, 서울시립대 앞,201901,136,42,178,37.582561,127.054367
동대문구,616, 서울시립대 앞,201902,83,36,119,37.582561,127.054367
동대문구,616, 서울시립대 앞,201903,262,91,353,37.582561,127.054367
동대문구,616, 서울시립대 앞,201904,395,140,535,37.582561,127.054367
동대문구,616, 서울시립대 앞,201905,609,177,786,37.582561,127.054367
동대문구,616, 서울시립대 앞,201906,681,192,873,37.582561,127.054367
동대문구,616, 서울시립대 앞,201907,551,142,693,37.582561,127.054367
동대문구,616, 서울시립대 앞,201908,448,105,553,37.582561,127.054367
동대문구,616, 서울시립대 앞,201909,387,122,509,37.582561,127.054367
동대문구,616, 서울시립대 앞,201910,371,155,526,37.582561,127.054367
동대문구,616, 서울시립대 앞,201911,359,78,437,37.582561,127.054367
동대문구,616, 서울시립대 앞,201912,228,55,283,37.582561,127.054367
동대문구,616, 서울시립대 앞,202001,199,64,263,37.582561,127.054367
동대문구,616, 서울시립대 앞,202002,133,46,179,37.582561,127.054367
동대문구,616, 서울시립대 앞,202003,221,73,294,37.582561,127.054367
동대문구,616, 서울시립대 앞,202004,227,120,347,37.582561,127.054367
동대문구,616, 서울시립대 앞,202005,236,89,325,37.582561,127.054367
동대문구,616, 서울시립대 앞,202006,388,109,497,37.582561,127.054367
동대문구,617, 청솔우성아파트 앞,201901,262,318,580,37.574203,127.057693
동대문구,617, 청솔우성아파트 앞,201902,257,281,538,37.574203,127.057693
동대문구,617, 청솔우성아파트 앞,201903,509,606,1115,37.574203,127.057693
동대문구,617, 청솔우성아파트 앞,201904,739,887,1626,37.574203,127.057693
동대문구,617, 청솔우성아파트 앞,201905,1157,1291,2448,37.574203,127.057693
동대문구,617, 청솔우성아파트 앞,201906,1242,1387,2629,37.574203,127.057693
동대문구,617, 청솔우성아파트 앞,201907,1226,1294,2520,37.574203,127.057693
동대문구,617, 청솔우성아파트 앞,201908,1059,1188,2247,37.574203,127.057693
동대문구,617, 청솔우성아파트 앞,201909,1191,1303,2494,37.574203,127.057693
동대문구,617, 청솔우성아파트 앞,201910,1344,1459,2803,37.574203,127.057693
동대문구,617, 청솔우성아파트 앞,201911,502,509,1011,37.574203,127.057693
동대문구,617, 청솔우성아파트 앞,201912,441,503,944,37.574203,127.057693
동대문구,617, 청솔우성아파트 앞,202001,365,433,798,37.574203,127.057693
동대문구,617, 청솔우성아파트 앞,202002,361,396,757,37.574203,127.057693
동대문구,617, 청솔우성아파트 앞,202003,711,767,1478,37.574203,127.057693
동대문구,617, 청솔우성아파트 앞,202004,1190,1195,2385,37.574203,127.057693
동대문구,617, 청솔우성아파트 앞,202005,1469,1473,2942,37.574203,127.057693
동대문구,617, 청솔우성아파트 앞,202006,1724,1800,3524,37.574203,127.057693
동대문구,621, 동대문중학교 옆,201901,110,99,209,37.574718,127.053391
동대문구,621, 동대문중학교 옆,201902,107,90,197,37.574718,127.053391
동대문구,621, 동대문중학교 옆,201903,221,161,382,37.574718,127.053391
동대문구,621, 동대문중학교 옆,201904,322,265,587,37.574718,127.053391
동대문구,621, 동대문중학교 옆,201905,435,345,780,37.574718,127.053391
동대문구,621, 동대문중학교 옆,201906,497,378,875,37.574718,127.053391
동대문구,621, 동대문중학교 옆,201907,396,313,709,37.574718,127.053391
동대문구,621, 동대문중학교 옆,201908,409,321,730,37.574718,127.053391
동대문구,621, 동대문중학교 옆,201909,410,333,743,37.574718,127.053391
동대문구,621, 동대문중학교 옆,201910,549,437,986,37.574718,127.053391
동대문구,621, 동대문중학교 옆,201911,360,310,670,37.574718,127.053391
동대문구,621, 동대문중학교 옆,201912,213,187,400,37.574718,127.053391
동대문구,621, 동대문중학교 옆,202001,188,146,334,37.574718,127.053391
동대문구,621, 동대문중학교 옆,202002,166,138,304,37.574718,127.053391
동대문구,621, 동대문중학교 옆,202003,282,272,554,37.574718,127.053391
동대문구,621, 동대문중학교 옆,202004,347,335,682,37.574718,127.053391
동대문구,621, 동대문중학교 옆,202005,331,324,655,37.574718,127.053391
동대문구,621, 동대문중학교 옆,202006,372,340,712,37.574718,127.053391
동대문구,622, 전농사거리 교통섬,201901,291,376,667,37.577793,127.057831
동대문구,622, 전농사거리 교통섬,201902,285,365,650,37.577793,127.057831
동대문구,622, 전농사거리 교통섬,201903,622,798,1420,37.577793,127.057831
동대문구,622, 전농사거리 교통섬,201904,768,1013,1781,37.577793,127.057831
동대문구,622, 전농사거리 교통섬,201905,1242,1648,2890,37.577793,127.057831
동대문구,622, 전농사거리 교통섬,201906,1468,1860,3328,37.577793,127.057831
동대문구,622, 전농사거리 교통섬,201907,1400,1839,3239,37.577793,127.057831
동대문구,622, 전농사거리 교통섬,201908,1385,1616,3001,37.577793,127.057831
동대문구,622, 전농사거리 교통섬,201909,1394,1497,2891,37.577793,127.057831
동대문구,622, 전농사거리 교통섬,201910,1623,1769,3392,37.577793,127.057831
동대문구,622, 전농사거리 교통섬,201911,1077,1348,2425,37.577793,127.057831
동대문구,622, 전농사거리 교통섬,201912,687,762,1449,37.577793,127.057831
동대문구,622, 전농사거리 교통섬,202001,572,685,1257,37.577793,127.057831
동대문구,622, 전농사거리 교통섬,202002,544,671,1215,37.577793,127.057831
동대문구,622, 전농사거리 교통섬,202003,991,1076,2067,37.577793,127.057831
동대문구,622, 전농사거리 교통섬,202004,1623,1666,3289,37.577793,127.057831
동대문구,622, 전농사거리 교통섬,202005,1662,1683,3345,37.577793,127.057831
동대문구,622, 전농사거리 교통섬,202006,1676,1706,3382,37.577793,127.057831
동대문구,623, 서울시립대 정문 앞,201901,795,444,1239,37.583698,127.053856
동대문구,623, 서울시립대 정문 앞,201902,730,401,1131,37.583698,127.053856
동대문구,623, 서울시립대 정문 앞,201903,1808,1069,2877,37.583698,127.053856
동대문구,623, 서울시립대 정문 앞,201904,2532,1457,3989,37.583698,127.053856
동대문구,623, 서울시립대 정문 앞,201905,3677,2308,5985,37.583698,127.053856
동대문구,623, 서울시립대 정문 앞,201906,3646,2310,5956,37.583698,127.053856
동대문구,623, 서울시립대 정문 앞,201907,2989,2102,5091,37.583698,127.053856
동대문구,623, 서울시립대 정문 앞,201908,2608,1790,4398,37.583698,127.053856
동대문구,623, 서울시립대 정문 앞,201909,2720,1894,4614,37.583698,127.053856
동대문구,623, 서울시립대 정문 앞,201910,2651,1901,4552,37.583698,127.053856
동대문구,623, 서울시립대 정문 앞,201911,1950,1309,3259,37.583698,127.053856
동대문구,623, 서울시립대 정문 앞,201912,1219,637,1856,37.583698,127.053856
동대문구,623, 서울시립대 정문 앞,202001,981,554,1535,37.583698,127.053856
동대문구,623, 서울시립대 정문 앞,202002,871,548,1419,37.583698,127.053856
동대문구,623, 서울시립대 정문 앞,202003,1025,690,1715,37.583698,127.053856
동대문구,623, 서울시립대 정문 앞,202004,1503,994,2497,37.583698,127.053856
동대문구,623, 서울시립대 정문 앞,202005,1598,1244,2842,37.583698,127.053856
동대문구,623, 서울시립대 정문 앞,202006,1919,1504,3423,37.583698,127.053856
동대문구,624, 전농동 동아아파트 앞,201901,369,476,845,37.574188,127.045891
동대문구,624, 전농동 동아아파트 앞,201902,416,487,903,37.574188,127.045891
동대문구,624, 전농동 동아아파트 앞,201903,711,888,1599,37.574188,127.045891
동대문구,624, 전농동 동아아파트 앞,201904,892,1172,2064,37.574188,127.045891
동대문구,624, 전농동 동아아파트 앞,201905,1361,1795,3156,37.574188,127.045891
동대문구,624, 전농동 동아아파트 앞,201906,1695,2059,3754,37.574188,127.045891
동대문구,624, 전농동 동아아파트 앞,201907,1655,2059,3714,37.574188,127.045891
동대문구,624, 전농동 동아아파트 앞,201908,1700,2022,3722,37.574188,127.045891
동대문구,624, 전농동 동아아파트 앞,201909,1532,1794,3326,37.574188,127.045891
동대문구,624, 전농동 동아아파트 앞,201910,1528,1792,3320,37.574188,127.045891
동대문구,624, 전농동 동아아파트 앞,201911,1178,1278,2456,37.574188,127.045891
동대문구,624, 전농동 동아아파트 앞,201912,777,881,1658,37.574188,127.045891
동대문구,624, 전농동 동아아파트 앞,202001,834,975,1809,37.574188,127.045891
동대문구,624, 전농동 동아아파트 앞,202002,780,856,1636,37.574188,127.045891
동대문구,624, 전농동 동아아파트 앞,202003,1135,1146,2281,37.574188,127.045891
동대문구,624, 전농동 동아아파트 앞,202004,1461,1531,2992,37.574188,127.045891
동대문구,624, 전농동 동아아파트 앞,202005,1591,1631,3222,37.574188,127.045891
동대문구,624, 전농동 동아아파트 앞,202006,1594,1675,3269,37.574188,127.045891
동대문구,625, 답십리초등학교 앞(현대시장 옆),201901,353,387,740,37.568192,127.057175
동대문구,625, 답십리초등학교 앞(현대시장 옆),201902,343,382,725,37.568192,127.057175
동대문구,625, 답십리초등학교 앞(현대시장 옆),201903,674,717,1391,37.568192,127.057175
동대문구,625, 답십리초등학교 앞(현대시장 옆),201904,1116,1294,2410,37.568192,127.057175
동대문구,625, 답십리초등학교 앞(현대시장 옆),201905,1669,1949,3618,37.568192,127.057175
동대문구,625, 답십리초등학교 앞(현대시장 옆),201906,1724,2000,3724,37.568192,127.057175
동대문구,625, 답십리초등학교 앞(현대시장 옆),201907,1732,2060,3792,37.568192,127.057175
동대문구,625, 답십리초등학교 앞(현대시장 옆),201908,1738,2070,3808,37.568192,127.057175
동대문구,625, 답십리초등학교 앞(현대시장 옆),201909,1734,1973,3707,37.568192,127.057175
동대문구,625, 답십리초등학교 앞(현대시장 옆),201910,2104,2223,4327,37.568192,127.057175
동대문구,625, 답십리초등학교 앞(현대시장 옆),201911,1509,1592,3101,37.568192,127.057175
동대문구,625, 답십리초등학교 앞(현대시장 옆),201912,901,931,1832,37.568192,127.057175
동대문구,625, 답십리초등학교 앞(현대시장 옆),202001,841,849,1690,37.568192,127.057175
동대문구,625, 답십리초등학교 앞(현대시장 옆),202002,719,741,1460,37.568192,127.057175
동대문구,625, 답십리초등학교 앞(현대시장 옆),202003,1251,1309,2560,37.568192,127.057175
동대문구,625, 답십리초등학교 앞(현대시장 옆),202004,1761,1803,3564,37.568192,127.057175
동대문구,625, 답십리초등학교 앞(현대시장 옆),202005,1956,1993,3949,37.568192,127.057175
동대문구,625, 답십리초등학교 앞(현대시장 옆),202006,2141,2277,4418,37.568192,127.057175
동대문구,626, 군자교 서측 녹지대,201901,240,332,572,37.561153,127.070969
동대문구,626, 군자교 서측 녹지대,201902,223,294,517,37.561153,127.070969
동대문구,626, 군자교 서측 녹지대,201903,402,528,930,37.561153,127.070969
동대문구,626, 군자교 서측 녹지대,201904,714,769,1483,37.561153,127.070969
동대문구,626, 군자교 서측 녹지대,201905,1182,1201,2383,37.561153,127.070969
동대문구,626, 군자교 서측 녹지대,201906,1320,1342,2662,37.561153,127.070969
동대문구,626, 군자교 서측 녹지대,201907,1189,1200,2389,37.561153,127.070969
동대문구,626, 군자교 서측 녹지대,201908,1150,1174,2324,37.561153,127.070969
동대문구,626, 군자교 서측 녹지대,201909,1092,1101,2193,37.561153,127.070969
동대문구,626, 군자교 서측 녹지대,201910,1340,1341,2681,37.561153,127.070969
동대문구,626, 군자교 서측 녹지대,201911,833,857,1690,37.561153,127.070969
동대문구,626, 군자교 서측 녹지대,201912,496,527,1023,37.561153,127.070969
동대문구,626, 군자교 서측 녹지대,202001,479,479,958,37.561153,127.070969
동대문구,626, 군자교 서측 녹지대,202002,540,550,1090,37.561153,127.070969
동대문구,626, 군자교 서측 녹지대,202003,1154,1171,2325,37.561153,127.070969
동대문구,626, 군자교 서측 녹지대,202004,1555,1581,3136,37.561153,127.070969
동대문구,626, 군자교 서측 녹지대,202005,1641,1656,3297,37.561153,127.070969
동대문구,626, 군자교 서측 녹지대,202006,1650,1666,3316,37.561153,127.070969
동대문구,627, 장안동삼거리 교통섬,201901,317,356,673,37.578632,127.071907
동대문구,627, 장안동삼거리 교통섬,201902,291,359,650,37.578632,127.071907
동대문구,627, 장안동삼거리 교통섬,201903,594,652,1246,37.578632,127.071907
동대문구,627, 장안동삼거리 교통섬,201904,985,1106,2091,37.578632,127.071907
동대문구,627, 장안동삼거리 교통섬,201905,1550,1770,3320,37.578632,127.071907
동대문구,627, 장안동삼거리 교통섬,201906,1732,1892,3624,37.578632,127.071907
동대문구,627, 장안동삼거리 교통섬,201907,1640,1744,3384,37.578632,127.071907
동대문구,627, 장안동삼거리 교통섬,201908,1495,1581,3076,37.578632,127.071907
동대문구,627, 장안동삼거리 교통섬,201909,1682,1824,3506,37.578632,127.071907
동대문구,627, 장안동삼거리 교통섬,201910,1870,2056,3926,37.578632,127.071907
동대문구,627, 장안동삼거리 교통섬,201911,1137,1198,2335,37.578632,127.071907
동대문구,627, 장안동삼거리 교통섬,201912,614,697,1311,37.578632,127.071907
동대문구,627, 장안동삼거리 교통섬,202001,574,578,1152,37.578632,127.071907
동대문구,627, 장안동삼거리 교통섬,202002,637,664,1301,37.578632,127.071907
동대문구,627, 장안동삼거리 교통섬,202003,1450,1570,3020,37.578632,127.071907
동대문구,627, 장안동삼거리 교통섬,202004,2199,2376,4575,37.578632,127.071907
동대문구,627, 장안동삼거리 교통섬,202005,2402,2584,4986,37.578632,127.071907
동대문구,627, 장안동삼거리 교통섬,202006,2249,2432,4681,37.578632,127.071907
동대문구,628, 휘봉고등학교 앞,201901,104,98,202,37.586815,127.067543
동대문구,628, 휘봉고등학교 앞,201902,132,103,235,37.586815,127.067543
동대문구,628, 휘봉고등학교 앞,201903,245,241,486,37.586815,127.067543
동대문구,628, 휘봉고등학교 앞,201904,318,303,621,37.586815,127.067543
동대문구,628, 휘봉고등학교 앞,201905,523,493,1016,37.586815,127.067543
동대문구,628, 휘봉고등학교 앞,201906,577,588,1165,37.586815,127.067543
동대문구,628, 휘봉고등학교 앞,201907,545,510,1055,37.586815,127.067543
동대문구,628, 휘봉고등학교 앞,201908,170,174,344,37.586815,127.067543
동대문구,628, 휘봉고등학교 앞,201909,525,499,1024,37.586815,127.067543
동대문구,628, 휘봉고등학교 앞,201910,665,609,1274,37.586815,127.067543
동대문구,628, 휘봉고등학교 앞,201911,378,360,738,37.586815,127.067543
동대문구,628, 휘봉고등학교 앞,201912,217,217,434,37.586815,127.067543
동대문구,628, 휘봉고등학교 앞,202001,194,191,385,37.586815,127.067543
동대문구,628, 휘봉고등학교 앞,202002,246,197,443,37.586815,127.067543
동대문구,628, 휘봉고등학교 앞,202003,291,286,577,37.586815,127.067543
동대문구,628, 휘봉고등학교 앞,202004,452,441,893,37.586815,127.067543
동대문구,628, 휘봉고등학교 앞,202005,696,689,1385,37.586815,127.067543
동대문구,628, 휘봉고등학교 앞,202006,818,812,1630,37.586815,127.067543
동대문구,630, 동대문구 보건소,201901,510,496,1006,37.574852,127.040306
동대문구,630, 동대문구 보건소,201902,492,492,984,37.574852,127.040306
동대문구,630, 동대문구 보건소,201903,868,812,1680,37.574852,127.040306
동대문구,630, 동대문구 보건소,201904,1040,1002,2042,37.574852,127.040306
동대문구,630, 동대문구 보건소,201905,1849,1778,3627,37.574852,127.040306
동대문구,630, 동대문구 보건소,201906,1950,1951,3901,37.574852,127.040306
동대문구,630, 동대문구 보건소,201907,1949,1998,3947,37.574852,127.040306
동대문구,630, 동대문구 보건소,201908,1939,1972,3911,37.574852,127.040306
동대문구,630, 동대문구 보건소,201909,1834,1830,3664,37.574852,127.040306
동대문구,630, 동대문구 보건소,201910,2075,2084,4159,37.574852,127.040306
동대문구,630, 동대문구 보건소,201911,1443,1448,2891,37.574852,127.040306
동대문구,630, 동대문구 보건소,201912,847,865,1712,37.574852,127.040306
동대문구,630, 동대문구 보건소,202001,744,751,1495,37.574852,127.040306
동대문구,630, 동대문구 보건소,202002,716,704,1420,37.574852,127.040306
동대문구,630, 동대문구 보건소,202003,1085,1063,2148,37.574852,127.040306
동대문구,630, 동대문구 보건소,202004,1478,1453,2931,37.574852,127.040306
동대문구,630, 동대문구 보건소,202005,1750,1789,3539,37.574852,127.040306
동대문구,630, 동대문구 보건소,202006,2144,2199,4343,37.574852,127.040306
동대문구,631, 답십리역 1번출구,201901,591,627,1218,37.568184,127.051277
동대문구,631, 답십리역 1번출구,201902,513,553,1066,37.568184,127.051277
동대문구,631, 답십리역 1번출구,201903,1004,957,1961,37.568184,127.051277
동대문구,631, 답십리역 1번출구,201904,1615,1488,3103,37.568184,127.051277
동대문구,631, 답십리역 1번출구,201905,2296,2195,4491,37.568184,127.051277
동대문구,631, 답십리역 1번출구,201906,2611,2611,5222,37.568184,127.051277
동대문구,631, 답십리역 1번출구,201907,2576,2596,5172,37.568184,127.051277
동대문구,631, 답십리역 1번출구,201908,2435,2529,4964,37.568184,127.051277
동대문구,631, 답십리역 1번출구,201909,2470,2507,4977,37.568184,127.051277
동대문구,631, 답십리역 1번출구,201910,2907,2924,5831,37.568184,127.051277
동대문구,631, 답십리역 1번출구,201911,2113,2143,4256,37.568184,127.051277
동대문구,631, 답십리역 1번출구,201912,1337,1368,2705,37.568184,127.051277
동대문구,631, 답십리역 1번출구,202001,1068,1084,2152,37.568184,127.051277
동대문구,631, 답십리역 1번출구,202002,986,1115,2101,37.568184,127.051277
동대문구,631, 답십리역 1번출구,202003,1573,1571,3144,37.568184,127.051277
동대문구,631, 답십리역 1번출구,202004,2121,2117,4238,37.568184,127.051277
동대문구,631, 답십리역 1번출구,202005,2330,2337,4667,37.568184,127.051277
동대문구,631, 답십리역 1번출구,202006,2817,2879,5696,37.568184,127.051277
동대문구,633, 청량리 기업은행 앞,201901,529,607,1136,37.580406,127.044823
동대문구,633, 청량리 기업은행 앞,201902,491,587,1078,37.580406,127.044823
동대문구,633, 청량리 기업은행 앞,201903,959,1000,1959,37.580406,127.044823
동대문구,633, 청량리 기업은행 앞,201904,1273,1502,2775,37.580406,127.044823
동대문구,633, 청량리 기업은행 앞,201905,2114,2204,4318,37.580406,127.044823
동대문구,633, 청량리 기업은행 앞,201906,2411,2544,4955,37.580406,127.044823
동대문구,633, 청량리 기업은행 앞,201907,2242,2441,4683,37.580406,127.044823
동대문구,633, 청량리 기업은행 앞,201908,1932,2134,4066,37.580406,127.044823
동대문구,633, 청량리 기업은행 앞,201909,1987,2099,4086,37.580406,127.044823
동대문구,633, 청량리 기업은행 앞,201910,2546,2594,5140,37.580406,127.044823
동대문구,633, 청량리 기업은행 앞,201911,1312,1479,2791,37.580406,127.044823
동대문구,633, 청량리 기업은행 앞,201912,739,837,1576,37.580406,127.044823
동대문구,633, 청량리 기업은행 앞,202001,844,926,1770,37.580406,127.044823
동대문구,633, 청량리 기업은행 앞,202002,887,939,1826,37.580406,127.044823
동대문구,633, 청량리 기업은행 앞,202003,1468,1587,3055,37.580406,127.044823
동대문구,633, 청량리 기업은행 앞,202004,2034,2077,4111,37.580406,127.044823
동대문구,633, 청량리 기업은행 앞,202005,2135,2186,4321,37.580406,127.044823
동대문구,633, 청량리 기업은행 앞,202006,1968,2140,4108,37.580406,127.044823
동대문구,634, 외국어대 정문 앞,201901,647,662,1309,37.59602,127.05983
동대문구,634, 외국어대 정문 앞,201902,564,609,1173,37.59602,127.05983
동대문구,634, 외국어대 정문 앞,201903,1431,1536,2967,37.59602,127.05983
동대문구,634, 외국어대 정문 앞,201904,2157,2174,4331,37.59602,127.05983
동대문구,634, 외국어대 정문 앞,201905,3601,3589,7190,37.59602,127.05983
동대문구,634, 외국어대 정문 앞,201906,3602,3586,7188,37.59602,127.05983
동대문구,634, 외국어대 정문 앞,201907,3299,3320,6619,37.59602,127.05983
동대문구,634, 외국어대 정문 앞,201908,2840,2857,5697,37.59602,127.05983
동대문구,634, 외국어대 정문 앞,201909,3322,3350,6672,37.59602,127.05983
동대문구,634, 외국어대 정문 앞,201910,3654,3661,7315,37.59602,127.05983
동대문구,634, 외국어대 정문 앞,201911,2159,2171,4330,37.59602,127.05983
동대문구,634, 외국어대 정문 앞,201912,1015,1006,2021,37.59602,127.05983
동대문구,634, 외국어대 정문 앞,202001,899,817,1716,37.59602,127.05983
동대문구,634, 외국어대 정문 앞,202002,994,923,1917,37.59602,127.05983
동대문구,634, 외국어대 정문 앞,202003,2032,1971,4003,37.59602,127.05983
동대문구,634, 외국어대 정문 앞,202004,2774,2743,5517,37.59602,127.05983
동대문구,634, 외국어대 정문 앞,202005,3630,3520,7150,37.59602,127.05983
동대문구,634, 외국어대 정문 앞,202006,3457,3375,6832,37.59602,127.05983
동대문구,635, 시조사 앞 (청량고정문 옆),201901,373,341,714,37.587517,127.052773
동대문구,635, 시조사 앞 (청량고정문 옆),201902,391,377,768,37.587517,127.052773
동대문구,635, 시조사 앞 (청량고정문 옆),201903,856,819,1675,37.587517,127.052773
동대문구,635, 시조사 앞 (청량고정문 옆),201904,1325,1304,2629,37.587517,127.052773
동대문구,635, 시조사 앞 (청량고정문 옆),201905,2145,2140,4285,37.587517,127.052773
동대문구,635, 시조사 앞 (청량고정문 옆),201906,2198,2135,4333,37.587517,127.052773
동대문구,635, 시조사 앞 (청량고정문 옆),201907,1990,1945,3935,37.587517,127.052773
동대문구,635, 시조사 앞 (청량고정문 옆),201908,1880,1806,3686,37.587517,127.052773
동대문구,635, 시조사 앞 (청량고정문 옆),201909,2086,1999,4085,37.587517,127.052773
동대문구,635, 시조사 앞 (청량고정문 옆),201910,2371,2309,4680,37.587517,127.052773
동대문구,635, 시조사 앞 (청량고정문 옆),201911,1528,1471,2999,37.587517,127.052773
동대문구,635, 시조사 앞 (청량고정문 옆),201912,706,639,1345,37.587517,127.052773
동대문구,635, 시조사 앞 (청량고정문 옆),202001,585,563,1148,37.587517,127.052773
동대문구,635, 시조사 앞 (청량고정문 옆),202002,641,645,1286,37.587517,127.052773
동대문구,635, 시조사 앞 (청량고정문 옆),202003,1197,1184,2381,37.587517,127.052773
동대문구,635, 시조사 앞 (청량고정문 옆),202004,1949,1941,3890,37.587517,127.052773
동대문구,635, 시조사 앞 (청량고정문 옆),202005,2276,2235,4511,37.587517,127.052773
동대문구,635, 시조사 앞 (청량고정문 옆),202006,2011,1967,3978,37.587517,127.052773
동대문구,636, 세종대왕기념관 교차로,201901,201,215,416,37.5909,127.042587
동대문구,636, 세종대왕기념관 교차로,201902,173,197,370,37.5909,127.042587
동대문구,636, 세종대왕기념관 교차로,201903,327,406,733,37.5909,127.042587
동대문구,636, 세종대왕기념관 교차로,201904,475,573,1048,37.5909,127.042587
동대문구,636, 세종대왕기념관 교차로,201905,840,935,1775,37.5909,127.042587
동대문구,636, 세종대왕기념관 교차로,201906,874,961,1835,37.5909,127.042587
동대문구,636, 세종대왕기념관 교차로,201907,853,992,1845,37.5909,127.042587
동대문구,636, 세종대왕기념관 교차로,201908,810,980,1790,37.5909,127.042587
동대문구,636, 세종대왕기념관 교차로,201909,889,995,1884,37.5909,127.042587
동대문구,636, 세종대왕기념관 교차로,201910,1036,1132,2168,37.5909,127.042587
동대문구,636, 세종대왕기념관 교차로,201911,752,815,1567,37.5909,127.042587
동대문구,636, 세종대왕기념관 교차로,201912,390,454,844,37.5909,127.042587
동대문구,636, 세종대왕기념관 교차로,202001,318,411,729,37.5909,127.042587
동대문구,636, 세종대왕기념관 교차로,202002,257,346,603,37.5909,127.042587
동대문구,636, 세종대왕기념관 교차로,202003,592,622,1214,37.5909,127.042587
동대문구,636, 세종대왕기념관 교차로,202004,680,694,1374,37.5909,127.042587
동대문구,636, 세종대왕기념관 교차로,202005,818,827,1645,37.5909,127.042587
동대문구,636, 세종대왕기념관 교차로,202006,966,1056,2022,37.5909,127.042587
동대문구,637, KAIST 경영대학 앞,201901,402,325,727,37.591614,127.045792
동대문구,637, KAIST 경영대학 앞,201902,317,287,604,37.591614,127.045792
동대문구,637, KAIST 경영대학 앞,201903,698,547,1245,37.591614,127.045792
동대문구,637, KAIST 경영대학 앞,201904,1040,870,1910,37.591614,127.045792
동대문구,637, KAIST 경영대학 앞,201905,1333,1094,2427,37.591614,127.045792
동대문구,637, KAIST 경영대학 앞,201906,1417,1289,2706,37.591614,127.045792
동대문구,637, KAIST 경영대학 앞,201907,1279,1150,2429,37.591614,127.045792
동대문구,637, KAIST 경영대학 앞,201908,1257,1040,2297,37.591614,127.045792
동대문구,637, KAIST 경영대학 앞,201909,1261,1173,2434,37.591614,127.045792
동대문구,637, KAIST 경영대학 앞,201910,1414,1326,2740,37.591614,127.045792
동대문구,637, KAIST 경영대학 앞,201911,1040,934,1974,37.591614,127.045792
동대문구,637, KAIST 경영대학 앞,201912,551,469,1020,37.591614,127.045792
동대문구,637, KAIST 경영대학 앞,202001,420,399,819,37.591614,127.045792
동대문구,637, KAIST 경영대학 앞,202002,406,385,791,37.591614,127.045792
동대문구,637, KAIST 경영대학 앞,202003,941,836,1777,37.591614,127.045792
동대문구,637, KAIST 경영대학 앞,202004,1205,1104,2309,37.591614,127.045792
동대문구,637, KAIST 경영대학 앞,202005,1305,1246,2551,37.591614,127.045792
동대문구,637, KAIST 경영대학 앞,202006,1284,1167,2451,37.591614,127.045792
동대문구,638, 서울시립대 정보기술관,201901,148,311,459,37.583008,127.060974
동대문구,638, 서울시립대 정보기술관,201902,137,243,380,37.583008,127.060974
동대문구,638, 서울시립대 정보기술관,201903,399,693,1092,37.583008,127.060974
동대문구,638, 서울시립대 정보기술관,201904,587,976,1563,37.583008,127.060974
동대문구,638, 서울시립대 정보기술관,201905,1186,1530,2716,37.583008,127.060974
동대문구,638, 서울시립대 정보기술관,201906,1239,1396,2635,37.583008,127.060974
동대문구,638, 서울시립대 정보기술관,201907,890,890,1780,37.583008,127.060974
동대문구,638, 서울시립대 정보기술관,201908,776,766,1542,37.583008,127.060974
동대문구,638, 서울시립대 정보기술관,201909,1033,1099,2132,37.583008,127.060974
동대문구,638, 서울시립대 정보기술관,201910,1170,1203,2373,37.583008,127.060974
동대문구,638, 서울시립대 정보기술관,201911,791,890,1681,37.583008,127.060974
동대문구,638, 서울시립대 정보기술관,201912,435,508,943,37.583008,127.060974
동대문구,638, 서울시립대 정보기술관,202001,295,268,563,37.583008,127.060974
동대문구,638, 서울시립대 정보기술관,202002,224,221,445,37.583008,127.060974
동대문구,638, 서울시립대 정보기술관,202003,241,188,429,37.583008,127.060974
동대문구,638, 서울시립대 정보기술관,202004,331,339,670,37.583008,127.060974
동대문구,638, 서울시립대 정보기술관,202005,451,413,864,37.583008,127.060974
동대문구,638, 서울시립대 정보기술관,202006,505,504,1009,37.583008,127.060974
동대문구,639, 서울시립대 후문,201901,545,334,879,37.585197,127.060951
동대문구,639, 서울시립대 후문,201902,488,311,799,37.585197,127.060951
동대문구,639, 서울시립대 후문,201903,1224,898,2122,37.585197,127.060951
동대문구,639, 서울시립대 후문,201904,1666,1243,2909,37.585197,127.060951
동대문구,639, 서울시립대 후문,201905,2243,1736,3979,37.585197,127.060951
동대문구,639, 서울시립대 후문,201906,2132,1878,4010,37.585197,127.060951
동대문구,639, 서울시립대 후문,201907,2052,1773,3825,37.585197,127.060951
동대문구,639, 서울시립대 후문,201908,1832,1636,3468,37.585197,127.060951
동대문구,639, 서울시립대 후문,201909,1520,1361,2881,37.585197,127.060951
동대문구,639, 서울시립대 후문,201910,1372,1275,2647,37.585197,127.060951
동대문구,639, 서울시립대 후문,201911,1061,919,1980,37.585197,127.060951
동대문구,639, 서울시립대 후문,201912,712,601,1313,37.585197,127.060951
동대문구,639, 서울시립대 후문,202001,519,497,1016,37.585197,127.060951
동대문구,639, 서울시립대 후문,202002,579,533,1112,37.585197,127.060951
동대문구,639, 서울시립대 후문,202003,526,493,1019,37.585197,127.060951
동대문구,639, 서울시립대 후문,202004,647,630,1277,37.585197,127.060951
동대문구,639, 서울시립대 후문,202005,680,680,1360,37.585197,127.060951
동대문구,639, 서울시립대 후문,202006,762,770,1532,37.585197,127.060951
동대문구,640, KEB하나은행 청량리역지점,201901,179,165,344,37.582455,127.044495
동대문구,640, KEB하나은행 청량리역지점,201902,155,147,302,37.582455,127.044495
동대문구,640, KEB하나은행 청량리역지점,201903,322,333,655,37.582455,127.044495
동대문구,640, KEB하나은행 청량리역지점,201904,461,526,987,37.582455,127.044495
동대문구,640, KEB하나은행 청량리역지점,201905,725,804,1529,37.582455,127.044495
동대문구,640, KEB하나은행 청량리역지점,201906,872,897,1769,37.582455,127.044495
동대문구,640, KEB하나은행 청량리역지점,201907,847,908,1755,37.582455,127.044495
동대문구,640, KEB하나은행 청량리역지점,201908,735,835,1570,37.582455,127.044495
동대문구,640, KEB하나은행 청량리역지점,201909,732,757,1489,37.582455,127.044495
동대문구,640, KEB하나은행 청량리역지점,201910,921,958,1879,37.582455,127.044495
동대문구,640, KEB하나은행 청량리역지점,201911,718,803,1521,37.582455,127.044495
동대문구,640, KEB하나은행 청량리역지점,201912,441,557,998,37.582455,127.044495
동대문구,640, KEB하나은행 청량리역지점,202001,290,387,677,37.582455,127.044495
동대문구,640, KEB하나은행 청량리역지점,202002,318,408,726,37.582455,127.044495
동대문구,640, KEB하나은행 청량리역지점,202003,505,554,1059,37.582455,127.044495
동대문구,640, KEB하나은행 청량리역지점,202004,747,794,1541,37.582455,127.044495
동대문구,640, KEB하나은행 청량리역지점,202005,860,880,1740,37.582455,127.044495
동대문구,640, KEB하나은행 청량리역지점,202006,975,989,1964,37.582455,127.044495
동대문구,641, 용두역 4번출구,201901,443,467,910,37.573753,127.038536
동대문구,641, 용두역 4번출구,201902,382,406,788,37.573753,127.038536
동대문구,641, 용두역 4번출구,201903,905,927,1832,37.573753,127.038536
동대문구,641, 용두역 4번출구,201904,1429,1448,2877,37.573753,127.038536
동대문구,641, 용두역 4번출구,201905,2196,2163,4359,37.573753,127.038536
동대문구,641, 용두역 4번출구,201906,2209,2198,4407,37.573753,127.038536
동대문구,641, 용두역 4번출구,201907,2103,2151,4254,37.573753,127.038536
동대문구,641, 용두역 4번출구,201908,2106,2103,4209,37.573753,127.038536
동대문구,641, 용두역 4번출구,201909,2037,2050,4087,37.573753,127.038536
동대문구,641, 용두역 4번출구,201910,2286,2290,4576,37.573753,127.038536
동대문구,641, 용두역 4번출구,201911,1566,1608,3174,37.573753,127.038536
동대문구,641, 용두역 4번출구,201912,840,852,1692,37.573753,127.038536
동대문구,641, 용두역 4번출구,202001,783,822,1605,37.573753,127.038536
동대문구,641, 용두역 4번출구,202002,817,798,1615,37.573753,127.038536
동대문구,641, 용두역 4번출구,202003,1800,1806,3606,37.573753,127.038536
동대문구,641, 용두역 4번출구,202004,2383,2386,4769,37.573753,127.038536
동대문구,641, 용두역 4번출구,202005,2476,2475,4951,37.573753,127.038536
동대문구,641, 용두역 4번출구,202006,2625,2635,5260,37.573753,127.038536
동대문구,642, 신답역 사거리,201901,448,445,893,#N/A,#N/A
동대문구,642, 신답역 사거리,201902,395,395,790,#N/A,#N/A
동대문구,642, 신답역 사거리,201903,719,728,1447,#N/A,#N/A
동대문구,642, 신답역 사거리,201904,947,968,1915,#N/A,#N/A
동대문구,642, 신답역 사거리,201905,1574,1577,3151,#N/A,#N/A
동대문구,642, 신답역 사거리,201906,1652,1677,3329,#N/A,#N/A
동대문구,642, 신답역 사거리,201907,1716,1737,3453,#N/A,#N/A
동대문구,642, 신답역 사거리,201908,1564,1566,3130,#N/A,#N/A
동대문구,642, 신답역 사거리,201909,1509,1465,2974,#N/A,#N/A
동대문구,642, 신답역 사거리,201910,1846,1772,3618,#N/A,#N/A
동대문구,642, 신답역 사거리,201911,1261,1176,2437,#N/A,#N/A
동대문구,642, 신답역 사거리,201912,696,686,1382,#N/A,#N/A
동대문구,642, 신답역 사거리,202001,567,559,1126,#N/A,#N/A
동대문구,642, 신답역 사거리,202002,512,519,1031,#N/A,#N/A
동대문구,642, 신답역 사거리,202003,872,894,1766,#N/A,#N/A
동대문구,642, 신답역 사거리,202004,1262,1285,2547,#N/A,#N/A
동대문구,642, 신답역 사거리,202005,1351,1359,2710,#N/A,#N/A
동대문구,642, 신답역 사거리,202006,534,533,1067,#N/A,#N/A
동대문구,643, 동대문구민체육센터 (육교아래),201901,273,405,678,37.566971,127.074417
동대문구,643, 동대문구민체육센터 (육교아래),201902,261,382,643,37.566971,127.074417
동대문구,643, 동대문구민체육센터 (육교아래),201903,483,611,1094,37.566971,127.074417
동대문구,643, 동대문구민체육센터 (육교아래),201904,916,1210,2126,37.566971,127.074417
동대문구,643, 동대문구민체육센터 (육교아래),201905,1238,1549,2787,37.566971,127.074417
동대문구,643, 동대문구민체육센터 (육교아래),201906,1393,1655,3048,37.566971,127.074417
동대문구,643, 동대문구민체육센터 (육교아래),201907,1216,1423,2639,37.566971,127.074417
동대문구,643, 동대문구민체육센터 (육교아래),201908,1224,1420,2644,37.566971,127.074417
동대문구,643, 동대문구민체육센터 (육교아래),201909,1396,1618,3014,37.566971,127.074417
동대문구,643, 동대문구민체육센터 (육교아래),201910,1480,1682,3162,37.566971,127.074417
동대문구,643, 동대문구민체육센터 (육교아래),201911,944,1085,2029,37.566971,127.074417
동대문구,643, 동대문구민체육센터 (육교아래),201912,566,724,1290,37.566971,127.074417
동대문구,643, 동대문구민체육센터 (육교아래),202001,537,643,1180,37.566971,127.074417
동대문구,643, 동대문구민체육센터 (육교아래),202002,538,628,1166,37.566971,127.074417
동대문구,643, 동대문구민체육센터 (육교아래),202003,1347,1459,2806,37.566971,127.074417
동대문구,643, 동대문구민체육센터 (육교아래),202004,2035,2187,4222,37.566971,127.074417
동대문구,643, 동대문구민체육센터 (육교아래),202005,2248,2328,4576,37.566971,127.074417
동대문구,643, 동대문구민체육센터 (육교아래),202006,1913,2044,3957,37.566971,127.074417
동대문구,646, 장한평역 1번출구 (국민은행앞),201901,830,981,1811,37.561867,127.064377
동대문구,646, 장한평역 1번출구 (국민은행앞),201902,753,882,1635,37.561867,127.064377
동대문구,646, 장한평역 1번출구 (국민은행앞),201903,1201,1404,2605,37.561867,127.064377
동대문구,646, 장한평역 1번출구 (국민은행앞),201904,1713,2013,3726,37.561867,127.064377
동대문구,646, 장한평역 1번출구 (국민은행앞),201905,2511,2947,5458,37.561867,127.064377
동대문구,646, 장한평역 1번출구 (국민은행앞),201906,2807,3192,5999,37.561867,127.064377
동대문구,646, 장한평역 1번출구 (국민은행앞),201907,2929,3335,6264,37.561867,127.064377
동대문구,646, 장한평역 1번출구 (국민은행앞),201908,2766,3042,5808,37.561867,127.064377
동대문구,646, 장한평역 1번출구 (국민은행앞),201909,2887,3165,6052,37.561867,127.064377
동대문구,646, 장한평역 1번출구 (국민은행앞),201910,3637,3920,7557,37.561867,127.064377
동대문구,646, 장한평역 1번출구 (국민은행앞),201911,2583,2772,5355,37.561867,127.064377
동대문구,646, 장한평역 1번출구 (국민은행앞),201912,1696,1861,3557,37.561867,127.064377
동대문구,646, 장한평역 1번출구 (국민은행앞),202001,1423,1594,3017,37.561867,127.064377
동대문구,646, 장한평역 1번출구 (국민은행앞),202002,1328,1444,2772,37.561867,127.064377
동대문구,646, 장한평역 1번출구 (국민은행앞),202003,2231,2418,4649,37.561867,127.064377
동대문구,646, 장한평역 1번출구 (국민은행앞),202004,3368,3512,6880,37.561867,127.064377
동대문구,646, 장한평역 1번출구 (국민은행앞),202005,3590,3682,7272,37.561867,127.064377
동대문구,646, 장한평역 1번출구 (국민은행앞),202006,4496,4876,9372,37.561867,127.064377
동대문구,647, 신이문역 1번출구,201901,210,296,506,37.602798,127.067268
동대문구,647, 신이문역 1번출구,201902,237,310,547,37.602798,127.067268
동대문구,647, 신이문역 1번출구,201903,429,494,923,37.602798,127.067268
동대문구,647, 신이문역 1번출구,201904,538,627,1165,37.602798,127.067268
동대문구,647, 신이문역 1번출구,201905,812,1016,1828,37.602798,127.067268
동대문구,647, 신이문역 1번출구,201906,906,1055,1961,37.602798,127.067268
동대문구,647, 신이문역 1번출구,201907,940,1096,2036,37.602798,127.067268
동대문구,647, 신이문역 1번출구,201908,853,1037,1890,37.602798,127.067268
동대문구,647, 신이문역 1번출구,201909,932,1066,1998,37.602798,127.067268
동대문구,647, 신이문역 1번출구,201910,990,1125,2115,37.602798,127.067268
동대문구,647, 신이문역 1번출구,201911,614,664,1278,37.602798,127.067268
동대문구,647, 신이문역 1번출구,201912,285,346,631,37.602798,127.067268
동대문구,647, 신이문역 1번출구,202001,253,334,587,37.602798,127.067268
동대문구,647, 신이문역 1번출구,202002,311,360,671,37.602798,127.067268
동대문구,647, 신이문역 1번출구,202003,729,751,1480,37.602798,127.067268
동대문구,647, 신이문역 1번출구,202004,1143,1216,2359,37.602798,127.067268
동대문구,647, 신이문역 1번출구,202005,1271,1343,2614,37.602798,127.067268
동대문구,647, 신이문역 1번출구,202006,1232,1338,2570,37.602798,127.067268
동대문구,648, 장안동위더스빌옆,201901,567,485,1052,37.5667,127.062424
동대문구,648, 장안동위더스빌옆,201902,519,466,985,37.5667,127.062424
동대문구,648, 장안동위더스빌옆,201903,951,940,1891,37.5667,127.062424
동대문구,648, 장안동위더스빌옆,201904,1344,1441,2785,37.5667,127.062424
동대문구,648, 장안동위더스빌옆,201905,2132,2242,4374,37.5667,127.062424
동대문구,648, 장안동위더스빌옆,201906,2356,2587,4943,37.5667,127.062424
동대문구,648, 장안동위더스빌옆,201907,2353,2562,4915,37.5667,127.062424
동대문구,648, 장안동위더스빌옆,201908,2245,2439,4684,37.5667,127.062424
동대문구,648, 장안동위더스빌옆,201909,2204,2430,4634,37.5667,127.062424
동대문구,648, 장안동위더스빌옆,201910,2743,2852,5595,37.5667,127.062424
동대문구,648, 장안동위더스빌옆,201911,1861,1895,3756,37.5667,127.062424
동대문구,648, 장안동위더스빌옆,201912,1248,1210,2458,37.5667,127.062424
동대문구,648, 장안동위더스빌옆,202001,1068,1101,2169,37.5667,127.062424
동대문구,648, 장안동위더스빌옆,202002,997,1013,2010,37.5667,127.062424
동대문구,648, 장안동위더스빌옆,202003,1707,1697,3404,37.5667,127.062424
동대문구,648, 장안동위더스빌옆,202004,2332,2308,4640,37.5667,127.062424
동대문구,648, 장안동위더스빌옆,202005,2532,2606,5138,37.5667,127.062424
동대문구,648, 장안동위더스빌옆,202006,3109,3190,6299,37.5667,127.062424
동대문구,650, 중랑교사거리,201901,460,424,884,37.591534,127.067741
동대문구,650, 중랑교사거리,201902,496,401,897,37.591534,127.067741
동대문구,650, 중랑교사거리,201903,1015,950,1965,37.591534,127.067741
동대문구,650, 중랑교사거리,201904,1713,1675,3388,37.591534,127.067741
동대문구,650, 중랑교사거리,201905,3081,2973,6054,37.591534,127.067741
동대문구,650, 중랑교사거리,201906,2968,2792,5760,37.591534,127.067741
동대문구,650, 중랑교사거리,201907,2748,2729,5477,37.591534,127.067741
동대문구,650, 중랑교사거리,201908,2896,2868,5764,37.591534,127.067741
동대문구,650, 중랑교사거리,201909,2924,2896,5820,37.591534,127.067741
동대문구,650, 중랑교사거리,201910,3058,2941,5999,37.591534,127.067741
동대문구,650, 중랑교사거리,201911,1907,1805,3712,37.591534,127.067741
동대문구,650, 중랑교사거리,201912,994,949,1943,37.591534,127.067741
동대문구,650, 중랑교사거리,202001,946,869,1815,37.591534,127.067741
동대문구,650, 중랑교사거리,202002,932,870,1802,37.591534,127.067741
동대문구,650, 중랑교사거리,202003,2406,2379,4785,37.591534,127.067741
동대문구,650, 중랑교사거리,202004,4073,4091,8164,37.591534,127.067741
동대문구,650, 중랑교사거리,202005,4154,4164,8318,37.591534,127.067741
동대문구,650, 중랑교사거리,202006,3448,3403,6851,37.591534,127.067741
동대문구,651, 우리은행청량리지점앞,201901,315,350,665,#N/A,#N/A
동대문구,651, 우리은행청량리지점앞,201902,272,266,538,#N/A,#N/A
동대문구,651, 우리은행청량리지점앞,201903,499,523,1022,#N/A,#N/A
동대문구,651, 우리은행청량리지점앞,201904,745,721,1466,#N/A,#N/A
동대문구,651, 우리은행청량리지점앞,201905,1117,1089,2206,#N/A,#N/A
동대문구,651, 우리은행청량리지점앞,201906,1204,1164,2368,#N/A,#N/A
동대문구,651, 우리은행청량리지점앞,201907,1138,1134,2272,#N/A,#N/A
동대문구,651, 우리은행청량리지점앞,201908,982,940,1922,#N/A,#N/A
동대문구,651, 우리은행청량리지점앞,201909,984,941,1925,#N/A,#N/A
동대문구,651, 우리은행청량리지점앞,201910,1202,1147,2349,#N/A,#N/A
동대문구,651, 우리은행청량리지점앞,201911,804,747,1551,#N/A,#N/A
동대문구,651, 우리은행청량리지점앞,201912,438,395,833,#N/A,#N/A
동대문구,651, 우리은행청량리지점앞,202001,371,323,694,#N/A,#N/A
동대문구,651, 우리은행청량리지점앞,202002,356,320,676,#N/A,#N/A
동대문구,651, 우리은행청량리지점앞,202003,709,673,1382,#N/A,#N/A
동대문구,651, 우리은행청량리지점앞,202004,815,808,1623,#N/A,#N/A
동대문구,651, 우리은행청량리지점앞,202005,995,995,1990,#N/A,#N/A
동대문구,651, 우리은행청량리지점앞,202006,361,363,724,#N/A,#N/A
동대문구,652, 답십리 래미안엘파인아파트 입구,201901,83,76,159,37.57653,127.065941
동대문구,652, 답십리 래미안엘파인아파트 입구,201902,103,100,203,37.57653,127.065941
동대문구,652, 답십리 래미안엘파인아파트 입구,201903,229,212,441,37.57653,127.065941
동대문구,652, 답십리 래미안엘파인아파트 입구,201904,275,258,533,37.57653,127.065941
동대문구,652, 답십리 래미안엘파인아파트 입구,201905,500,489,989,37.57653,127.065941
동대문구,652, 답십리 래미안엘파인아파트 입구,201906,599,677,1276,37.57653,127.065941
동대문구,652, 답십리 래미안엘파인아파트 입구,201907,534,597,1131,37.57653,127.065941
동대문구,652, 답십리 래미안엘파인아파트 입구,201908,456,510,966,37.57653,127.065941
동대문구,652, 답십리 래미안엘파인아파트 입구,201909,483,507,990,37.57653,127.065941
동대문구,652, 답십리 래미안엘파인아파트 입구,201910,562,602,1164,37.57653,127.065941
동대문구,652, 답십리 래미안엘파인아파트 입구,201911,323,326,649,37.57653,127.065941
동대문구,652, 답십리 래미안엘파인아파트 입구,201912,180,197,377,37.57653,127.065941
동대문구,652, 답십리 래미안엘파인아파트 입구,202001,150,163,313,37.57653,127.065941
동대문구,652, 답십리 래미안엘파인아파트 입구,202002,175,185,360,37.57653,127.065941
동대문구,652, 답십리 래미안엘파인아파트 입구,202003,373,351,724,37.57653,127.065941
동대문구,652, 답십리 래미안엘파인아파트 입구,202004,575,601,1176,37.57653,127.065941
동대문구,652, 답십리 래미안엘파인아파트 입구,202005,712,708,1420,37.57653,127.065941
동대문구,652, 답십리 래미안엘파인아파트 입구,202006,851,895,1746,37.57653,127.065941
동대문구,654, 전농동 텃골공원,201901,120,124,244,37.577621,127.052109
동대문구,654, 전농동 텃골공원,201902,134,135,269,37.577621,127.052109
동대문구,654, 전농동 텃골공원,201903,273,208,481,37.577621,127.052109
동대문구,654, 전농동 텃골공원,201904,447,348,795,37.577621,127.052109
동대문구,654, 전농동 텃골공원,201905,597,567,1164,37.577621,127.052109
동대문구,654, 전농동 텃골공원,201906,756,688,1444,37.577621,127.052109
동대문구,654, 전농동 텃골공원,201907,724,599,1323,37.577621,127.052109
동대문구,654, 전농동 텃골공원,201908,528,463,991,37.577621,127.052109
동대문구,654, 전농동 텃골공원,201909,629,544,1173,37.577621,127.052109
동대문구,654, 전농동 텃골공원,201910,762,688,1450,37.577621,127.052109
동대문구,654, 전농동 텃골공원,201911,644,540,1184,37.577621,127.052109
동대문구,654, 전농동 텃골공원,201912,378,365,743,37.577621,127.052109
동대문구,654, 전농동 텃골공원,202001,301,274,575,37.577621,127.052109
동대문구,654, 전농동 텃골공원,202002,306,233,539,37.577621,127.052109
동대문구,654, 전농동 텃골공원,202003,384,387,771,37.577621,127.052109
동대문구,654, 전농동 텃골공원,202004,499,492,991,37.577621,127.052109
동대문구,654, 전농동 텃골공원,202005,582,582,1164,37.577621,127.052109
동대문구,654, 전농동 텃골공원,202006,695,682,1377,37.577621,127.052109
동대문구,656, 영휘원 교차로,201901,131,137,268,37.587238,127.043137
동대문구,656, 영휘원 교차로,201902,119,126,245,37.587238,127.043137
동대문구,656, 영휘원 교차로,201903,289,300,589,37.587238,127.043137
동대문구,656, 영휘원 교차로,201904,388,440,828,37.587238,127.043137
동대문구,656, 영휘원 교차로,201905,693,699,1392,37.587238,127.043137
동대문구,656, 영휘원 교차로,201906,697,747,1444,37.587238,127.043137
동대문구,656, 영휘원 교차로,201907,685,669,1354,37.587238,127.043137
동대문구,656, 영휘원 교차로,201908,702,737,1439,37.587238,127.043137
동대문구,656, 영휘원 교차로,201909,736,731,1467,37.587238,127.043137
동대문구,656, 영휘원 교차로,201910,873,871,1744,37.587238,127.043137
동대문구,656, 영휘원 교차로,201911,551,590,1141,37.587238,127.043137
동대문구,656, 영휘원 교차로,201912,357,423,780,37.587238,127.043137
동대문구,656, 영휘원 교차로,202001,375,417,792,37.587238,127.043137
동대문구,656, 영휘원 교차로,202002,412,423,835,37.587238,127.043137
동대문구,656, 영휘원 교차로,202003,617,598,1215,37.587238,127.043137
동대문구,656, 영휘원 교차로,202004,842,811,1653,37.587238,127.043137
동대문구,656, 영휘원 교차로,202005,890,859,1749,37.587238,127.043137
동대문구,656, 영휘원 교차로,202006,1003,975,1978,37.587238,127.043137
동대문구,657, 동대문롯데캐슬아파트 앞,201901,298,260,558,37.57576,127.04837
동대문구,657, 동대문롯데캐슬아파트 앞,201902,280,284,564,37.57576,127.04837
동대문구,657, 동대문롯데캐슬아파트 앞,201903,452,430,882,37.57576,127.04837
동대문구,657, 동대문롯데캐슬아파트 앞,201904,621,577,1198,37.57576,127.04837
동대문구,657, 동대문롯데캐슬아파트 앞,201905,1012,1056,2068,37.57576,127.04837
동대문구,657, 동대문롯데캐슬아파트 앞,201906,1183,1284,2467,37.57576,127.04837
동대문구,657, 동대문롯데캐슬아파트 앞,201907,1180,1391,2571,37.57576,127.04837
동대문구,657, 동대문롯데캐슬아파트 앞,201908,1143,1301,2444,37.57576,127.04837
동대문구,657, 동대문롯데캐슬아파트 앞,201909,1129,1216,2345,37.57576,127.04837
동대문구,657, 동대문롯데캐슬아파트 앞,201910,1387,1518,2905,37.57576,127.04837
동대문구,657, 동대문롯데캐슬아파트 앞,201911,950,1051,2001,37.57576,127.04837
동대문구,657, 동대문롯데캐슬아파트 앞,201912,682,773,1455,37.57576,127.04837
동대문구,657, 동대문롯데캐슬아파트 앞,202001,520,583,1103,37.57576,127.04837
동대문구,657, 동대문롯데캐슬아파트 앞,202002,481,547,1028,37.57576,127.04837
동대문구,657, 동대문롯데캐슬아파트 앞,202003,775,817,1592,37.57576,127.04837
동대문구,657, 동대문롯데캐슬아파트 앞,202004,1111,1186,2297,37.57576,127.04837
동대문구,657, 동대문롯데캐슬아파트 앞,202005,1268,1285,2553,37.57576,127.04837
동대문구,657, 동대문롯데캐슬아파트 앞,202006,1492,1586,3078,37.57576,127.04837
동대문구,658, 촬영소 사거리,201901,230,270,500,37.572948,127.066147
동대문구,658, 촬영소 사거리,201902,195,232,427,37.572948,127.066147
동대문구,658, 촬영소 사거리,201903,413,469,882,37.572948,127.066147
동대문구,658, 촬영소 사거리,201904,561,619,1180,37.572948,127.066147
동대문구,658, 촬영소 사거리,201905,931,1048,1979,37.572948,127.066147
동대문구,658, 촬영소 사거리,201906,1065,1199,2264,37.572948,127.066147
동대문구,658, 촬영소 사거리,201907,1049,1114,2163,37.572948,127.066147
동대문구,658, 촬영소 사거리,201908,975,1113,2088,37.572948,127.066147
동대문구,658, 촬영소 사거리,201909,961,1076,2037,37.572948,127.066147
동대문구,658, 촬영소 사거리,201910,1207,1331,2538,37.572948,127.066147
동대문구,658, 촬영소 사거리,201911,843,971,1814,37.572948,127.066147
동대문구,658, 촬영소 사거리,201912,497,556,1053,37.572948,127.066147
동대문구,658, 촬영소 사거리,202001,446,495,941,37.572948,127.066147
동대문구,658, 촬영소 사거리,202002,440,498,938,37.572948,127.066147
동대문구,658, 촬영소 사거리,202003,603,670,1273,37.572948,127.066147
동대문구,658, 촬영소 사거리,202004,1031,1082,2113,37.572948,127.066147
동대문구,658, 촬영소 사거리,202005,1300,1349,2649,37.572948,127.066147
동대문구,658, 촬영소 사거리,202006,1417,1498,2915,37.572948,127.066147
동대문구,659, 제기역1번출구,201901,378,369,747,37.57835,127.033386
동대문구,659, 제기역1번출구,201902,343,333,676,37.57835,127.033386
동대문구,659, 제기역1번출구,201903,611,594,1205,37.57835,127.033386
동대문구,659, 제기역1번출구,201904,881,786,1667,37.57835,127.033386
동대문구,659, 제기역1번출구,201905,1499,1412,2911,37.57835,127.033386
동대문구,659, 제기역1번출구,201906,1916,1790,3706,37.57835,127.033386
동대문구,659, 제기역1번출구,201907,1951,1849,3800,37.57835,127.033386
동대문구,659, 제기역1번출구,201908,772,655,1427,37.57835,127.033386
동대문구,659, 제기역1번출구,201909,1780,1691,3471,37.57835,127.033386
동대문구,659, 제기역1번출구,201910,2140,2048,4188,37.57835,127.033386
동대문구,659, 제기역1번출구,201911,1399,1351,2750,37.57835,127.033386
동대문구,659, 제기역1번출구,201912,976,883,1859,37.57835,127.033386
동대문구,659, 제기역1번출구,202001,856,786,1642,37.57835,127.033386
동대문구,659, 제기역1번출구,202002,882,833,1715,37.57835,127.033386
동대문구,659, 제기역1번출구,202003,1257,1118,2375,37.57835,127.033386
동대문구,659, 제기역1번출구,202004,1702,1628,3330,37.57835,127.033386
동대문구,659, 제기역1번출구,202005,1781,1732,3513,37.57835,127.033386
동대문구,659, 제기역1번출구,202006,2120,1990,4110,37.57835,127.033386
동대문구,660, 동의보감타워,201901,317,294,611,37.577999,127.037628
동대문구,660, 동의보감타워,201902,270,257,527,37.577999,127.037628
동대문구,660, 동의보감타워,201903,584,585,1169,37.577999,127.037628
동대문구,660, 동의보감타워,201904,908,880,1788,37.577999,127.037628
동대문구,660, 동의보감타워,201905,1537,1531,3068,37.577999,127.037628
동대문구,660, 동의보감타워,201906,1910,1893,3803,37.577999,127.037628
동대문구,660, 동의보감타워,201907,1875,1880,3755,37.577999,127.037628
동대문구,660, 동의보감타워,201908,1840,1879,3719,37.577999,127.037628
동대문구,660, 동의보감타워,201909,1523,1544,3067,37.577999,127.037628
동대문구,660, 동의보감타워,201910,1913,1927,3840,37.577999,127.037628
동대문구,660, 동의보감타워,201911,1296,1323,2619,37.577999,127.037628
동대문구,660, 동의보감타워,201912,797,798,1595,37.577999,127.037628
동대문구,660, 동의보감타워,202001,635,671,1306,37.577999,127.037628
동대문구,660, 동의보감타워,202002,652,659,1311,37.577999,127.037628
동대문구,660, 동의보감타워,202003,978,950,1928,37.577999,127.037628
동대문구,660, 동의보감타워,202004,1318,1322,2640,37.577999,127.037628
동대문구,660, 동의보감타워,202005,1460,1454,2914,37.577999,127.037628
동대문구,660, 동의보감타워,202006,1478,1470,2948,37.577999,127.037628
동대문구,661, 경희대학교 청운관,201901,240,206,446,37.594601,127.051964
동대문구,661, 경희대학교 청운관,201902,208,194,402,37.594601,127.051964
동대문구,661, 경희대학교 청운관,201903,670,707,1377,37.594601,127.051964
동대문구,661, 경희대학교 청운관,201904,1258,1335,2593,37.594601,127.051964
동대문구,661, 경희대학교 청운관,201905,1794,1841,3635,37.594601,127.051964
동대문구,661, 경희대학교 청운관,201906,1522,1558,3080,37.594601,127.051964
동대문구,661, 경희대학교 청운관,201907,1408,1381,2789,37.594601,127.051964
동대문구,661, 경희대학교 청운관,201908,1317,1285,2602,37.594601,127.051964
동대문구,661, 경희대학교 청운관,201909,1672,1698,3370,37.594601,127.051964
동대문구,661, 경희대학교 청운관,201910,1906,1956,3862,37.594601,127.051964
동대문구,661, 경희대학교 청운관,201911,1122,1116,2238,37.594601,127.051964
동대문구,661, 경희대학교 청운관,201912,505,494,999,37.594601,127.051964
동대문구,661, 경희대학교 청운관,202001,344,319,663,37.594601,127.051964
동대문구,661, 경희대학교 청운관,202002,375,366,741,37.594601,127.051964
동대문구,661, 경희대학교 청운관,202003,828,790,1618,37.594601,127.051964
동대문구,661, 경희대학교 청운관,202004,1179,1197,2376,37.594601,127.051964
동대문구,661, 경희대학교 청운관,202005,1412,1444,2856,37.594601,127.051964
동대문구,661, 경희대학교 청운관,202006,1364,1441,2805,37.594601,127.051964
동대문구,663, 외대앞역 4번출구,201901,143,142,285,37.594891,127.063026
동대문구,663, 외대앞역 4번출구,201902,144,160,304,37.594891,127.063026
동대문구,663, 외대앞역 4번출구,201903,386,385,771,37.594891,127.063026
동대문구,663, 외대앞역 4번출구,201904,719,752,1471,37.594891,127.063026
동대문구,663, 외대앞역 4번출구,201905,1347,1404,2751,37.594891,127.063026
동대문구,663, 외대앞역 4번출구,201906,1528,1622,3150,37.594891,127.063026
동대문구,663, 외대앞역 4번출구,201907,1636,1725,3361,37.594891,127.063026
동대문구,663, 외대앞역 4번출구,201908,1524,1593,3117,37.594891,127.063026
동대문구,663, 외대앞역 4번출구,201909,1731,1793,3524,37.594891,127.063026
동대문구,663, 외대앞역 4번출구,201910,2085,2129,4214,37.594891,127.063026
동대문구,663, 외대앞역 4번출구,201911,1266,1321,2587,37.594891,127.063026
동대문구,663, 외대앞역 4번출구,201912,686,760,1446,37.594891,127.063026
동대문구,663, 외대앞역 4번출구,202001,556,630,1186,37.594891,127.063026
동대문구,663, 외대앞역 4번출구,202002,535,586,1121,37.594891,127.063026
동대문구,663, 외대앞역 4번출구,202003,1134,1247,2381,37.594891,127.063026
동대문구,663, 외대앞역 4번출구,202004,1987,2163,4150,37.594891,127.063026
동대문구,663, 외대앞역 4번출구,202005,2810,2886,5696,37.594891,127.063026
동대문구,663, 외대앞역 4번출구,202006,2548,2635,5183,37.594891,127.063026
동대문구,664, 서울시립대 대학본부,201911,130,127,257,37.584129,127.057938
동대문구,664, 서울시립대 대학본부,201912,265,263,528,37.584129,127.057938
동대문구,664, 서울시립대 대학본부,202001,184,183,367,37.584129,127.057938
동대문구,664, 서울시립대 대학본부,202002,173,173,346,37.584129,127.057938
동대문구,664, 서울시립대 대학본부,202003,176,174,350,37.584129,127.057938
동대문구,664, 서울시립대 대학본부,202004,296,299,595,37.584129,127.057938
동대문구,664, 서울시립대 대학본부,202005,359,362,721,37.584129,127.057938
동대문구,664, 서울시립대 대학본부,202006,451,446,897,37.584129,127.057938
동대문구,665,이문동 쌍용아파트 정문,202004,0,1,1,37.599606,127.068642
동대문구,665,이문동 쌍용아파트 정문,202005,311,310,621,37.599606,127.068642
동대문구,665,이문동 쌍용아파트 정문,202006,858,894,1752,37.599606,127.068642
동대문구,666,이문대성유니드아파트 앞,202006,175,167,342,37.603622,127.070831
동대문구,667,청량차도 육교 밑,202004,1,1,2,37.586594,127.046997
동대문구,667,청량차도 육교 밑,202005,46,40,86,37.586594,127.046997
동대문구,667,청량차도 육교 밑,202006,307,225,532,37.586594,127.046997
동대문구,668,서울축산농협(장안지점),202004,2,2,4,37.568653,127.069183
동대문구,668,서울축산농협(장안지점),202005,356,358,714,37.568653,127.069183
동대문구,668,서울축산농협(장안지점),202006,1837,1856,3693,37.568653,127.069183
동대문구,669,청계신한신휴플러스앞 삼거리,202004,1,1,2,37.572048,127.044663
동대문구,669,청계신한신휴플러스앞 삼거리,202005,239,240,479,37.572048,127.044663
동대문구,669,청계한신휴플러스앞 삼거리,202006,897,897,1794,37.572048,127.044663
동대문구,670,삼육서울병원 버스정류장,202004,4,4,8,37.589687,127.061409
동대문구,670,삼육서울병원 버스정류장,202005,568,580,1148,37.589687,127.061409
동대문구,670,삼육서울병원 버스정류장,202006,2211,2204,4415,37.589687,127.061409
동대문구,671,대광빌딩,202004,1,1,2,37.577343,127.023377
동대문구,671,대광빌딩,202005,56,43,99,37.577343,127.023377
동대문구,671,대광빌딩,202006,158,152,310,37.577343,127.023377
동대문구,672,대광고등학교,202004,2,2,4,37.57859,127.02385
동대문구,672,대광고등학교,202005,63,53,116,37.57859,127.02385
동대문구,672,대광고등학교,202006,258,203,461,37.57859,127.02385
동대문구,673,안암골벽산아파트(후문),202004,2,2,4,37.58408,127.031036
동대문구,673,안암골벽산아파트(후문),202005,196,186,382,37.58408,127.031036
동대문구,673,안암골벽산아파트(후문),202006,756,750,1506,37.58408,127.031036
동대문구,674,고대앞사거리 교통섬,202004,2,2,4,37.586552,127.033142
동대문구,674,고대앞사거리 교통섬,202005,234,231,465,37.586552,127.033142
동대문구,674,고대앞사거리 교통섬,202006,855,822,1677,37.586552,127.033142
동대문구,675,성복교회 앞 (장평교 아래),202004,2,2,4,37.572025,127.077004
동대문구,675,성복교회 앞 (장평교 아래),202005,329,334,663,37.572025,127.077004
동대문구,675,성복교회 앞 (장평교 아래),202006,1190,1199,2389,37.572025,127.077004
동대문구,676,FITI시험연구원 앞,202004,1,1,2,37.581432,127.035477
동대문구,676,FITI시험연구원 앞,202005,118,109,227,37.581432,127.035477
동대문구,676,FITI시험연구원 앞,202006,497,455,952,37.581432,127.035477
동대문구,677,청량리역 4번 5번출구 사이,202004,1,1,2,37.580151,127.045799
동대문구,677,청량리역 4번 5번출구 사이,202005,215,203,418,37.580151,127.045799
동대문구,677,청량리역 4번 5번출구 사이,202006,954,927,1881,37.580151,127.045799
동대문구,678,장안힐스테이트(아) 앞,202004,2,2,4,37.576557,127.07431
동대문구,678,장안힐스테이트(아) 앞,202005,213,217,430,37.576557,127.07431
동대문구,678,장안힐스테이트(아) 앞,202006,909,924,1833,37.576557,127.07431
동대문구,679,전농SK아파트 앞,202004,1,1,2,37.577877,127.061684
동대문구,679,전농SK아파트 앞,202005,54,56,110,37.577877,127.061684
동대문구,679,전농SK아파트 앞,202006,293,297,590,37.577877,127.061684
동대문구,680,꿈마루어린이도서관 앞,202004,4,4,8,37.592384,127.057411
동대문구,680,꿈마루어린이도서관 앞,202005,1,1,2,37.592384,127.057411
동대문구,680,꿈마루어린이도서관 앞,202006,1211,1206,2417,37.592384,127.057411
동대문구,681,서울특별시 동부교육지원청(육교),202004,1,1,2,37.579838,127.056374
동대문구,681,서울특별시 동부교육지원청(육교),202005,19,19,38,37.579838,127.056374
동대문구,681,서울특별시 동부교육지원청(육교),202006,99,101,200,37.579838,127.056374
양천구,700, KB국민은행 염창역 지점 앞,201901,357,301,658,37.546848,126.872772
양천구,700, KB국민은행 염창역 지점 앞,201902,342,274,616,37.546848,126.872772
양천구,700, KB국민은행 염창역 지점 앞,201903,680,621,1301,37.546848,126.872772
양천구,700, KB국민은행 염창역 지점 앞,201904,1225,1288,2513,37.546848,126.872772
양천구,700, KB국민은행 염창역 지점 앞,201905,2205,2254,4459,37.546848,126.872772
양천구,700, KB국민은행 염창역 지점 앞,201906,2438,2548,4986,37.546848,126.872772
양천구,700, KB국민은행 염창역 지점 앞,201907,2408,2371,4779,37.546848,126.872772
양천구,700, KB국민은행 염창역 지점 앞,201908,2322,2313,4635,37.546848,126.872772
양천구,700, KB국민은행 염창역 지점 앞,201909,2371,2355,4726,37.546848,126.872772
양천구,700, KB국민은행 염창역 지점 앞,201910,2655,2617,5272,37.546848,126.872772
양천구,700, KB국민은행 염창역 지점 앞,201911,1448,1382,2830,37.546848,126.872772
양천구,700, KB국민은행 염창역 지점 앞,201912,769,698,1467,37.546848,126.872772
양천구,700, KB국민은행 염창역 지점 앞,202001,669,640,1309,37.546848,126.872772
양천구,700, KB국민은행 염창역 지점 앞,202002,664,647,1311,37.546848,126.872772
양천구,700, KB국민은행 염창역 지점 앞,202003,1788,1721,3509,37.546848,126.872772
양천구,700, KB국민은행 염창역 지점 앞,202004,2610,2497,5107,37.546848,126.872772
양천구,700, KB국민은행 염창역 지점 앞,202005,3104,2976,6080,37.546848,126.872772
양천구,700, KB국민은행 염창역 지점 앞,202006,2791,2755,5546,37.546848,126.872772
양천구,701, 목동사거리 부근,201901,224,227,451,37.532803,126.86393
양천구,701, 목동사거리 부근,201902,181,212,393,37.532803,126.86393
양천구,701, 목동사거리 부근,201903,331,385,716,37.532803,126.86393
양천구,701, 목동사거리 부근,201904,567,659,1226,37.532803,126.86393
양천구,701, 목동사거리 부근,201905,833,975,1808,37.532803,126.86393
양천구,701, 목동사거리 부근,201906,974,1195,2169,37.532803,126.86393
양천구,701, 목동사거리 부근,201907,1000,1039,2039,37.532803,126.86393
양천구,701, 목동사거리 부근,201908,865,1000,1865,37.532803,126.86393
양천구,701, 목동사거리 부근,201909,937,998,1935,37.532803,126.86393
양천구,701, 목동사거리 부근,201910,1061,1144,2205,37.532803,126.86393
양천구,701, 목동사거리 부근,201911,702,735,1437,37.532803,126.86393
양천구,701, 목동사거리 부근,201912,347,366,713,37.532803,126.86393
양천구,701, 목동사거리 부근,202001,327,336,663,37.532803,126.86393
양천구,701, 목동사거리 부근,202002,301,320,621,37.532803,126.86393
양천구,701, 목동사거리 부근,202003,528,550,1078,37.532803,126.86393
양천구,701, 목동사거리 부근,202004,784,815,1599,37.532803,126.86393
양천구,701, 목동사거리 부근,202005,1155,1182,2337,37.532803,126.86393
양천구,701, 목동사거리 부근,202006,1216,1341,2557,37.532803,126.86393
양천구,702, 목4동주민센터 옆,201901,262,266,528,37.532543,126.868729
양천구,702, 목4동주민센터 옆,201902,271,254,525,37.532543,126.868729
양천구,702, 목4동주민센터 옆,201903,421,406,827,37.532543,126.868729
양천구,702, 목4동주민센터 옆,201904,542,473,1015,37.532543,126.868729
양천구,702, 목4동주민센터 옆,201905,839,814,1653,37.532543,126.868729
양천구,702, 목4동주민센터 옆,201906,1017,990,2007,37.532543,126.868729
양천구,702, 목4동주민센터 옆,201907,1062,1087,2149,37.532543,126.868729
양천구,702, 목4동주민센터 옆,201908,1082,1083,2165,37.532543,126.868729
양천구,702, 목4동주민센터 옆,201909,909,875,1784,37.532543,126.868729
양천구,702, 목4동주민센터 옆,201910,1055,1012,2067,37.532543,126.868729
양천구,702, 목4동주민센터 옆,201911,761,734,1495,37.532543,126.868729
양천구,702, 목4동주민센터 옆,201912,558,500,1058,37.532543,126.868729
양천구,702, 목4동주민센터 옆,202001,511,421,932,37.532543,126.868729
양천구,702, 목4동주민센터 옆,202002,533,442,975,37.532543,126.868729
양천구,702, 목4동주민센터 옆,202003,707,555,1262,37.532543,126.868729
양천구,702, 목4동주민센터 옆,202004,1052,879,1931,37.532543,126.868729
양천구,702, 목4동주민센터 옆,202005,1207,1077,2284,37.532543,126.868729
양천구,702, 목4동주민센터 옆,202006,1542,1448,2990,37.532543,126.868729
양천구,703, 오목교역 7번출구 앞,201901,983,1102,2085,37.524063,126.87558
양천구,703, 오목교역 7번출구 앞,201902,902,984,1886,37.524063,126.87558
양천구,703, 오목교역 7번출구 앞,201903,1484,1667,3151,37.524063,126.87558
양천구,703, 오목교역 7번출구 앞,201904,2899,2975,5874,37.524063,126.87558
양천구,703, 오목교역 7번출구 앞,201905,4347,4410,8757,37.524063,126.87558
양천구,703, 오목교역 7번출구 앞,201906,4825,4936,9761,37.524063,126.87558
양천구,703, 오목교역 7번출구 앞,201907,3602,3653,7255,37.524063,126.87558
양천구,703, 오목교역 7번출구 앞,201908,3313,3342,6655,37.524063,126.87558
양천구,703, 오목교역 7번출구 앞,201909,3115,3193,6308,37.524063,126.87558
양천구,703, 오목교역 7번출구 앞,201910,3554,3609,7163,37.524063,126.87558
양천구,703, 오목교역 7번출구 앞,201911,2239,2305,4544,37.524063,126.87558
양천구,703, 오목교역 7번출구 앞,201912,1308,1397,2705,37.524063,126.87558
양천구,703, 오목교역 7번출구 앞,202001,1133,1220,2353,37.524063,126.87558
양천구,703, 오목교역 7번출구 앞,202002,1226,1248,2474,37.524063,126.87558
양천구,703, 오목교역 7번출구 앞,202003,2484,2554,5038,37.524063,126.87558
양천구,703, 오목교역 7번출구 앞,202004,3649,3691,7340,37.524063,126.87558
양천구,703, 오목교역 7번출구 앞,202005,4414,4488,8902,37.524063,126.87558
양천구,703, 오목교역 7번출구 앞,202006,4617,4944,9561,37.524063,126.87558
양천구,704, 남부법원검찰청 교차로,201901,648,719,1367,37.523254,126.864906
양천구,704, 남부법원검찰청 교차로,201902,647,681,1328,37.523254,126.864906
양천구,704, 남부법원검찰청 교차로,201903,1163,1234,2397,37.523254,126.864906
양천구,704, 남부법원검찰청 교차로,201904,1811,1909,3720,37.523254,126.864906
양천구,704, 남부법원검찰청 교차로,201905,3102,3116,6218,37.523254,126.864906
양천구,704, 남부법원검찰청 교차로,201906,3305,3408,6713,37.523254,126.864906
양천구,704, 남부법원검찰청 교차로,201907,3015,3196,6211,37.523254,126.864906
양천구,704, 남부법원검찰청 교차로,201908,2981,3056,6037,37.523254,126.864906
양천구,704, 남부법원검찰청 교차로,201909,3081,3186,6267,37.523254,126.864906
양천구,704, 남부법원검찰청 교차로,201910,3626,3779,7405,37.523254,126.864906
양천구,704, 남부법원검찰청 교차로,201911,2268,2391,4659,37.523254,126.864906
양천구,704, 남부법원검찰청 교차로,201912,1151,1256,2407,37.523254,126.864906
양천구,704, 남부법원검찰청 교차로,202001,1154,1238,2392,37.523254,126.864906
양천구,704, 남부법원검찰청 교차로,202002,1081,1220,2301,37.523254,126.864906
양천구,704, 남부법원검찰청 교차로,202003,2052,2186,4238,37.523254,126.864906
양천구,704, 남부법원검찰청 교차로,202004,3581,3659,7240,37.523254,126.864906
양천구,704, 남부법원검찰청 교차로,202005,4457,4504,8961,37.523254,126.864906
양천구,704, 남부법원검찰청 교차로,202006,4520,4523,9043,37.523254,126.864906
양천구,706, 신정네거리역,201901,203,315,518,37.521881,126.851753
양천구,706, 신정네거리역,201902,215,312,527,37.521881,126.851753
양천구,706, 신정네거리역,201903,409,533,942,37.521881,126.851753
양천구,706, 신정네거리역,201904,653,768,1421,37.521881,126.851753
양천구,706, 신정네거리역,201905,1044,1298,2342,37.521881,126.851753
양천구,706, 신정네거리역,201906,1468,1581,3049,37.521881,126.851753
양천구,706, 신정네거리역,201907,1322,1488,2810,37.521881,126.851753
양천구,706, 신정네거리역,201908,1305,1476,2781,37.521881,126.851753
양천구,706, 신정네거리역,201909,1362,1420,2782,37.521881,126.851753
양천구,706, 신정네거리역,201910,1813,1853,3666,37.521881,126.851753
양천구,706, 신정네거리역,201911,999,1099,2098,37.521881,126.851753
양천구,706, 신정네거리역,201912,597,604,1201,37.521881,126.851753
양천구,706, 신정네거리역,202001,559,645,1204,37.521881,126.851753
양천구,706, 신정네거리역,202002,578,620,1198,37.521881,126.851753
양천구,706, 신정네거리역,202003,1006,1048,2054,37.521881,126.851753
양천구,706, 신정네거리역,202004,1609,1621,3230,37.521881,126.851753
양천구,706, 신정네거리역,202005,1904,1946,3850,37.521881,126.851753
양천구,706, 신정네거리역,202006,1879,1897,3776,37.521881,126.851753
양천구,707, 신정3동주민센터,201901,102,65,167,37.515156,126.854897
양천구,707, 신정3동주민센터,201902,114,80,194,37.515156,126.854897
양천구,707, 신정3동주민센터,201903,216,148,364,37.515156,126.854897
양천구,707, 신정3동주민센터,201904,280,197,477,37.515156,126.854897
양천구,707, 신정3동주민센터,201905,439,276,715,37.515156,126.854897
양천구,707, 신정3동주민센터,201906,527,343,870,37.515156,126.854897
양천구,707, 신정3동주민센터,201907,449,306,755,37.515156,126.854897
양천구,707, 신정3동주민센터,201908,514,325,839,37.515156,126.854897
양천구,707, 신정3동주민센터,201909,411,327,738,37.515156,126.854897
양천구,707, 신정3동주민센터,201910,540,409,949,37.515156,126.854897
양천구,707, 신정3동주민센터,201911,369,254,623,37.515156,126.854897
양천구,707, 신정3동주민센터,201912,257,147,404,37.515156,126.854897
양천구,707, 신정3동주민센터,202001,257,129,386,37.515156,126.854897
양천구,707, 신정3동주민센터,202002,247,134,381,37.515156,126.854897
양천구,707, 신정3동주민센터,202003,428,292,720,37.515156,126.854897
양천구,707, 신정3동주민센터,202004,583,356,939,37.515156,126.854897
양천구,707, 신정3동주민센터,202005,703,484,1187,37.515156,126.854897
양천구,707, 신정3동주민센터,202006,740,468,1208,37.515156,126.854897
양천구,708, 서울출입국관리사무소 앞,201901,502,574,1076,37.51897,126.869965
양천구,708, 서울출입국관리사무소 앞,201902,493,540,1033,37.51897,126.869965
양천구,708, 서울출입국관리사무소 앞,201903,832,946,1778,37.51897,126.869965
양천구,708, 서울출입국관리사무소 앞,201904,1369,1558,2927,37.51897,126.869965
양천구,708, 서울출입국관리사무소 앞,201905,2298,2515,4813,37.51897,126.869965
양천구,708, 서울출입국관리사무소 앞,201906,2813,3059,5872,37.51897,126.869965
양천구,708, 서울출입국관리사무소 앞,201907,2685,2857,5542,37.51897,126.869965
양천구,708, 서울출입국관리사무소 앞,201908,2528,2760,5288,37.51897,126.869965
양천구,708, 서울출입국관리사무소 앞,201909,2689,2845,5534,37.51897,126.869965
양천구,708, 서울출입국관리사무소 앞,201910,3138,3336,6474,37.51897,126.869965
양천구,708, 서울출입국관리사무소 앞,201911,1941,2170,4111,37.51897,126.869965
양천구,708, 서울출입국관리사무소 앞,201912,1171,1232,2403,37.51897,126.869965
양천구,708, 서울출입국관리사무소 앞,202001,1059,1069,2128,37.51897,126.869965
양천구,708, 서울출입국관리사무소 앞,202002,1025,1106,2131,37.51897,126.869965
양천구,708, 서울출입국관리사무소 앞,202003,2016,2029,4045,37.51897,126.869965
양천구,708, 서울출입국관리사무소 앞,202004,3034,3105,6139,37.51897,126.869965
양천구,708, 서울출입국관리사무소 앞,202005,3787,3930,7717,37.51897,126.869965
양천구,708, 서울출입국관리사무소 앞,202006,3776,4001,7777,37.51897,126.869965
양천구,709, 신정3동 현장민원실 앞,201901,94,87,181,37.511585,126.84156
양천구,709, 신정3동 현장민원실 앞,201902,86,83,169,37.511585,126.84156
양천구,709, 신정3동 현장민원실 앞,201903,172,197,369,37.511585,126.84156
양천구,709, 신정3동 현장민원실 앞,201904,260,256,516,37.511585,126.84156
양천구,709, 신정3동 현장민원실 앞,201905,342,285,627,37.511585,126.84156
양천구,709, 신정3동 현장민원실 앞,201906,450,384,834,37.511585,126.84156
양천구,709, 신정3동 현장민원실 앞,201907,509,373,882,37.511585,126.84156
양천구,709, 신정3동 현장민원실 앞,201908,505,323,828,37.511585,126.84156
양천구,709, 신정3동 현장민원실 앞,201909,287,298,585,37.511585,126.84156
양천구,709, 신정3동 현장민원실 앞,201910,443,385,828,37.511585,126.84156
양천구,709, 신정3동 현장민원실 앞,201911,408,326,734,37.511585,126.84156
양천구,709, 신정3동 현장민원실 앞,201912,290,207,497,37.511585,126.84156
양천구,709, 신정3동 현장민원실 앞,202001,307,241,548,37.511585,126.84156
양천구,709, 신정3동 현장민원실 앞,202002,273,196,469,37.511585,126.84156
양천구,709, 신정3동 현장민원실 앞,202003,395,309,704,37.511585,126.84156
양천구,709, 신정3동 현장민원실 앞,202004,712,570,1282,37.511585,126.84156
양천구,709, 신정3동 현장민원실 앞,202005,1010,908,1918,37.511585,126.84156
양천구,709, 신정3동 현장민원실 앞,202006,1081,957,2038,37.511585,126.84156
양천구,710, 서부화물트럭터미널 사거리,201901,90,70,160,#N/A,#N/A
양천구,710, 서부화물트럭터미널 사거리,201902,61,49,110,#N/A,#N/A
양천구,710, 서부화물트럭터미널 사거리,201903,152,167,319,#N/A,#N/A
양천구,710, 서부화물트럭터미널 사거리,201904,286,248,534,#N/A,#N/A
양천구,710, 서부화물트럭터미널 사거리,201905,492,464,956,#N/A,#N/A
양천구,710, 서부화물트럭터미널 사거리,201906,547,546,1093,#N/A,#N/A
양천구,710, 서부화물트럭터미널 사거리,201907,652,648,1300,#N/A,#N/A
양천구,710, 서부화물트럭터미널 사거리,201908,662,640,1302,#N/A,#N/A
양천구,710, 서부화물트럭터미널 사거리,201909,538,534,1072,#N/A,#N/A
양천구,710, 서부화물트럭터미널 사거리,201910,610,585,1195,#N/A,#N/A
양천구,710, 서부화물트럭터미널 사거리,201911,405,389,794,#N/A,#N/A
양천구,710, 서부화물트럭터미널 사거리,201912,202,205,407,#N/A,#N/A
양천구,710, 서부화물트럭터미널 사거리,202001,217,194,411,#N/A,#N/A
양천구,710, 서부화물트럭터미널 사거리,202002,233,245,478,#N/A,#N/A
양천구,710, 서부화물트럭터미널 사거리,202003,327,316,643,#N/A,#N/A
양천구,710, 서부화물트럭터미널 사거리,202004,468,466,934,#N/A,#N/A
양천구,710, 서부화물트럭터미널 사거리,202005,28,30,58,#N/A,#N/A
양천구,710, 서부화물트럭터미널 사거리,202006,22,36,58,#N/A,#N/A
양천구,711, 신일해피트리아파트 앞,201901,156,36,192,37.517059,126.848488
양천구,711, 신일해피트리아파트 앞,201902,89,37,126,37.517059,126.848488
양천구,711, 신일해피트리아파트 앞,201903,208,54,262,37.517059,126.848488
양천구,711, 신일해피트리아파트 앞,201904,279,108,387,37.517059,126.848488
양천구,711, 신일해피트리아파트 앞,201905,458,205,663,37.517059,126.848488
양천구,711, 신일해피트리아파트 앞,201906,564,245,809,37.517059,126.848488
양천구,711, 신일해피트리아파트 앞,201907,523,201,724,37.517059,126.848488
양천구,711, 신일해피트리아파트 앞,201908,518,197,715,37.517059,126.848488
양천구,711, 신일해피트리아파트 앞,201909,545,205,750,37.517059,126.848488
양천구,711, 신일해피트리아파트 앞,201910,669,206,875,37.517059,126.848488
양천구,711, 신일해피트리아파트 앞,201911,426,102,528,37.517059,126.848488
양천구,711, 신일해피트리아파트 앞,201912,209,42,251,37.517059,126.848488
양천구,711, 신일해피트리아파트 앞,202001,229,52,281,37.517059,126.848488
양천구,711, 신일해피트리아파트 앞,202002,162,45,207,37.517059,126.848488
양천구,711, 신일해피트리아파트 앞,202003,366,103,469,37.517059,126.848488
양천구,711, 신일해피트리아파트 앞,202004,529,180,709,37.517059,126.848488
양천구,711, 신일해피트리아파트 앞,202005,650,272,922,37.517059,126.848488
양천구,711, 신일해피트리아파트 앞,202006,824,372,1196,37.517059,126.848488
양천구,712, 강월초교입구 사거리,201901,186,234,420,37.516998,126.838318
양천구,712, 강월초교입구 사거리,201902,177,230,407,37.516998,126.838318
양천구,712, 강월초교입구 사거리,201903,286,399,685,37.516998,126.838318
양천구,712, 강월초교입구 사거리,201904,341,459,800,37.516998,126.838318
양천구,712, 강월초교입구 사거리,201905,672,880,1552,37.516998,126.838318
양천구,712, 강월초교입구 사거리,201906,778,1110,1888,37.516998,126.838318
양천구,712, 강월초교입구 사거리,201907,811,1103,1914,37.516998,126.838318
양천구,712, 강월초교입구 사거리,201908,828,1095,1923,37.516998,126.838318
양천구,712, 강월초교입구 사거리,201909,791,977,1768,37.516998,126.838318
양천구,712, 강월초교입구 사거리,201910,1026,1230,2256,37.516998,126.838318
양천구,712, 강월초교입구 사거리,201911,606,754,1360,37.516998,126.838318
양천구,712, 강월초교입구 사거리,201912,378,480,858,37.516998,126.838318
양천구,712, 강월초교입구 사거리,202001,334,413,747,37.516998,126.838318
양천구,712, 강월초교입구 사거리,202002,265,370,635,37.516998,126.838318
양천구,712, 강월초교입구 사거리,202003,556,662,1218,37.516998,126.838318
양천구,712, 강월초교입구 사거리,202004,900,1080,1980,37.516998,126.838318
양천구,712, 강월초교입구 사거리,202005,1144,1440,2584,37.516998,126.838318
양천구,712, 강월초교입구 사거리,202006,1203,1749,2952,37.516998,126.838318
양천구,713, 양서중학교 옆,201901,153,129,282,37.533047,126.829956
양천구,713, 양서중학교 옆,201902,129,84,213,37.533047,126.829956
양천구,713, 양서중학교 옆,201903,244,136,380,37.533047,126.829956
양천구,713, 양서중학교 옆,201904,350,285,635,37.533047,126.829956
양천구,713, 양서중학교 옆,201905,539,524,1063,37.533047,126.829956
양천구,713, 양서중학교 옆,201906,541,535,1076,37.533047,126.829956
양천구,713, 양서중학교 옆,201907,675,608,1283,37.533047,126.829956
양천구,713, 양서중학교 옆,201908,542,454,996,37.533047,126.829956
양천구,713, 양서중학교 옆,201909,529,478,1007,37.533047,126.829956
양천구,713, 양서중학교 옆,201910,553,517,1070,37.533047,126.829956
양천구,713, 양서중학교 옆,201911,401,376,777,37.533047,126.829956
양천구,713, 양서중학교 옆,201912,261,235,496,37.533047,126.829956
양천구,713, 양서중학교 옆,202001,256,204,460,37.533047,126.829956
양천구,713, 양서중학교 옆,202002,250,202,452,37.533047,126.829956
양천구,713, 양서중학교 옆,202003,451,370,821,37.533047,126.829956
양천구,713, 양서중학교 옆,202004,910,820,1730,37.533047,126.829956
양천구,713, 양서중학교 옆,202005,1028,965,1993,37.533047,126.829956
양천구,713, 양서중학교 옆,202006,843,760,1603,37.533047,126.829956
양천구,714, 한국SGI 양천문화회관 앞,201901,184,167,351,37.532547,126.830803
양천구,714, 한국SGI 양천문화회관 앞,201902,144,146,290,37.532547,126.830803
양천구,714, 한국SGI 양천문화회관 앞,201903,265,258,523,37.532547,126.830803
양천구,714, 한국SGI 양천문화회관 앞,201904,395,429,824,37.532547,126.830803
양천구,714, 한국SGI 양천문화회관 앞,201905,665,707,1372,37.532547,126.830803
양천구,714, 한국SGI 양천문화회관 앞,201906,730,766,1496,37.532547,126.830803
양천구,714, 한국SGI 양천문화회관 앞,201907,557,598,1155,37.532547,126.830803
양천구,714, 한국SGI 양천문화회관 앞,201908,668,675,1343,37.532547,126.830803
양천구,714, 한국SGI 양천문화회관 앞,201909,749,720,1469,37.532547,126.830803
양천구,714, 한국SGI 양천문화회관 앞,201910,821,782,1603,37.532547,126.830803
양천구,714, 한국SGI 양천문화회관 앞,201911,464,454,918,37.532547,126.830803
양천구,714, 한국SGI 양천문화회관 앞,201912,313,291,604,37.532547,126.830803
양천구,714, 한국SGI 양천문화회관 앞,202001,253,252,505,37.532547,126.830803
양천구,714, 한국SGI 양천문화회관 앞,202002,278,261,539,37.532547,126.830803
양천구,714, 한국SGI 양천문화회관 앞,202003,469,434,903,37.532547,126.830803
양천구,714, 한국SGI 양천문화회관 앞,202004,858,798,1656,37.532547,126.830803
양천구,714, 한국SGI 양천문화회관 앞,202005,910,931,1841,37.532547,126.830803
양천구,714, 한국SGI 양천문화회관 앞,202006,991,948,1939,37.532547,126.830803
양천구,716,신정6동 주민센터 인근,201901,680,690,1370,37.517281,126.864334
양천구,716,신정6동 주민센터 인근,201902,524,526,1050,37.517281,126.864334
양천구,716,신정6동 주민센터 인근,201903,1037,1097,2134,37.517281,126.864334
양천구,716,신정6동 주민센터 인근,201904,1591,1696,3287,37.517281,126.864334
양천구,716,신정6동 주민센터 인근,201905,2187,2384,4571,37.517281,126.864334
양천구,716,신정6동 주민센터 인근,201906,2555,2688,5243,37.517281,126.864334
양천구,716,신정6동 주민센터 인근,201907,2516,2655,5171,37.517281,126.864334
양천구,716,신정6동 주민센터 인근,201908,2387,2513,4900,37.517281,126.864334
양천구,716,신정6동 주민센터 인근,201909,2314,2405,4719,37.517281,126.864334
양천구,716,신정6동 주민센터 인근,201910,2989,3143,6132,37.517281,126.864334
양천구,716,신정6동 주민센터 인근,201911,1898,1996,3894,37.517281,126.864334
양천구,716,신정6동 주민센터 인근,201912,1086,1117,2203,37.517281,126.864334
양천구,716,신정6동 주민센터 인근,202001,1077,1130,2207,37.517281,126.864334
양천구,716,신정6동 주민센터 인근,202002,1069,1146,2215,37.517281,126.864334
양천구,716,신정6동 주민센터 인근,202003,1853,1914,3767,37.517281,126.864334
양천구,716,신정6동 주민센터 인근,202004,2552,2680,5232,37.517281,126.864334
양천구,716,신정6동 주민센터 인근,202005,2731,2858,5589,37.517281,126.864334
양천구,716,신정6동 주민센터 인근,202006,2656,2780,5436,37.517281,126.864334
양천구,719, 홍익병원앞 교차로,201901,395,419,814,37.530369,126.864258
양천구,719, 홍익병원앞 교차로,201902,337,414,751,37.530369,126.864258
양천구,719, 홍익병원앞 교차로,201903,634,706,1340,37.530369,126.864258
양천구,719, 홍익병원앞 교차로,201904,887,992,1879,37.530369,126.864258
양천구,719, 홍익병원앞 교차로,201905,1323,1423,2746,37.530369,126.864258
양천구,719, 홍익병원앞 교차로,201906,1682,1751,3433,37.530369,126.864258
양천구,719, 홍익병원앞 교차로,201907,1617,1682,3299,37.530369,126.864258
양천구,719, 홍익병원앞 교차로,201908,1499,1528,3027,37.530369,126.864258
양천구,719, 홍익병원앞 교차로,201909,1328,1389,2717,37.530369,126.864258
양천구,719, 홍익병원앞 교차로,201910,1575,1635,3210,37.530369,126.864258
양천구,719, 홍익병원앞 교차로,201911,934,995,1929,37.530369,126.864258
양천구,719, 홍익병원앞 교차로,201912,606,608,1214,37.530369,126.864258
양천구,719, 홍익병원앞 교차로,202001,541,590,1131,37.530369,126.864258
양천구,719, 홍익병원앞 교차로,202002,514,539,1053,37.530369,126.864258
양천구,719, 홍익병원앞 교차로,202003,849,844,1693,37.530369,126.864258
양천구,719, 홍익병원앞 교차로,202004,1387,1316,2703,37.530369,126.864258
양천구,719, 홍익병원앞 교차로,202005,1710,1648,3358,37.530369,126.864258
양천구,719, 홍익병원앞 교차로,202006,1783,1787,3570,37.530369,126.864258
양천구,720, 서울강월초등학교 앞,201901,124,47,171,37.516197,126.8349
양천구,720, 서울강월초등학교 앞,201902,91,42,133,37.516197,126.8349
양천구,720, 서울강월초등학교 앞,201903,191,58,249,37.516197,126.8349
양천구,720, 서울강월초등학교 앞,201904,255,100,355,37.516197,126.8349
양천구,720, 서울강월초등학교 앞,201905,471,216,687,37.516197,126.8349
양천구,720, 서울강월초등학교 앞,201906,434,254,688,37.516197,126.8349
양천구,720, 서울강월초등학교 앞,201907,420,208,628,37.516197,126.8349
양천구,720, 서울강월초등학교 앞,201908,396,198,594,37.516197,126.8349
양천구,720, 서울강월초등학교 앞,201909,416,195,611,37.516197,126.8349
양천구,720, 서울강월초등학교 앞,201910,440,191,631,37.516197,126.8349
양천구,720, 서울강월초등학교 앞,201911,262,100,362,37.516197,126.8349
양천구,720, 서울강월초등학교 앞,201912,186,46,232,37.516197,126.8349
양천구,720, 서울강월초등학교 앞,202001,172,47,219,37.516197,126.8349
양천구,720, 서울강월초등학교 앞,202002,173,56,229,37.516197,126.8349
양천구,720, 서울강월초등학교 앞,202003,313,117,430,37.516197,126.8349
양천구,720, 서울강월초등학교 앞,202004,454,209,663,37.516197,126.8349
양천구,720, 서울강월초등학교 앞,202005,453,221,674,37.516197,126.8349
양천구,720, 서울강월초등학교 앞,202006,579,270,849,37.516197,126.8349
양천구,722, LG전자베스트샵 신정점,201901,301,361,662,37.521435,126.857384
양천구,722, LG전자베스트샵 신정점,201902,277,308,585,37.521435,126.857384
양천구,722, LG전자베스트샵 신정점,201903,557,669,1226,37.521435,126.857384
양천구,722, LG전자베스트샵 신정점,201904,933,1089,2022,37.521435,126.857384
양천구,722, LG전자베스트샵 신정점,201905,1436,1661,3097,37.521435,126.857384
양천구,722, LG전자베스트샵 신정점,201906,1729,1939,3668,37.521435,126.857384
양천구,722, LG전자베스트샵 신정점,201907,1601,1837,3438,37.521435,126.857384
양천구,722, LG전자베스트샵 신정점,201908,1636,1836,3472,37.521435,126.857384
양천구,722, LG전자베스트샵 신정점,201909,1646,1768,3414,37.521435,126.857384
양천구,722, LG전자베스트샵 신정점,201910,1988,2105,4093,37.521435,126.857384
양천구,722, LG전자베스트샵 신정점,201911,1169,1403,2572,37.521435,126.857384
양천구,722, LG전자베스트샵 신정점,201912,659,731,1390,37.521435,126.857384
양천구,722, LG전자베스트샵 신정점,202001,573,595,1168,37.521435,126.857384
양천구,722, LG전자베스트샵 신정점,202002,585,612,1197,37.521435,126.857384
양천구,722, LG전자베스트샵 신정점,202003,1219,1321,2540,37.521435,126.857384
양천구,722, LG전자베스트샵 신정점,202004,1965,2099,4064,37.521435,126.857384
양천구,722, LG전자베스트샵 신정점,202005,2422,2561,4983,37.521435,126.857384
양천구,722, LG전자베스트샵 신정점,202006,2725,3073,5798,37.521435,126.857384
양천구,723, SBS방송국,201901,808,985,1793,37.529163,126.872749
양천구,723, SBS방송국,201902,680,794,1474,37.529163,126.872749
양천구,723, SBS방송국,201903,1262,1374,2636,37.529163,126.872749
양천구,723, SBS방송국,201904,1848,1962,3810,37.529163,126.872749
양천구,723, SBS방송국,201905,2789,2736,5525,37.529163,126.872749
양천구,723, SBS방송국,201906,3204,3194,6398,37.529163,126.872749
양천구,723, SBS방송국,201907,2768,2833,5601,37.529163,126.872749
양천구,723, SBS방송국,201908,2687,2722,5409,37.529163,126.872749
양천구,723, SBS방송국,201909,2544,2682,5226,37.529163,126.872749
양천구,723, SBS방송국,201910,3203,3357,6560,37.529163,126.872749
양천구,723, SBS방송국,201911,2100,2383,4483,37.529163,126.872749
양천구,723, SBS방송국,201912,1222,1495,2717,37.529163,126.872749
양천구,723, SBS방송국,202001,1115,1357,2472,37.529163,126.872749
양천구,723, SBS방송국,202002,1108,1417,2525,37.529163,126.872749
양천구,723, SBS방송국,202003,1872,2233,4105,37.529163,126.872749
양천구,723, SBS방송국,202004,2649,2904,5553,37.529163,126.872749
양천구,723, SBS방송국,202005,3246,3591,6837,37.529163,126.872749
양천구,723, SBS방송국,202006,3041,3591,6632,37.529163,126.872749
양천구,724, 계남공원 입구 주출입구 좌측,201901,53,13,66,37.510681,126.857399
양천구,724, 계남공원 입구 주출입구 좌측,201902,27,16,43,37.510681,126.857399
양천구,724, 계남공원 입구 주출입구 좌측,201903,71,43,114,37.510681,126.857399
양천구,724, 계남공원 입구 주출입구 좌측,201904,91,53,144,37.510681,126.857399
양천구,724, 계남공원 입구 주출입구 좌측,201905,175,89,264,37.510681,126.857399
양천구,724, 계남공원 입구 주출입구 좌측,201906,186,125,311,37.510681,126.857399
양천구,724, 계남공원 입구 주출입구 좌측,201907,200,149,349,37.510681,126.857399
양천구,724, 계남공원 입구 주출입구 좌측,201908,190,126,316,37.510681,126.857399
양천구,724, 계남공원 입구 주출입구 좌측,201909,164,115,279,37.510681,126.857399
양천구,724, 계남공원 입구 주출입구 좌측,201910,201,112,313,37.510681,126.857399
양천구,724, 계남공원 입구 주출입구 좌측,201911,150,98,248,37.510681,126.857399
양천구,724, 계남공원 입구 주출입구 좌측,201912,117,93,210,37.510681,126.857399
양천구,724, 계남공원 입구 주출입구 좌측,202001,96,35,131,37.510681,126.857399
양천구,724, 계남공원 입구 주출입구 좌측,202002,96,34,130,37.510681,126.857399
양천구,724, 계남공원 입구 주출입구 좌측,202003,160,68,228,37.510681,126.857399
양천구,724, 계남공원 입구 주출입구 좌측,202004,258,144,402,37.510681,126.857399
양천구,724, 계남공원 입구 주출입구 좌측,202005,291,152,443,37.510681,126.857399
양천구,724, 계남공원 입구 주출입구 좌측,202006,312,168,480,37.510681,126.857399
양천구,725, 양강중학교앞 교차로,201901,210,74,284,37.524334,126.850548
양천구,725, 양강중학교앞 교차로,201902,187,69,256,37.524334,126.850548
양천구,725, 양강중학교앞 교차로,201903,381,137,518,37.524334,126.850548
양천구,725, 양강중학교앞 교차로,201904,511,189,700,37.524334,126.850548
양천구,725, 양강중학교앞 교차로,201905,695,276,971,37.524334,126.850548
양천구,725, 양강중학교앞 교차로,201906,717,277,994,37.524334,126.850548
양천구,725, 양강중학교앞 교차로,201907,646,257,903,37.524334,126.850548
양천구,725, 양강중학교앞 교차로,201908,613,237,850,37.524334,126.850548
양천구,725, 양강중학교앞 교차로,201909,493,249,742,37.524334,126.850548
양천구,725, 양강중학교앞 교차로,201910,423,279,702,37.524334,126.850548
양천구,725, 양강중학교앞 교차로,201911,375,205,580,37.524334,126.850548
양천구,725, 양강중학교앞 교차로,201912,266,81,347,37.524334,126.850548
양천구,725, 양강중학교앞 교차로,202001,220,57,277,37.524334,126.850548
양천구,725, 양강중학교앞 교차로,202002,215,73,288,37.524334,126.850548
양천구,725, 양강중학교앞 교차로,202003,320,204,524,37.524334,126.850548
양천구,725, 양강중학교앞 교차로,202004,507,309,816,37.524334,126.850548
양천구,725, 양강중학교앞 교차로,202005,587,350,937,37.524334,126.850548
양천구,725, 양강중학교앞 교차로,202006,717,368,1085,37.524334,126.850548
양천구,726, 목동3단지 시내버스정류장,201901,342,404,746,37.534389,126.869598
양천구,726, 목동3단지 시내버스정류장,201902,315,407,722,37.534389,126.869598
양천구,726, 목동3단지 시내버스정류장,201903,607,663,1270,37.534389,126.869598
양천구,726, 목동3단지 시내버스정류장,201904,897,925,1822,37.534389,126.869598
양천구,726, 목동3단지 시내버스정류장,201905,1517,1675,3192,37.534389,126.869598
양천구,726, 목동3단지 시내버스정류장,201906,1784,1946,3730,37.534389,126.869598
양천구,726, 목동3단지 시내버스정류장,201907,1754,1860,3614,37.534389,126.869598
양천구,726, 목동3단지 시내버스정류장,201908,1847,1978,3825,37.534389,126.869598
양천구,726, 목동3단지 시내버스정류장,201909,1573,1736,3309,37.534389,126.869598
양천구,726, 목동3단지 시내버스정류장,201910,1892,2016,3908,37.534389,126.869598
양천구,726, 목동3단지 시내버스정류장,201911,1169,1236,2405,37.534389,126.869598
양천구,726, 목동3단지 시내버스정류장,201912,745,739,1484,37.534389,126.869598
양천구,726, 목동3단지 시내버스정류장,202001,809,783,1592,37.534389,126.869598
양천구,726, 목동3단지 시내버스정류장,202002,743,726,1469,37.534389,126.869598
양천구,726, 목동3단지 시내버스정류장,202003,1150,1159,2309,37.534389,126.869598
양천구,726, 목동3단지 시내버스정류장,202004,1780,1768,3548,37.534389,126.869598
양천구,726, 목동3단지 시내버스정류장,202005,2131,2108,4239,37.534389,126.869598
양천구,726, 목동3단지 시내버스정류장,202006,2597,2781,5378,37.534389,126.869598
양천구,729, 서부식자재마트 건너편,201901,392,394,786,37.51038,126.866798
양천구,729, 서부식자재마트 건너편,201902,331,339,670,37.51038,126.866798
양천구,729, 서부식자재마트 건너편,201903,638,710,1348,37.51038,126.866798
양천구,729, 서부식자재마트 건너편,201904,972,1076,2048,37.51038,126.866798
양천구,729, 서부식자재마트 건너편,201905,1421,1653,3074,37.51038,126.866798
양천구,729, 서부식자재마트 건너편,201906,1560,1880,3440,37.51038,126.866798
양천구,729, 서부식자재마트 건너편,201907,1533,2004,3537,37.51038,126.866798
양천구,729, 서부식자재마트 건너편,201908,935,1285,2220,37.51038,126.866798
양천구,729, 서부식자재마트 건너편,201909,1324,1589,2913,37.51038,126.866798
양천구,729, 서부식자재마트 건너편,201910,1827,2091,3918,37.51038,126.866798
양천구,729, 서부식자재마트 건너편,201911,1117,1276,2393,37.51038,126.866798
양천구,729, 서부식자재마트 건너편,201912,579,642,1221,37.51038,126.866798
양천구,729, 서부식자재마트 건너편,202001,612,636,1248,37.51038,126.866798
양천구,729, 서부식자재마트 건너편,202002,603,610,1213,37.51038,126.866798
양천구,729, 서부식자재마트 건너편,202003,1288,1415,2703,37.51038,126.866798
양천구,729, 서부식자재마트 건너편,202004,1885,2172,4057,37.51038,126.866798
양천구,729, 서부식자재마트 건너편,202005,2113,2287,4400,37.51038,126.866798
양천구,729, 서부식자재마트 건너편,202006,2218,2522,4740,37.51038,126.866798
양천구,731, 서울시 도로환경관리센터,201901,393,507,900,37.5299,126.876541
양천구,731, 서울시 도로환경관리센터,201902,376,410,786,37.5299,126.876541
양천구,731, 서울시 도로환경관리센터,201903,633,748,1381,37.5299,126.876541
양천구,731, 서울시 도로환경관리센터,201904,1245,1352,2597,37.5299,126.876541
양천구,731, 서울시 도로환경관리센터,201905,2007,2173,4180,37.5299,126.876541
양천구,731, 서울시 도로환경관리센터,201906,2438,2534,4972,37.5299,126.876541
양천구,731, 서울시 도로환경관리센터,201907,1928,2010,3938,37.5299,126.876541
양천구,731, 서울시 도로환경관리센터,201908,1851,1913,3764,37.5299,126.876541
양천구,731, 서울시 도로환경관리센터,201909,1899,2010,3909,37.5299,126.876541
양천구,731, 서울시 도로환경관리센터,201910,2197,2472,4669,37.5299,126.876541
양천구,731, 서울시 도로환경관리센터,201911,1325,1563,2888,37.5299,126.876541
양천구,731, 서울시 도로환경관리센터,201912,710,946,1656,37.5299,126.876541
양천구,731, 서울시 도로환경관리센터,202001,726,938,1664,37.5299,126.876541
양천구,731, 서울시 도로환경관리센터,202002,736,895,1631,37.5299,126.876541
양천구,731, 서울시 도로환경관리센터,202003,1531,1719,3250,37.5299,126.876541
양천구,731, 서울시 도로환경관리센터,202004,2150,2488,4638,37.5299,126.876541
양천구,731, 서울시 도로환경관리센터,202005,2344,2590,4934,37.5299,126.876541
양천구,731, 서울시 도로환경관리센터,202006,2252,2469,4721,37.5299,126.876541
양천구,732, 신월동 이마트,201901,148,137,285,37.539551,126.8283
양천구,732, 신월동 이마트,201902,120,96,216,37.539551,126.8283
양천구,732, 신월동 이마트,201903,213,193,406,37.539551,126.8283
양천구,732, 신월동 이마트,201904,308,314,622,37.539551,126.8283
양천구,732, 신월동 이마트,201905,612,629,1241,37.539551,126.8283
양천구,732, 신월동 이마트,201906,707,756,1463,37.539551,126.8283
양천구,732, 신월동 이마트,201907,708,718,1426,37.539551,126.8283
양천구,732, 신월동 이마트,201908,660,685,1345,37.539551,126.8283
양천구,732, 신월동 이마트,201909,684,670,1354,37.539551,126.8283
양천구,732, 신월동 이마트,201910,741,747,1488,37.539551,126.8283
양천구,732, 신월동 이마트,201911,513,519,1032,37.539551,126.8283
양천구,732, 신월동 이마트,201912,278,275,553,37.539551,126.8283
양천구,732, 신월동 이마트,202001,318,275,593,37.539551,126.8283
양천구,732, 신월동 이마트,202002,328,290,618,37.539551,126.8283
양천구,732, 신월동 이마트,202003,549,553,1102,37.539551,126.8283
양천구,732, 신월동 이마트,202004,887,893,1780,37.539551,126.8283
양천구,732, 신월동 이마트,202005,1052,1041,2093,37.539551,126.8283
양천구,732, 신월동 이마트,202006,1071,1068,2139,37.539551,126.8283
양천구,733, 신정이펜하우스314동,201901,106,37,143,37.514099,126.831001
양천구,733, 신정이펜하우스314동,201902,108,59,167,37.514099,126.831001
양천구,733, 신정이펜하우스314동,201903,248,157,405,37.514099,126.831001
양천구,733, 신정이펜하우스314동,201904,353,213,566,37.514099,126.831001
양천구,733, 신정이펜하우스314동,201905,517,403,920,37.514099,126.831001
양천구,733, 신정이펜하우스314동,201906,544,428,972,37.514099,126.831001
양천구,733, 신정이펜하우스314동,201907,564,472,1036,37.514099,126.831001
양천구,733, 신정이펜하우스314동,201908,516,394,910,37.514099,126.831001
양천구,733, 신정이펜하우스314동,201909,531,397,928,37.514099,126.831001
양천구,733, 신정이펜하우스314동,201910,552,395,947,37.514099,126.831001
양천구,733, 신정이펜하우스314동,201911,388,247,635,37.514099,126.831001
양천구,733, 신정이펜하우스314동,201912,208,107,315,37.514099,126.831001
양천구,733, 신정이펜하우스314동,202001,228,116,344,37.514099,126.831001
양천구,733, 신정이펜하우스314동,202002,253,134,387,37.514099,126.831001
양천구,733, 신정이펜하우스314동,202003,475,289,764,37.514099,126.831001
양천구,733, 신정이펜하우스314동,202004,715,538,1253,37.514099,126.831001
양천구,733, 신정이펜하우스314동,202005,774,572,1346,37.514099,126.831001
양천구,733, 신정이펜하우스314동,202006,770,561,1331,37.514099,126.831001
양천구,734, 신트리공원 입구,201901,231,243,474,37.51395,126.856056
양천구,734, 신트리공원 입구,201902,224,212,436,37.51395,126.856056
양천구,734, 신트리공원 입구,201903,458,424,882,37.51395,126.856056
양천구,734, 신트리공원 입구,201904,629,685,1314,37.51395,126.856056
양천구,734, 신트리공원 입구,201905,1012,1110,2122,37.51395,126.856056
양천구,734, 신트리공원 입구,201906,1091,1268,2359,37.51395,126.856056
양천구,734, 신트리공원 입구,201907,1060,1160,2220,37.51395,126.856056
양천구,734, 신트리공원 입구,201908,949,1041,1990,37.51395,126.856056
양천구,734, 신트리공원 입구,201909,953,1008,1961,37.51395,126.856056
양천구,734, 신트리공원 입구,201910,1170,1234,2404,37.51395,126.856056
양천구,734, 신트리공원 입구,201911,725,781,1506,37.51395,126.856056
양천구,734, 신트리공원 입구,201912,483,468,951,37.51395,126.856056
양천구,734, 신트리공원 입구,202001,469,489,958,37.51395,126.856056
양천구,734, 신트리공원 입구,202002,468,485,953,37.51395,126.856056
양천구,734, 신트리공원 입구,202003,856,910,1766,37.51395,126.856056
양천구,734, 신트리공원 입구,202004,1319,1404,2723,37.51395,126.856056
양천구,734, 신트리공원 입구,202005,1789,1959,3748,37.51395,126.856056
양천구,734, 신트리공원 입구,202006,1866,2083,3949,37.51395,126.856056
양천구,735, 영도초등학교,201901,452,463,915,37.53643,126.871521
양천구,735, 영도초등학교,201902,424,472,896,37.53643,126.871521
양천구,735, 영도초등학교,201903,637,697,1334,37.53643,126.871521
양천구,735, 영도초등학교,201904,846,890,1736,37.53643,126.871521
양천구,735, 영도초등학교,201905,1332,1466,2798,37.53643,126.871521
양천구,735, 영도초등학교,201906,1621,1804,3425,37.53643,126.871521
양천구,735, 영도초등학교,201907,1724,1933,3657,37.53643,126.871521
양천구,735, 영도초등학교,201908,1709,1904,3613,37.53643,126.871521
양천구,735, 영도초등학교,201909,1552,1644,3196,37.53643,126.871521
양천구,735, 영도초등학교,201910,1867,2046,3913,37.53643,126.871521
양천구,735, 영도초등학교,201911,1188,1301,2489,37.53643,126.871521
양천구,735, 영도초등학교,201912,695,759,1454,37.53643,126.871521
양천구,735, 영도초등학교,202001,666,728,1394,37.53643,126.871521
양천구,735, 영도초등학교,202002,553,617,1170,37.53643,126.871521
양천구,735, 영도초등학교,202003,1144,1230,2374,37.53643,126.871521
양천구,735, 영도초등학교,202004,1730,1862,3592,37.53643,126.871521
양천구,735, 영도초등학교,202005,2284,2411,4695,37.53643,126.871521
양천구,735, 영도초등학교,202006,2417,2884,5301,37.53643,126.871521
양천구,736, 오솔길공원,201901,197,199,396,37.52219,126.8367
양천구,736, 오솔길공원,201902,145,190,335,37.52219,126.8367
양천구,736, 오솔길공원,201903,250,318,568,37.52219,126.8367
양천구,736, 오솔길공원,201904,452,559,1011,37.52219,126.8367
양천구,736, 오솔길공원,201905,892,1050,1942,37.52219,126.8367
양천구,736, 오솔길공원,201906,946,1129,2075,37.52219,126.8367
양천구,736, 오솔길공원,201907,1057,1215,2272,37.52219,126.8367
양천구,736, 오솔길공원,201908,897,1091,1988,37.52219,126.8367
양천구,736, 오솔길공원,201909,806,1090,1896,37.52219,126.8367
양천구,736, 오솔길공원,201910,1070,1318,2388,37.52219,126.8367
양천구,736, 오솔길공원,201911,772,861,1633,37.52219,126.8367
양천구,736, 오솔길공원,201912,469,513,982,37.52219,126.8367
양천구,736, 오솔길공원,202001,417,434,851,37.52219,126.8367
양천구,736, 오솔길공원,202002,402,479,881,37.52219,126.8367
양천구,736, 오솔길공원,202003,742,820,1562,37.52219,126.8367
양천구,736, 오솔길공원,202004,1064,1124,2188,37.52219,126.8367
양천구,736, 오솔길공원,202005,1196,1366,2562,37.52219,126.8367
양천구,736, 오솔길공원,202006,1247,1333,2580,37.52219,126.8367
양천구,737, 장수공원,201901,159,166,325,37.52256,126.84948
양천구,737, 장수공원,201902,170,138,308,37.52256,126.84948
양천구,737, 장수공원,201903,265,260,525,37.52256,126.84948
양천구,737, 장수공원,201904,367,411,778,37.52256,126.84948
양천구,737, 장수공원,201905,632,865,1497,37.52256,126.84948
양천구,737, 장수공원,201906,617,903,1520,37.52256,126.84948
양천구,737, 장수공원,201907,687,813,1500,37.52256,126.84948
양천구,737, 장수공원,201908,609,785,1394,37.52256,126.84948
양천구,737, 장수공원,201909,669,783,1452,37.52256,126.84948
양천구,737, 장수공원,201910,791,939,1730,37.52256,126.84948
양천구,737, 장수공원,201911,493,575,1068,37.52256,126.84948
양천구,737, 장수공원,201912,250,304,554,37.52256,126.84948
양천구,737, 장수공원,202001,251,319,570,37.52256,126.84948
양천구,737, 장수공원,202002,285,330,615,37.52256,126.84948
양천구,737, 장수공원,202003,547,654,1201,37.52256,126.84948
양천구,737, 장수공원,202004,835,930,1765,37.52256,126.84948
양천구,737, 장수공원,202005,1048,1126,2174,37.52256,126.84948
양천구,737, 장수공원,202006,1129,1340,2469,37.52256,126.84948
양천구,739, 신월사거리,201901,261,261,522,37.536201,126.827797
양천구,739, 신월사거리,201902,244,222,466,37.536201,126.827797
양천구,739, 신월사거리,201903,454,466,920,37.536201,126.827797
양천구,739, 신월사거리,201904,597,589,1186,37.536201,126.827797
양천구,739, 신월사거리,201905,936,1011,1947,37.536201,126.827797
양천구,739, 신월사거리,201906,1100,1271,2371,37.536201,126.827797
양천구,739, 신월사거리,201907,1046,1189,2235,37.536201,126.827797
양천구,739, 신월사거리,201908,936,954,1890,37.536201,126.827797
양천구,739, 신월사거리,201909,934,940,1874,37.536201,126.827797
양천구,739, 신월사거리,201910,1137,1124,2261,37.536201,126.827797
양천구,739, 신월사거리,201911,834,840,1674,37.536201,126.827797
양천구,739, 신월사거리,201912,556,545,1101,37.536201,126.827797
양천구,739, 신월사거리,202001,512,536,1048,37.536201,126.827797
양천구,739, 신월사거리,202002,437,445,882,37.536201,126.827797
양천구,739, 신월사거리,202003,634,681,1315,37.536201,126.827797
양천구,739, 신월사거리,202004,316,368,684,37.536201,126.827797
양천구,739, 신월사거리,202005,852,860,1712,37.536201,126.827797
양천구,739, 신월사거리,202006,1406,1391,2797,37.536201,126.827797
양천구,740, 으뜸공원,201901,139,182,321,37.536369,126.831711
양천구,740, 으뜸공원,201902,129,131,260,37.536369,126.831711
양천구,740, 으뜸공원,201903,293,299,592,37.536369,126.831711
양천구,740, 으뜸공원,201904,380,440,820,37.536369,126.831711
양천구,740, 으뜸공원,201905,635,722,1357,37.536369,126.831711
양천구,740, 으뜸공원,201906,729,899,1628,37.536369,126.831711
양천구,740, 으뜸공원,201907,800,981,1781,37.536369,126.831711
양천구,740, 으뜸공원,201908,830,1033,1863,37.536369,126.831711
양천구,740, 으뜸공원,201909,911,1095,2006,37.536369,126.831711
양천구,740, 으뜸공원,201910,1077,1255,2332,37.536369,126.831711
양천구,740, 으뜸공원,201911,623,725,1348,37.536369,126.831711
양천구,740, 으뜸공원,201912,348,417,765,37.536369,126.831711
양천구,740, 으뜸공원,202001,251,377,628,37.536369,126.831711
양천구,740, 으뜸공원,202002,340,427,767,37.536369,126.831711
양천구,740, 으뜸공원,202003,541,629,1170,37.536369,126.831711
양천구,740, 으뜸공원,202004,1083,1178,2261,37.536369,126.831711
양천구,740, 으뜸공원,202005,1091,1294,2385,37.536369,126.831711
양천구,740, 으뜸공원,202006,1150,1344,2494,37.536369,126.831711
양천구,741, 화곡로 입구 교차로,201901,33,23,56,37.53952,126.825401
양천구,741, 화곡로 입구 교차로,201902,50,46,96,37.53952,126.825401
양천구,741, 화곡로 입구 교차로,201903,86,80,166,37.53952,126.825401
양천구,741, 화곡로 입구 교차로,201904,162,157,319,37.53952,126.825401
양천구,741, 화곡로 입구 교차로,201905,233,222,455,37.53952,126.825401
양천구,741, 화곡로 입구 교차로,201906,260,214,474,37.53952,126.825401
양천구,741, 화곡로 입구 교차로,201907,250,228,478,37.53952,126.825401
양천구,741, 화곡로 입구 교차로,201908,212,218,430,37.53952,126.825401
양천구,741, 화곡로 입구 교차로,201909,256,252,508,37.53952,126.825401
양천구,741, 화곡로 입구 교차로,201910,345,327,672,37.53952,126.825401
양천구,741, 화곡로 입구 교차로,201911,242,247,489,37.53952,126.825401
양천구,741, 화곡로 입구 교차로,201912,126,117,243,37.53952,126.825401
양천구,741, 화곡로 입구 교차로,202001,137,105,242,37.53952,126.825401
양천구,741, 화곡로 입구 교차로,202002,160,133,293,37.53952,126.825401
양천구,741, 화곡로 입구 교차로,202003,218,187,405,37.53952,126.825401
양천구,741, 화곡로 입구 교차로,202004,364,359,723,37.53952,126.825401
양천구,741, 화곡로 입구 교차로,202005,421,426,847,37.53952,126.825401
양천구,741, 화곡로 입구 교차로,202006,400,392,792,37.53952,126.825401
양천구,742, 등촌역 5번 출구 뒤,201901,248,261,509,37.550732,126.864578
양천구,742, 등촌역 5번 출구 뒤,201902,131,136,267,37.550732,126.864578
양천구,742, 등촌역 5번 출구 뒤,201903,298,263,561,37.550732,126.864578
양천구,742, 등촌역 5번 출구 뒤,201904,381,358,739,37.550732,126.864578
양천구,742, 등촌역 5번 출구 뒤,201905,736,702,1438,37.550732,126.864578
양천구,742, 등촌역 5번 출구 뒤,201906,973,946,1919,37.550732,126.864578
양천구,742, 등촌역 5번 출구 뒤,201907,839,834,1673,37.550732,126.864578
양천구,742, 등촌역 5번 출구 뒤,201908,751,731,1482,37.550732,126.864578
양천구,742, 등촌역 5번 출구 뒤,201909,740,744,1484,37.550732,126.864578
양천구,742, 등촌역 5번 출구 뒤,201910,980,963,1943,37.550732,126.864578
양천구,742, 등촌역 5번 출구 뒤,201911,634,612,1246,37.550732,126.864578
양천구,742, 등촌역 5번 출구 뒤,201912,309,308,617,37.550732,126.864578
양천구,742, 등촌역 5번 출구 뒤,202001,304,296,600,37.550732,126.864578
양천구,742, 등촌역 5번 출구 뒤,202002,292,279,571,37.550732,126.864578
양천구,742, 등촌역 5번 출구 뒤,202003,517,503,1020,37.550732,126.864578
양천구,742, 등촌역 5번 출구 뒤,202004,831,807,1638,37.550732,126.864578
양천구,742, 등촌역 5번 출구 뒤,202005,1115,1085,2200,37.550732,126.864578
양천구,742, 등촌역 5번 출구 뒤,202006,1063,1067,2130,37.550732,126.864578
양천구,743, 현대6차아파트 101동 옆,201901,120,114,234,37.5089,126.842682
양천구,743, 현대6차아파트 101동 옆,201902,121,90,211,37.5089,126.842682
양천구,743, 현대6차아파트 101동 옆,201903,209,151,360,37.5089,126.842682
양천구,743, 현대6차아파트 101동 옆,201904,301,253,554,37.5089,126.842682
양천구,743, 현대6차아파트 101동 옆,201905,509,439,948,37.5089,126.842682
양천구,743, 현대6차아파트 101동 옆,201906,503,499,1002,37.5089,126.842682
양천구,743, 현대6차아파트 101동 옆,201907,572,514,1086,37.5089,126.842682
양천구,743, 현대6차아파트 101동 옆,201908,533,497,1030,37.5089,126.842682
양천구,743, 현대6차아파트 101동 옆,201909,494,410,904,37.5089,126.842682
양천구,743, 현대6차아파트 101동 옆,201910,622,528,1150,37.5089,126.842682
양천구,743, 현대6차아파트 101동 옆,201911,398,327,725,37.5089,126.842682
양천구,743, 현대6차아파트 101동 옆,201912,240,205,445,37.5089,126.842682
양천구,743, 현대6차아파트 101동 옆,202001,212,207,419,37.5089,126.842682
양천구,743, 현대6차아파트 101동 옆,202002,239,212,451,37.5089,126.842682
양천구,743, 현대6차아파트 101동 옆,202003,397,392,789,37.5089,126.842682
양천구,743, 현대6차아파트 101동 옆,202004,537,497,1034,37.5089,126.842682
양천구,743, 현대6차아파트 101동 옆,202005,880,848,1728,37.5089,126.842682
양천구,743, 현대6차아파트 101동 옆,202006,1012,987,1999,37.5089,126.842682
양천구,744, 신목동역 2번 출구,201901,439,414,853,37.543842,126.882545
양천구,744, 신목동역 2번 출구,201902,418,364,782,37.543842,126.882545
양천구,744, 신목동역 2번 출구,201903,715,743,1458,37.543842,126.882545
양천구,744, 신목동역 2번 출구,201904,1407,1446,2853,37.543842,126.882545
양천구,744, 신목동역 2번 출구,201905,2268,2282,4550,37.543842,126.882545
양천구,744, 신목동역 2번 출구,201906,1602,1558,3160,37.543842,126.882545
양천구,744, 신목동역 2번 출구,201907,1430,1470,2900,37.543842,126.882545
양천구,744, 신목동역 2번 출구,201908,1370,1372,2742,37.543842,126.882545
양천구,744, 신목동역 2번 출구,201909,1378,1321,2699,37.543842,126.882545
양천구,744, 신목동역 2번 출구,201910,1563,1551,3114,37.543842,126.882545
양천구,744, 신목동역 2번 출구,201911,1069,1100,2169,37.543842,126.882545
양천구,744, 신목동역 2번 출구,201912,677,650,1327,37.543842,126.882545
양천구,744, 신목동역 2번 출구,202001,602,591,1193,37.543842,126.882545
양천구,744, 신목동역 2번 출구,202002,579,579,1158,37.543842,126.882545
양천구,744, 신목동역 2번 출구,202003,866,807,1673,37.543842,126.882545
양천구,744, 신목동역 2번 출구,202004,1572,1434,3006,37.543842,126.882545
양천구,744, 신목동역 2번 출구,202005,1974,1828,3802,37.543842,126.882545
양천구,744, 신목동역 2번 출구,202006,2237,2094,4331,37.543842,126.882545
양천구,745, 강서초등학교,201901,114,131,245,37.522282,126.839699
양천구,745, 강서초등학교,201902,88,118,206,37.522282,126.839699
양천구,745, 강서초등학교,201903,146,205,351,37.522282,126.839699
양천구,745, 강서초등학교,201904,303,367,670,37.522282,126.839699
양천구,745, 강서초등학교,201905,496,573,1069,37.522282,126.839699
양천구,745, 강서초등학교,201906,687,813,1500,37.522282,126.839699
양천구,745, 강서초등학교,201907,635,804,1439,37.522282,126.839699
양천구,745, 강서초등학교,201908,607,769,1376,37.522282,126.839699
양천구,745, 강서초등학교,201909,698,823,1521,37.522282,126.839699
양천구,745, 강서초등학교,201910,913,1068,1981,37.522282,126.839699
양천구,745, 강서초등학교,201911,587,683,1270,37.522282,126.839699
양천구,745, 강서초등학교,201912,268,330,598,37.522282,126.839699
양천구,745, 강서초등학교,202001,236,272,508,37.522282,126.839699
양천구,745, 강서초등학교,202002,191,284,475,37.522282,126.839699
양천구,745, 강서초등학교,202003,452,488,940,37.522282,126.839699
양천구,745, 강서초등학교,202004,812,936,1748,37.522282,126.839699
양천구,745, 강서초등학교,202005,932,1103,2035,37.522282,126.839699
양천구,745, 강서초등학교,202006,1017,1339,2356,37.522282,126.839699
양천구,746, 목동2단지 상가,201901,388,423,811,37.536503,126.877747
양천구,746, 목동2단지 상가,201902,388,393,781,37.536503,126.877747
양천구,746, 목동2단지 상가,201903,611,619,1230,37.536503,126.877747
양천구,746, 목동2단지 상가,201904,936,943,1879,37.536503,126.877747
양천구,746, 목동2단지 상가,201905,1526,1534,3060,37.536503,126.877747
양천구,746, 목동2단지 상가,201906,1906,1885,3791,37.536503,126.877747
양천구,746, 목동2단지 상가,201907,1844,1856,3700,37.536503,126.877747
양천구,746, 목동2단지 상가,201908,1647,1677,3324,37.536503,126.877747
양천구,746, 목동2단지 상가,201909,1579,1644,3223,37.536503,126.877747
양천구,746, 목동2단지 상가,201910,1926,1959,3885,37.536503,126.877747
양천구,746, 목동2단지 상가,201911,1334,1359,2693,37.536503,126.877747
양천구,746, 목동2단지 상가,201912,812,835,1647,37.536503,126.877747
양천구,746, 목동2단지 상가,202001,807,825,1632,37.536503,126.877747
양천구,746, 목동2단지 상가,202002,798,844,1642,37.536503,126.877747
양천구,746, 목동2단지 상가,202003,1170,1206,2376,37.536503,126.877747
양천구,746, 목동2단지 상가,202004,1883,1933,3816,37.536503,126.877747
양천구,746, 목동2단지 상가,202005,2399,2456,4855,37.536503,126.877747
양천구,746, 목동2단지 상가,202006,2739,2764,5503,37.536503,126.877747
양천구,747, 목동3단지 상가,201901,292,289,581,37.53458,126.875648
양천구,747, 목동3단지 상가,201902,266,259,525,37.53458,126.875648
양천구,747, 목동3단지 상가,201903,573,537,1110,37.53458,126.875648
양천구,747, 목동3단지 상가,201904,749,710,1459,37.53458,126.875648
양천구,747, 목동3단지 상가,201905,1095,1079,2174,37.53458,126.875648
양천구,747, 목동3단지 상가,201906,1215,1151,2366,37.53458,126.875648
양천구,747, 목동3단지 상가,201907,989,985,1974,37.53458,126.875648
양천구,747, 목동3단지 상가,201908,1262,1278,2540,37.53458,126.875648
양천구,747, 목동3단지 상가,201909,1104,1106,2210,37.53458,126.875648
양천구,747, 목동3단지 상가,201910,1213,1220,2433,37.53458,126.875648
양천구,747, 목동3단지 상가,201911,850,866,1716,37.53458,126.875648
양천구,747, 목동3단지 상가,201912,574,573,1147,37.53458,126.875648
양천구,747, 목동3단지 상가,202001,585,576,1161,37.53458,126.875648
양천구,747, 목동3단지 상가,202002,474,486,960,37.53458,126.875648
양천구,747, 목동3단지 상가,202003,560,540,1100,37.53458,126.875648
양천구,747, 목동3단지 상가,202004,880,832,1712,37.53458,126.875648
양천구,747, 목동3단지 상가,202005,1331,1307,2638,37.53458,126.875648
양천구,747, 목동3단지 상가,202006,1374,1346,2720,37.53458,126.875648
양천구,748, 목동운동장,201901,50,83,133,37.530251,126.879303
양천구,748, 목동운동장,201902,46,67,113,37.530251,126.879303
양천구,748, 목동운동장,201903,55,89,144,37.530251,126.879303
양천구,748, 목동운동장,201904,160,198,358,37.530251,126.879303
양천구,748, 목동운동장,201905,191,186,377,37.530251,126.879303
양천구,748, 목동운동장,201906,338,291,629,37.530251,126.879303
양천구,748, 목동운동장,201907,350,330,680,37.530251,126.879303
양천구,748, 목동운동장,201908,359,298,657,37.530251,126.879303
양천구,748, 목동운동장,201909,220,228,448,37.530251,126.879303
양천구,748, 목동운동장,201910,433,429,862,37.530251,126.879303
양천구,748, 목동운동장,201911,290,344,634,37.530251,126.879303
양천구,748, 목동운동장,201912,231,240,471,37.530251,126.879303
양천구,748, 목동운동장,202001,147,180,327,37.530251,126.879303
양천구,748, 목동운동장,202002,173,196,369,37.530251,126.879303
양천구,748, 목동운동장,202003,160,146,306,37.530251,126.879303
양천구,748, 목동운동장,202004,326,225,551,37.530251,126.879303
양천구,748, 목동운동장,202005,471,391,862,37.530251,126.879303
양천구,748, 목동운동장,202006,391,278,669,37.530251,126.879303
양천구,749, 이대 목동병원 앞,201901,179,167,346,37.537228,126.886612
양천구,749, 이대 목동병원 앞,201902,171,210,381,37.537228,126.886612
양천구,749, 이대 목동병원 앞,201903,341,406,747,37.537228,126.886612
양천구,749, 이대 목동병원 앞,201904,714,730,1444,37.537228,126.886612
양천구,749, 이대 목동병원 앞,201905,1051,1100,2151,37.537228,126.886612
양천구,749, 이대 목동병원 앞,201906,1282,1275,2557,37.537228,126.886612
양천구,749, 이대 목동병원 앞,201907,1064,1080,2144,37.537228,126.886612
양천구,749, 이대 목동병원 앞,201908,1045,1054,2099,37.537228,126.886612
양천구,749, 이대 목동병원 앞,201909,1020,1049,2069,37.537228,126.886612
양천구,749, 이대 목동병원 앞,201910,1256,1296,2552,37.537228,126.886612
양천구,749, 이대 목동병원 앞,201911,766,819,1585,37.537228,126.886612
양천구,749, 이대 목동병원 앞,201912,425,454,879,37.537228,126.886612
양천구,749, 이대 목동병원 앞,202001,389,407,796,37.537228,126.886612
양천구,749, 이대 목동병원 앞,202002,462,456,918,37.537228,126.886612
양천구,749, 이대 목동병원 앞,202003,1192,1203,2395,37.537228,126.886612
양천구,749, 이대 목동병원 앞,202004,1764,1802,3566,37.537228,126.886612
양천구,749, 이대 목동병원 앞,202005,2025,2065,4090,37.537228,126.886612
양천구,749, 이대 목동병원 앞,202006,1791,1883,3674,37.537228,126.886612
양천구,750, 연의근린공원 건너편,201901,99,104,203,37.512157,126.835625
양천구,750, 연의근린공원 건너편,201902,81,94,175,37.512157,126.835625
양천구,750, 연의근린공원 건너편,201903,164,167,331,37.512157,126.835625
양천구,750, 연의근린공원 건너편,201904,310,325,635,37.512157,126.835625
양천구,750, 연의근린공원 건너편,201905,524,597,1121,37.512157,126.835625
양천구,750, 연의근린공원 건너편,201906,637,689,1326,37.512157,126.835625
양천구,750, 연의근린공원 건너편,201907,586,723,1309,37.512157,126.835625
양천구,750, 연의근린공원 건너편,201908,521,656,1177,37.512157,126.835625
양천구,750, 연의근린공원 건너편,201909,581,678,1259,37.512157,126.835625
양천구,750, 연의근린공원 건너편,201910,712,789,1501,37.512157,126.835625
양천구,750, 연의근린공원 건너편,201911,517,601,1118,37.512157,126.835625
양천구,750, 연의근린공원 건너편,201912,319,387,706,37.512157,126.835625
양천구,750, 연의근린공원 건너편,202001,290,312,602,37.512157,126.835625
양천구,750, 연의근린공원 건너편,202002,305,353,658,37.512157,126.835625
양천구,750, 연의근린공원 건너편,202003,561,651,1212,37.512157,126.835625
양천구,750, 연의근린공원 건너편,202004,954,997,1951,37.512157,126.835625
양천구,750, 연의근린공원 건너편,202005,1122,1109,2231,37.512157,126.835625
양천구,750, 연의근린공원 건너편,202006,1004,1139,2143,37.512157,126.835625
양천구,752, 성원2차 아파트,201901,294,222,516,37.542183,126.863304
양천구,752, 성원2차 아파트,201902,220,198,418,37.542183,126.863304
양천구,752, 성원2차 아파트,201903,337,290,627,37.542183,126.863304
양천구,752, 성원2차 아파트,201904,543,478,1021,37.542183,126.863304
양천구,752, 성원2차 아파트,201905,948,893,1841,37.542183,126.863304
양천구,752, 성원2차 아파트,201906,914,884,1798,37.542183,126.863304
양천구,752, 성원2차 아파트,201907,799,829,1628,37.542183,126.863304
양천구,752, 성원2차 아파트,201908,771,754,1525,37.542183,126.863304
양천구,752, 성원2차 아파트,201909,704,677,1381,37.542183,126.863304
양천구,752, 성원2차 아파트,201910,855,838,1693,37.542183,126.863304
양천구,752, 성원2차 아파트,201911,551,522,1073,37.542183,126.863304
양천구,752, 성원2차 아파트,201912,311,273,584,37.542183,126.863304
양천구,752, 성원2차 아파트,202001,338,248,586,37.542183,126.863304
양천구,752, 성원2차 아파트,202002,335,263,598,37.542183,126.863304
양천구,752, 성원2차 아파트,202003,544,465,1009,37.542183,126.863304
양천구,752, 성원2차 아파트,202004,891,818,1709,37.542183,126.863304
양천구,752, 성원2차 아파트,202005,1129,1029,2158,37.542183,126.863304
양천구,752, 성원2차 아파트,202006,1214,1157,2371,37.542183,126.863304
양천구,754, 목동1단지아파트 118동 앞 (월촌초등학교 정류소 옆),201901,231,240,471,37.541142,126.876678
양천구,754, 목동1단지아파트 118동 앞 (월촌초등학교 정류소 옆),201902,195,218,413,37.541142,126.876678
양천구,754, 목동1단지아파트 118동 앞 (월촌초등학교 정류소 옆),201903,389,382,771,37.541142,126.876678
양천구,754, 목동1단지아파트 118동 앞 (월촌초등학교 정류소 옆),201904,601,649,1250,37.541142,126.876678
양천구,754, 목동1단지아파트 118동 앞 (월촌초등학교 정류소 옆),201905,915,999,1914,37.541142,126.876678
양천구,754, 목동1단지아파트 118동 앞 (월촌초등학교 정류소 옆),201906,1073,1159,2232,37.541142,126.876678
양천구,754, 목동1단지아파트 118동 앞 (월촌초등학교 정류소 옆),201907,1096,1150,2246,37.541142,126.876678
양천구,754, 목동1단지아파트 118동 앞 (월촌초등학교 정류소 옆),201908,1210,1245,2455,37.541142,126.876678
양천구,754, 목동1단지아파트 118동 앞 (월촌초등학교 정류소 옆),201909,961,1004,1965,37.541142,126.876678
양천구,754, 목동1단지아파트 118동 앞 (월촌초등학교 정류소 옆),201910,1189,1222,2411,37.541142,126.876678
양천구,754, 목동1단지아파트 118동 앞 (월촌초등학교 정류소 옆),201911,852,864,1716,37.541142,126.876678
양천구,754, 목동1단지아파트 118동 앞 (월촌초등학교 정류소 옆),201912,531,556,1087,37.541142,126.876678
양천구,754, 목동1단지아파트 118동 앞 (월촌초등학교 정류소 옆),202001,543,548,1091,37.541142,126.876678
양천구,754, 목동1단지아파트 118동 앞 (월촌초등학교 정류소 옆),202002,526,524,1050,37.541142,126.876678
양천구,754, 목동1단지아파트 118동 앞 (월촌초등학교 정류소 옆),202003,655,661,1316,37.541142,126.876678
양천구,754, 목동1단지아파트 118동 앞 (월촌초등학교 정류소 옆),202004,1025,1020,2045,37.541142,126.876678
양천구,754, 목동1단지아파트 118동 앞 (월촌초등학교 정류소 옆),202005,1333,1367,2700,37.541142,126.876678
양천구,754, 목동1단지아파트 118동 앞 (월촌초등학교 정류소 옆),202006,1421,1537,2958,37.541142,126.876678
양천구,755, 목동1단지아파트 상가 앞 (월촌중학교 버스정류소 옆),201901,320,300,620,37.537868,126.881409
양천구,755, 목동1단지아파트 상가 앞 (월촌중학교 버스정류소 옆),201902,298,337,635,37.537868,126.881409
양천구,755, 목동1단지아파트 상가 앞 (월촌중학교 버스정류소 옆),201903,597,657,1254,37.537868,126.881409
양천구,755, 목동1단지아파트 상가 앞 (월촌중학교 버스정류소 옆),201904,990,1021,2011,37.537868,126.881409
양천구,755, 목동1단지아파트 상가 앞 (월촌중학교 버스정류소 옆),201905,1510,1526,3036,37.537868,126.881409
양천구,755, 목동1단지아파트 상가 앞 (월촌중학교 버스정류소 옆),201906,1665,1669,3334,37.537868,126.881409
양천구,755, 목동1단지아파트 상가 앞 (월촌중학교 버스정류소 옆),201907,1661,1676,3337,37.537868,126.881409
양천구,755, 목동1단지아파트 상가 앞 (월촌중학교 버스정류소 옆),201908,1738,1752,3490,37.537868,126.881409
양천구,755, 목동1단지아파트 상가 앞 (월촌중학교 버스정류소 옆),201909,1529,1542,3071,37.537868,126.881409
양천구,755, 목동1단지아파트 상가 앞 (월촌중학교 버스정류소 옆),201910,1859,1881,3740,37.537868,126.881409
양천구,755, 목동1단지아파트 상가 앞 (월촌중학교 버스정류소 옆),201911,1280,1308,2588,37.537868,126.881409
양천구,755, 목동1단지아파트 상가 앞 (월촌중학교 버스정류소 옆),201912,760,779,1539,37.537868,126.881409
양천구,755, 목동1단지아파트 상가 앞 (월촌중학교 버스정류소 옆),202001,737,785,1522,37.537868,126.881409
양천구,755, 목동1단지아파트 상가 앞 (월촌중학교 버스정류소 옆),202002,686,706,1392,37.537868,126.881409
양천구,755, 목동1단지아파트 상가 앞 (월촌중학교 버스정류소 옆),202003,1053,1035,2088,37.537868,126.881409
양천구,755, 목동1단지아파트 상가 앞 (월촌중학교 버스정류소 옆),202004,1924,1961,3885,37.537868,126.881409
양천구,755, 목동1단지아파트 상가 앞 (월촌중학교 버스정류소 옆),202005,2338,2332,4670,37.537868,126.881409
양천구,755, 목동1단지아파트 상가 앞 (월촌중학교 버스정류소 옆),202006,2485,2473,4958,37.537868,126.881409
양천구,756, 목동주차장,201901,315,310,625,37.52668,126.876167
양천구,756, 목동주차장,201902,337,317,654,37.52668,126.876167
양천구,756, 목동주차장,201903,646,681,1327,37.52668,126.876167
양천구,756, 목동주차장,201904,1120,1115,2235,37.52668,126.876167
양천구,756, 목동주차장,201905,1886,1839,3725,37.52668,126.876167
양천구,756, 목동주차장,201906,1749,1880,3629,37.52668,126.876167
양천구,756, 목동주차장,201907,1549,1661,3210,37.52668,126.876167
양천구,756, 목동주차장,201908,1404,1417,2821,37.52668,126.876167
양천구,756, 목동주차장,201909,1423,1448,2871,37.52668,126.876167
양천구,756, 목동주차장,201910,1828,1873,3701,37.52668,126.876167
양천구,756, 목동주차장,201911,1076,1157,2233,37.52668,126.876167
양천구,756, 목동주차장,201912,605,661,1266,37.52668,126.876167
양천구,756, 목동주차장,202001,542,601,1143,37.52668,126.876167
양천구,756, 목동주차장,202002,541,576,1117,37.52668,126.876167
양천구,756, 목동주차장,202003,1017,1034,2051,37.52668,126.876167
양천구,756, 목동주차장,202004,1662,1729,3391,37.52668,126.876167
양천구,756, 목동주차장,202005,1950,2085,4035,37.52668,126.876167
양천구,756, 목동주차장,202006,2010,2126,4136,37.52668,126.876167
양천구,757, 신정이펜하우스 1단지아파트 입구 사거리,201901,81,44,125,37.514278,126.828743
양천구,757, 신정이펜하우스 1단지아파트 입구 사거리,201902,72,52,124,37.514278,126.828743
양천구,757, 신정이펜하우스 1단지아파트 입구 사거리,201903,132,101,233,37.514278,126.828743
양천구,757, 신정이펜하우스 1단지아파트 입구 사거리,201904,183,168,351,37.514278,126.828743
양천구,757, 신정이펜하우스 1단지아파트 입구 사거리,201905,331,216,547,37.514278,126.828743
양천구,757, 신정이펜하우스 1단지아파트 입구 사거리,201906,358,291,649,37.514278,126.828743
양천구,757, 신정이펜하우스 1단지아파트 입구 사거리,201907,306,204,510,37.514278,126.828743
양천구,757, 신정이펜하우스 1단지아파트 입구 사거리,201908,335,240,575,37.514278,126.828743
양천구,757, 신정이펜하우스 1단지아파트 입구 사거리,201909,378,257,635,37.514278,126.828743
양천구,757, 신정이펜하우스 1단지아파트 입구 사거리,201910,461,304,765,37.514278,126.828743
양천구,757, 신정이펜하우스 1단지아파트 입구 사거리,201911,263,159,422,37.514278,126.828743
양천구,757, 신정이펜하우스 1단지아파트 입구 사거리,201912,187,104,291,37.514278,126.828743
양천구,757, 신정이펜하우스 1단지아파트 입구 사거리,202001,165,95,260,37.514278,126.828743
양천구,757, 신정이펜하우스 1단지아파트 입구 사거리,202002,197,116,313,37.514278,126.828743
양천구,757, 신정이펜하우스 1단지아파트 입구 사거리,202003,382,260,642,37.514278,126.828743
양천구,757, 신정이펜하우스 1단지아파트 입구 사거리,202004,503,437,940,37.514278,126.828743
양천구,757, 신정이펜하우스 1단지아파트 입구 사거리,202005,594,454,1048,37.514278,126.828743
양천구,757, 신정이펜하우스 1단지아파트 입구 사거리,202006,587,404,991,37.514278,126.828743
양천구,758, 한사랑교회 앞,201901,221,214,435,37.514721,126.8592
양천구,758, 한사랑교회 앞,201902,217,214,431,37.514721,126.8592
양천구,758, 한사랑교회 앞,201903,464,414,878,37.514721,126.8592
양천구,758, 한사랑교회 앞,201904,675,656,1331,37.514721,126.8592
양천구,758, 한사랑교회 앞,201905,1055,1085,2140,37.514721,126.8592
양천구,758, 한사랑교회 앞,201906,1361,1401,2762,37.514721,126.8592
양천구,758, 한사랑교회 앞,201907,1452,1470,2922,37.514721,126.8592
양천구,758, 한사랑교회 앞,201908,1348,1458,2806,37.514721,126.8592
양천구,758, 한사랑교회 앞,201909,1265,1326,2591,37.514721,126.8592
양천구,758, 한사랑교회 앞,201910,1509,1594,3103,37.514721,126.8592
양천구,758, 한사랑교회 앞,201911,968,1045,2013,37.514721,126.8592
양천구,758, 한사랑교회 앞,201912,519,578,1097,37.514721,126.8592
양천구,758, 한사랑교회 앞,202001,465,521,986,37.514721,126.8592
양천구,758, 한사랑교회 앞,202002,474,467,941,37.514721,126.8592
양천구,758, 한사랑교회 앞,202003,878,872,1750,37.514721,126.8592
양천구,758, 한사랑교회 앞,202004,1549,1637,3186,37.514721,126.8592
양천구,758, 한사랑교회 앞,202005,2054,2100,4154,37.514721,126.8592
양천구,758, 한사랑교회 앞,202006,2246,2370,4616,37.514721,126.8592
양천구,759, 보아스아파트 앞,201901,100,72,172,37.524071,126.8386
양천구,759, 보아스아파트 앞,201902,68,56,124,37.524071,126.8386
양천구,759, 보아스아파트 앞,201903,147,141,288,37.524071,126.8386
양천구,759, 보아스아파트 앞,201904,243,245,488,37.524071,126.8386
양천구,759, 보아스아파트 앞,201905,358,421,779,37.524071,126.8386
양천구,759, 보아스아파트 앞,201906,450,548,998,37.524071,126.8386
양천구,759, 보아스아파트 앞,201907,503,641,1144,37.524071,126.8386
양천구,759, 보아스아파트 앞,201908,512,649,1161,37.524071,126.8386
양천구,759, 보아스아파트 앞,201909,494,577,1071,37.524071,126.8386
양천구,759, 보아스아파트 앞,201910,683,777,1460,37.524071,126.8386
양천구,759, 보아스아파트 앞,201911,454,480,934,37.524071,126.8386
양천구,759, 보아스아파트 앞,201912,305,337,642,37.524071,126.8386
양천구,759, 보아스아파트 앞,202001,317,297,614,37.524071,126.8386
양천구,759, 보아스아파트 앞,202002,265,291,556,37.524071,126.8386
양천구,759, 보아스아파트 앞,202003,418,443,861,37.524071,126.8386
양천구,759, 보아스아파트 앞,202004,722,793,1515,37.524071,126.8386
양천구,759, 보아스아파트 앞,202005,893,956,1849,37.524071,126.8386
양천구,759, 보아스아파트 앞,202006,869,1011,1880,37.524071,126.8386
양천구,760, 잣절보도육교 아래,201901,84,79,163,37.506821,126.844299
양천구,760, 잣절보도육교 아래,201902,71,87,158,37.506821,126.844299
양천구,760, 잣절보도육교 아래,201903,143,113,256,37.506821,126.844299
양천구,760, 잣절보도육교 아래,201904,175,190,365,37.506821,126.844299
양천구,760, 잣절보도육교 아래,201905,331,344,675,37.506821,126.844299
양천구,760, 잣절보도육교 아래,201906,348,381,729,37.506821,126.844299
양천구,760, 잣절보도육교 아래,201907,362,370,732,37.506821,126.844299
양천구,760, 잣절보도육교 아래,201908,395,382,777,37.506821,126.844299
양천구,760, 잣절보도육교 아래,201909,416,412,828,37.506821,126.844299
양천구,760, 잣절보도육교 아래,201910,476,480,956,37.506821,126.844299
양천구,760, 잣절보도육교 아래,201911,338,329,667,37.506821,126.844299
양천구,760, 잣절보도육교 아래,201912,223,209,432,37.506821,126.844299
양천구,760, 잣절보도육교 아래,202001,155,158,313,37.506821,126.844299
양천구,760, 잣절보도육교 아래,202002,147,144,291,37.506821,126.844299
양천구,760, 잣절보도육교 아래,202003,254,265,519,37.506821,126.844299
양천구,760, 잣절보도육교 아래,202004,488,477,965,37.506821,126.844299
양천구,760, 잣절보도육교 아래,202005,642,613,1255,37.506821,126.844299
양천구,760, 잣절보도육교 아래,202006,615,600,1215,37.506821,126.844299
양천구,762, 오목로 무중력지대 앞,201901,164,168,332,37.524551,126.877052
양천구,762, 오목로 무중력지대 앞,201902,156,134,290,37.524551,126.877052
양천구,762, 오목로 무중력지대 앞,201903,368,388,756,37.524551,126.877052
양천구,762, 오목로 무중력지대 앞,201904,892,886,1778,37.524551,126.877052
양천구,762, 오목로 무중력지대 앞,201905,1231,1212,2443,37.524551,126.877052
양천구,762, 오목로 무중력지대 앞,201906,1639,1610,3249,37.524551,126.877052
양천구,762, 오목로 무중력지대 앞,201907,1193,1190,2383,37.524551,126.877052
양천구,762, 오목로 무중력지대 앞,201908,992,999,1991,37.524551,126.877052
양천구,762, 오목로 무중력지대 앞,201909,1056,1078,2134,37.524551,126.877052
양천구,762, 오목로 무중력지대 앞,201910,1259,1275,2534,37.524551,126.877052
양천구,762, 오목로 무중력지대 앞,201911,616,619,1235,37.524551,126.877052
양천구,762, 오목로 무중력지대 앞,201912,292,317,609,37.524551,126.877052
양천구,762, 오목로 무중력지대 앞,202001,281,354,635,37.524551,126.877052
양천구,762, 오목로 무중력지대 앞,202002,372,384,756,37.524551,126.877052
양천구,762, 오목로 무중력지대 앞,202003,1279,1284,2563,37.524551,126.877052
양천구,762, 오목로 무중력지대 앞,202004,2262,2308,4570,37.524551,126.877052
양천구,762, 오목로 무중력지대 앞,202005,2104,2135,4239,37.524551,126.877052
양천구,762, 오목로 무중력지대 앞,202006,1938,1973,3911,37.524551,126.877052
양천구,763, 목동11단지 아파트,201901,116,96,212,37.510658,126.859161
양천구,763, 목동11단지 아파트,201902,99,82,181,37.510658,126.859161
양천구,763, 목동11단지 아파트,201903,187,155,342,37.510658,126.859161
양천구,763, 목동11단지 아파트,201904,323,275,598,37.510658,126.859161
양천구,763, 목동11단지 아파트,201905,430,393,823,37.510658,126.859161
양천구,763, 목동11단지 아파트,201906,610,576,1186,37.510658,126.859161
양천구,763, 목동11단지 아파트,201907,597,603,1200,37.510658,126.859161
양천구,763, 목동11단지 아파트,201908,629,614,1243,37.510658,126.859161
양천구,763, 목동11단지 아파트,201909,634,624,1258,37.510658,126.859161
양천구,763, 목동11단지 아파트,201910,648,623,1271,37.510658,126.859161
양천구,763, 목동11단지 아파트,201911,399,383,782,37.510658,126.859161
양천구,763, 목동11단지 아파트,201912,243,224,467,37.510658,126.859161
양천구,763, 목동11단지 아파트,202001,252,211,463,37.510658,126.859161
양천구,763, 목동11단지 아파트,202002,217,176,393,37.510658,126.859161
양천구,763, 목동11단지 아파트,202003,475,448,923,37.510658,126.859161
양천구,763, 목동11단지 아파트,202004,772,749,1521,37.510658,126.859161
양천구,763, 목동11단지 아파트,202005,873,850,1723,37.510658,126.859161
양천구,763, 목동11단지 아파트,202006,1044,1046,2090,37.510658,126.859161
양천구,764, 목동청소년수련관,201901,352,284,636,37.531029,126.875893
양천구,764, 목동청소년수련관,201902,328,230,558,37.531029,126.875893
양천구,764, 목동청소년수련관,201903,579,398,977,37.531029,126.875893
양천구,764, 목동청소년수련관,201904,989,751,1740,37.531029,126.875893
양천구,764, 목동청소년수련관,201905,1667,1243,2910,37.531029,126.875893
양천구,764, 목동청소년수련관,201906,1876,1440,3316,37.531029,126.875893
양천구,764, 목동청소년수련관,201907,1821,1494,3315,37.531029,126.875893
양천구,764, 목동청소년수련관,201908,2120,1787,3907,37.531029,126.875893
양천구,764, 목동청소년수련관,201909,1708,1494,3202,37.531029,126.875893
양천구,764, 목동청소년수련관,201910,2031,1751,3782,37.531029,126.875893
양천구,764, 목동청소년수련관,201911,1493,1177,2670,37.531029,126.875893
양천구,764, 목동청소년수련관,201912,944,745,1689,37.531029,126.875893
양천구,764, 목동청소년수련관,202001,1017,701,1718,37.531029,126.875893
양천구,764, 목동청소년수련관,202002,1012,739,1751,37.531029,126.875893
양천구,764, 목동청소년수련관,202003,1291,956,2247,37.531029,126.875893
양천구,764, 목동청소년수련관,202004,1831,1456,3287,37.531029,126.875893
양천구,764, 목동청소년수련관,202005,2461,2093,4554,37.531029,126.875893
양천구,764, 목동청소년수련관,202006,2568,2082,4650,37.531029,126.875893
양천구,765, 오목교역 3번출구,201907,1940,1934,3874,37.524776,126.875481
양천구,765, 오목교역 3번출구,201908,2443,2471,4914,37.524776,126.875481
양천구,765, 오목교역 3번출구,201909,2654,2737,5391,37.524776,126.875481
양천구,765, 오목교역 3번출구,201910,3330,3471,6801,37.524776,126.875481
양천구,765, 오목교역 3번출구,201911,2070,2095,4165,37.524776,126.875481
양천구,765, 오목교역 3번출구,201912,1090,1131,2221,37.524776,126.875481
양천구,765, 오목교역 3번출구,202001,1102,1175,2277,37.524776,126.875481
양천구,765, 오목교역 3번출구,202002,1153,1143,2296,37.524776,126.875481
양천구,765, 오목교역 3번출구,202003,2440,2465,4905,37.524776,126.875481
양천구,765, 오목교역 3번출구,202004,3866,3920,7786,37.524776,126.875481
양천구,765, 오목교역 3번출구,202005,4674,4801,9475,37.524776,126.875481
양천구,765, 오목교역 3번출구,202006,4692,4916,9608,37.524776,126.875481
양천구,766, 신목동역 3번출구,201905,15,11,26,37.54426,126.88325
양천구,766, 신목동역 3번출구,201906,1312,1259,2571,37.54426,126.88325
양천구,766, 신목동역 3번출구,201907,1187,1159,2346,37.54426,126.88325
양천구,766, 신목동역 3번출구,201908,1398,1330,2728,37.54426,126.88325
양천구,766, 신목동역 3번출구,201909,1422,1331,2753,37.54426,126.88325
양천구,766, 신목동역 3번출구,201910,1570,1426,2996,37.54426,126.88325
양천구,766, 신목동역 3번출구,201911,812,650,1462,37.54426,126.88325
양천구,766, 신목동역 3번출구,201912,375,282,657,37.54426,126.88325
양천구,766, 신목동역 3번출구,202001,371,298,669,37.54426,126.88325
양천구,766, 신목동역 3번출구,202002,448,370,818,37.54426,126.88325
양천구,766, 신목동역 3번출구,202003,2030,1842,3872,37.54426,126.88325
양천구,766, 신목동역 3번출구,202004,2993,2806,5799,37.54426,126.88325
양천구,766, 신목동역 3번출구,202005,3211,3058,6269,37.54426,126.88325
양천구,766, 신목동역 3번출구,202006,2960,2931,5891,37.54426,126.88325
양천구,767,신정숲속마을아파트,202004,1,1,2,37.505745,126.836311
양천구,767,신정숲속마을아파트,202006,93,69,162,37.505745,126.836311
양천구,768,목동5단지아파트 501동,202004,1,1,2,37.535919,126.882446
양천구,768,목동5단지아파트 501동,202006,487,465,952,37.535919,126.882446
양천구,769,CBS방송국 앞,202004,1,1,2,37.527855,126.874672
양천구,769,CBS방송국 앞,202006,715,645,1360,37.527855,126.874672
양천구,770,목동역5번출구 교통정보센터 앞,202004,7,7,14,37.525715,126.864868
양천구,770,목동역5번출구 교통정보센터 앞,202006,1574,1569,3143,37.525715,126.864868
양천구,771,목동아파트 703동 앞,202004,1,1,2,37.527706,126.870064
양천구,771,목동아파트 703동 앞,202006,826,778,1604,37.527706,126.870064
양천구,773,"염창역 3, 4번 출구 사이",202004,1,1,2,37.546707,126.874573
양천구,773,"염창역 3, 4번 출구 사이",202006,538,503,1041,37.546707,126.874573
양천구,774,등촌역 4번 출구,202004,1,1,2,37.549507,126.867218
양천구,774,등촌역 4번 출구,202006,267,263,530,37.549507,126.867218
양천구,775,세종그랑시아 앞(102동),202004,2,1,3,37.538376,126.863831
양천구,775,세종그랑시아 앞(102동),202006,337,234,571,37.538376,126.863831
양천구,776,목마공원,202006,177,122,299,37.538742,126.885681
양천구,777,신월6차보람아파트 앞,202004,1,1,2,37.530128,126.834778
양천구,777,신월6차보람아파트 앞,202006,413,407,820,37.530128,126.834778
양천구,779,양천나눔누리센터,202004,1,1,2,37.518845,126.853684
양천구,779,양천나눔누리센터,202006,586,596,1182,37.518845,126.853684
양천구,780,신정교 하부,202004,1,1,2,37.516907,126.877586
양천구,780,신정교 하부,202006,949,963,1912,37.516907,126.877586
양천구,781,신정보도육교 아래,202004,2,2,4,37.517593,126.876556
양천구,781,신정보도육교 아래,202006,767,728,1495,37.517593,126.876556
양천구,782,서남병원 후문,202004,2,2,4,37.511673,126.832741
양천구,782,서남병원 후문,202006,313,166,479,37.511673,126.832741
양천구,783,명가원설놀탕 앞(신정4동),202004,1,1,2,#N/A,#N/A
양천구,785,"양천구청, 보건소 사잇길",202004,283,247,530,37.517326,126.866303
양천구,785,"양천구청, 보건소 사잇길",202005,1265,1089,2354,37.517326,126.866303
양천구,785,"양천구청, 보건소 사잇길",202006,1749,1559,3308,37.517326,126.866303
양천구,786,목동아파트 8단지 상가동 앞,202004,2,2,4,37.520439,126.868401
양천구,786,목동아파트 8단지 상가동 앞,202006,598,565,1163,37.520439,126.868401
양천구,787,양천아파트 입구,202004,344,289,633,37.507904,126.862648
양천구,787,양천아파트 입구,202005,1117,1030,2147,37.507904,126.862648
양천구,787,양천아파트 입구,202006,1769,1753,3522,37.507904,126.862648
양천구,788,양천구청역 2번출구 옆,202004,427,297,724,37.512379,126.865555
양천구,788,양천구청역 2번출구 옆,202005,1126,945,2071,37.512379,126.865555
양천구,788,양천구청역 2번출구 옆,202006,1459,1384,2843,37.512379,126.865555
양천구,790,화곡고가 사거리,202004,1,1,2,37.527607,126.848755
양천구,790,화곡고가 사거리,202006,247,206,453,37.527607,126.848755
양천구,791,현대하이페리온,202004,6,6,12,37.52478,126.869835
양천구,791,현대하이페리온,202006,753,706,1459,37.52478,126.869835
양천구,792,목동트라팰리스 웨스턴에비뉴,202004,53,53,106,37.525372,126.870926
양천구,792,목동트라팰리스 웨스턴에비뉴,202006,1265,1141,2406,37.525372,126.870926
양천구,793,목동5단지아파트 534동,202004,1,1,2,37.53355,126.878143
양천구,793,목동5단지아파트 534동,202006,139,113,252,37.53355,126.878143
양천구,794,양천문화회관,202006,125,111,236,37.516842,126.862953
양천구,795,양천 해누리타운,202006,460,440,900,37.515419,126.8638
양천구,797,목동아파트 1422동 1434동 사잇길,202006,644,629,1273,37.515156,126.87249
용산구,800, 목월공원 앞,201901,388,425,813,37.532433,126.954742
용산구,800, 목월공원 앞,201902,422,432,854,37.532433,126.954742
용산구,800, 목월공원 앞,201903,716,817,1533,37.532433,126.954742
용산구,800, 목월공원 앞,201904,985,1073,2058,37.532433,126.954742
용산구,800, 목월공원 앞,201905,1541,1594,3135,37.532433,126.954742
용산구,800, 목월공원 앞,201906,1799,1928,3727,37.532433,126.954742
용산구,800, 목월공원 앞,201907,1627,1743,3370,37.532433,126.954742
용산구,800, 목월공원 앞,201908,1507,1605,3112,37.532433,126.954742
용산구,800, 목월공원 앞,201909,1516,1595,3111,37.532433,126.954742
용산구,800, 목월공원 앞,201910,1695,1764,3459,37.532433,126.954742
용산구,800, 목월공원 앞,201911,1101,1168,2269,37.532433,126.954742
용산구,800, 목월공원 앞,201912,659,728,1387,37.532433,126.954742
용산구,800, 목월공원 앞,202001,654,712,1366,37.532433,126.954742
용산구,800, 목월공원 앞,202002,542,586,1128,37.532433,126.954742
용산구,800, 목월공원 앞,202003,1100,1114,2214,37.532433,126.954742
용산구,800, 목월공원 앞,202004,1493,1526,3019,37.532433,126.954742
용산구,800, 목월공원 앞,202005,1799,1832,3631,37.532433,126.954742
용산구,800, 목월공원 앞,202006,1885,1955,3840,37.532433,126.954742
용산구,802, 한강진역 2번 출구 앞,201901,177,108,285,37.541153,127.002213
용산구,802, 한강진역 2번 출구 앞,201902,147,103,250,37.541153,127.002213
용산구,802, 한강진역 2번 출구 앞,201903,324,184,508,37.541153,127.002213
용산구,802, 한강진역 2번 출구 앞,201904,591,401,992,37.541153,127.002213
용산구,802, 한강진역 2번 출구 앞,201905,720,567,1287,37.541153,127.002213
용산구,802, 한강진역 2번 출구 앞,201906,629,428,1057,37.541153,127.002213
용산구,802, 한강진역 2번 출구 앞,201907,620,366,986,37.541153,127.002213
용산구,802, 한강진역 2번 출구 앞,201908,618,367,985,37.541153,127.002213
용산구,802, 한강진역 2번 출구 앞,201909,617,407,1024,37.541153,127.002213
용산구,802, 한강진역 2번 출구 앞,201910,700,497,1197,37.541153,127.002213
용산구,802, 한강진역 2번 출구 앞,201911,377,231,608,37.541153,127.002213
용산구,802, 한강진역 2번 출구 앞,201912,311,147,458,37.541153,127.002213
용산구,802, 한강진역 2번 출구 앞,202001,267,150,417,37.541153,127.002213
용산구,802, 한강진역 2번 출구 앞,202002,259,177,436,37.541153,127.002213
용산구,802, 한강진역 2번 출구 앞,202003,555,453,1008,37.541153,127.002213
용산구,802, 한강진역 2번 출구 앞,202004,675,561,1236,37.541153,127.002213
용산구,802, 한강진역 2번 출구 앞,202005,542,412,954,37.541153,127.002213
용산구,802, 한강진역 2번 출구 앞,202006,490,372,862,37.541153,127.002213
용산구,803, 한남초교 앞 보도육교,201901,88,86,174,37.538139,127.004097
용산구,803, 한남초교 앞 보도육교,201902,81,93,174,37.538139,127.004097
용산구,803, 한남초교 앞 보도육교,201903,143,174,317,37.538139,127.004097
용산구,803, 한남초교 앞 보도육교,201904,355,385,740,37.538139,127.004097
용산구,803, 한남초교 앞 보도육교,201905,436,438,874,37.538139,127.004097
용산구,803, 한남초교 앞 보도육교,201906,464,458,922,37.538139,127.004097
용산구,803, 한남초교 앞 보도육교,201907,394,401,795,37.538139,127.004097
용산구,803, 한남초교 앞 보도육교,201908,409,412,821,37.538139,127.004097
용산구,803, 한남초교 앞 보도육교,201909,455,451,906,37.538139,127.004097
용산구,803, 한남초교 앞 보도육교,201910,458,472,930,37.538139,127.004097
용산구,803, 한남초교 앞 보도육교,201911,239,267,506,37.538139,127.004097
용산구,803, 한남초교 앞 보도육교,201912,107,148,255,37.538139,127.004097
용산구,803, 한남초교 앞 보도육교,202001,97,155,252,37.538139,127.004097
용산구,803, 한남초교 앞 보도육교,202002,113,169,282,37.538139,127.004097
용산구,803, 한남초교 앞 보도육교,202003,402,432,834,37.538139,127.004097
용산구,803, 한남초교 앞 보도육교,202004,576,621,1197,37.538139,127.004097
용산구,803, 한남초교 앞 보도육교,202005,507,503,1010,37.538139,127.004097
용산구,803, 한남초교 앞 보도육교,202006,416,411,827,37.538139,127.004097
용산구,805, 문배어린이공원 앞,201901,288,326,614,37.536758,126.970001
용산구,805, 문배어린이공원 앞,201902,219,289,508,37.536758,126.970001
용산구,805, 문배어린이공원 앞,201903,416,525,941,37.536758,126.970001
용산구,805, 문배어린이공원 앞,201904,442,531,973,37.536758,126.970001
용산구,805, 문배어린이공원 앞,201905,384,388,772,37.536758,126.970001
용산구,805, 문배어린이공원 앞,201906,1306,1322,2628,37.536758,126.970001
용산구,805, 문배어린이공원 앞,201907,1126,1305,2431,37.536758,126.970001
용산구,805, 문배어린이공원 앞,201908,1166,1304,2470,37.536758,126.970001
용산구,805, 문배어린이공원 앞,201909,1224,1279,2503,37.536758,126.970001
용산구,805, 문배어린이공원 앞,201910,1446,1552,2998,37.536758,126.970001
용산구,805, 문배어린이공원 앞,201911,939,972,1911,37.536758,126.970001
용산구,805, 문배어린이공원 앞,201912,527,603,1130,37.536758,126.970001
용산구,805, 문배어린이공원 앞,202001,512,608,1120,37.536758,126.970001
용산구,805, 문배어린이공원 앞,202002,496,522,1018,37.536758,126.970001
용산구,805, 문배어린이공원 앞,202003,866,921,1787,37.536758,126.970001
용산구,805, 문배어린이공원 앞,202004,1085,1096,2181,37.536758,126.970001
용산구,805, 문배어린이공원 앞,202005,1133,1128,2261,37.536758,126.970001
용산구,805, 문배어린이공원 앞,202006,1215,1230,2445,37.536758,126.970001
용산구,806, 전자랜드 본관 앞,201901,363,357,720,37.533066,126.960732
용산구,806, 전자랜드 본관 앞,201902,343,335,678,37.533066,126.960732
용산구,806, 전자랜드 본관 앞,201903,522,472,994,37.533066,126.960732
용산구,806, 전자랜드 본관 앞,201904,781,758,1539,37.533066,126.960732
용산구,806, 전자랜드 본관 앞,201905,1251,1162,2413,37.533066,126.960732
용산구,806, 전자랜드 본관 앞,201906,1357,1317,2674,37.533066,126.960732
용산구,806, 전자랜드 본관 앞,201907,1202,1189,2391,37.533066,126.960732
용산구,806, 전자랜드 본관 앞,201908,1149,1096,2245,37.533066,126.960732
용산구,806, 전자랜드 본관 앞,201909,1031,1025,2056,37.533066,126.960732
용산구,806, 전자랜드 본관 앞,201910,1411,1392,2803,37.533066,126.960732
용산구,806, 전자랜드 본관 앞,201911,835,872,1707,37.533066,126.960732
용산구,806, 전자랜드 본관 앞,201912,561,511,1072,37.533066,126.960732
용산구,806, 전자랜드 본관 앞,202001,443,448,891,37.533066,126.960732
용산구,806, 전자랜드 본관 앞,202002,425,390,815,37.533066,126.960732
용산구,806, 전자랜드 본관 앞,202003,675,666,1341,37.533066,126.960732
용산구,806, 전자랜드 본관 앞,202004,993,963,1956,37.533066,126.960732
용산구,806, 전자랜드 본관 앞,202005,1102,1091,2193,37.533066,126.960732
용산구,806, 전자랜드 본관 앞,202006,1192,1150,2342,37.533066,126.960732
용산구,807, 서울역 12번 출구 앞,201901,271,248,519,37.552277,126.972687
용산구,807, 서울역 12번 출구 앞,201902,262,254,516,37.552277,126.972687
용산구,807, 서울역 12번 출구 앞,201903,469,450,919,37.552277,126.972687
용산구,807, 서울역 12번 출구 앞,201904,710,676,1386,37.552277,126.972687
용산구,807, 서울역 12번 출구 앞,201905,858,857,1715,37.552277,126.972687
용산구,807, 서울역 12번 출구 앞,201906,926,927,1853,37.552277,126.972687
용산구,807, 서울역 12번 출구 앞,201907,945,889,1834,37.552277,126.972687
용산구,807, 서울역 12번 출구 앞,201908,837,776,1613,37.552277,126.972687
용산구,807, 서울역 12번 출구 앞,201909,904,894,1798,37.552277,126.972687
용산구,807, 서울역 12번 출구 앞,201910,1177,1190,2367,37.552277,126.972687
용산구,807, 서울역 12번 출구 앞,201911,726,718,1444,37.552277,126.972687
용산구,807, 서울역 12번 출구 앞,201912,467,454,921,37.552277,126.972687
용산구,807, 서울역 12번 출구 앞,202001,389,403,792,37.552277,126.972687
용산구,807, 서울역 12번 출구 앞,202002,425,387,812,37.552277,126.972687
용산구,807, 서울역 12번 출구 앞,202003,657,644,1301,37.552277,126.972687
용산구,807, 서울역 12번 출구 앞,202004,995,982,1977,37.552277,126.972687
용산구,807, 서울역 12번 출구 앞,202005,965,948,1913,37.552277,126.972687
용산구,807, 서울역 12번 출구 앞,202006,966,956,1922,37.552277,126.972687
용산구,808, 서빙고동 금호맨션 앞,201901,96,95,191,37.520504,126.989738
용산구,808, 서빙고동 금호맨션 앞,201902,95,82,177,37.520504,126.989738
용산구,808, 서빙고동 금호맨션 앞,201903,183,190,373,37.520504,126.989738
용산구,808, 서빙고동 금호맨션 앞,201904,358,385,743,37.520504,126.989738
용산구,808, 서빙고동 금호맨션 앞,201905,552,613,1165,37.520504,126.989738
용산구,808, 서빙고동 금호맨션 앞,201906,545,549,1094,37.520504,126.989738
용산구,808, 서빙고동 금호맨션 앞,201907,395,417,812,37.520504,126.989738
용산구,808, 서빙고동 금호맨션 앞,201908,468,509,977,37.520504,126.989738
용산구,808, 서빙고동 금호맨션 앞,201909,516,543,1059,37.520504,126.989738
용산구,808, 서빙고동 금호맨션 앞,201910,550,573,1123,37.520504,126.989738
용산구,808, 서빙고동 금호맨션 앞,201911,297,311,608,37.520504,126.989738
용산구,808, 서빙고동 금호맨션 앞,201912,125,107,232,37.520504,126.989738
용산구,808, 서빙고동 금호맨션 앞,202001,122,105,227,37.520504,126.989738
용산구,808, 서빙고동 금호맨션 앞,202002,112,120,232,37.520504,126.989738
용산구,808, 서빙고동 금호맨션 앞,202003,439,447,886,37.520504,126.989738
용산구,808, 서빙고동 금호맨션 앞,202004,612,636,1248,37.520504,126.989738
용산구,808, 서빙고동 금호맨션 앞,202005,679,668,1347,37.520504,126.989738
용산구,808, 서빙고동 금호맨션 앞,202006,501,498,999,37.520504,126.989738
용산구,809, 한남 유수지 복개주차장,201901,131,190,321,37.530167,127.007439
용산구,809, 한남 유수지 복개주차장,201902,161,185,346,37.530167,127.007439
용산구,809, 한남 유수지 복개주차장,201903,344,396,740,37.530167,127.007439
용산구,809, 한남 유수지 복개주차장,201904,645,714,1359,37.530167,127.007439
용산구,809, 한남 유수지 복개주차장,201905,1097,1127,2224,37.530167,127.007439
용산구,809, 한남 유수지 복개주차장,201906,981,1033,2014,37.530167,127.007439
용산구,809, 한남 유수지 복개주차장,201907,812,841,1653,37.530167,127.007439
용산구,809, 한남 유수지 복개주차장,201908,889,941,1830,37.530167,127.007439
용산구,809, 한남 유수지 복개주차장,201909,970,987,1957,37.530167,127.007439
용산구,809, 한남 유수지 복개주차장,201910,1043,1101,2144,37.530167,127.007439
용산구,809, 한남 유수지 복개주차장,201911,463,545,1008,37.530167,127.007439
용산구,809, 한남 유수지 복개주차장,201912,262,303,565,37.530167,127.007439
용산구,809, 한남 유수지 복개주차장,202001,235,327,562,37.530167,127.007439
용산구,809, 한남 유수지 복개주차장,202002,286,347,633,37.530167,127.007439
용산구,809, 한남 유수지 복개주차장,202003,1015,1050,2065,37.530167,127.007439
용산구,809, 한남 유수지 복개주차장,202004,1401,1454,2855,37.530167,127.007439
용산구,809, 한남 유수지 복개주차장,202005,1438,1444,2882,37.530167,127.007439
용산구,809, 한남 유수지 복개주차장,202006,1209,1189,2398,37.530167,127.007439
용산구,810, 이태원지하보도,201901,154,143,297,37.53841,126.986649
용산구,810, 이태원지하보도,201902,144,137,281,37.53841,126.986649
용산구,810, 이태원지하보도,201903,274,258,532,37.53841,126.986649
용산구,810, 이태원지하보도,201904,448,436,884,37.53841,126.986649
용산구,810, 이태원지하보도,201905,584,589,1173,37.53841,126.986649
용산구,810, 이태원지하보도,201906,605,591,1196,37.53841,126.986649
용산구,810, 이태원지하보도,201907,471,458,929,37.53841,126.986649
용산구,810, 이태원지하보도,201908,483,478,961,37.53841,126.986649
용산구,810, 이태원지하보도,201909,446,441,887,37.53841,126.986649
용산구,810, 이태원지하보도,201910,544,547,1091,37.53841,126.986649
용산구,810, 이태원지하보도,201911,360,343,703,37.53841,126.986649
용산구,810, 이태원지하보도,201912,274,207,481,37.53841,126.986649
용산구,810, 이태원지하보도,202001,275,208,483,37.53841,126.986649
용산구,810, 이태원지하보도,202002,213,166,379,37.53841,126.986649
용산구,810, 이태원지하보도,202003,541,530,1071,37.53841,126.986649
용산구,810, 이태원지하보도,202004,795,785,1580,37.53841,126.986649
용산구,810, 이태원지하보도,202005,633,637,1270,37.53841,126.986649
용산구,810, 이태원지하보도,202006,654,647,1301,37.53841,126.986649
용산구,811, 녹사평역1번출구,201901,226,100,326,37.53508,126.985382
용산구,811, 녹사평역1번출구,201902,228,110,338,37.53508,126.985382
용산구,811, 녹사평역1번출구,201903,413,199,612,37.53508,126.985382
용산구,811, 녹사평역1번출구,201904,531,271,802,37.53508,126.985382
용산구,811, 녹사평역1번출구,201905,684,453,1137,37.53508,126.985382
용산구,811, 녹사평역1번출구,201906,656,480,1136,37.53508,126.985382
용산구,811, 녹사평역1번출구,201907,771,408,1179,37.53508,126.985382
용산구,811, 녹사평역1번출구,201908,598,300,898,37.53508,126.985382
용산구,811, 녹사평역1번출구,201909,595,334,929,37.53508,126.985382
용산구,811, 녹사평역1번출구,201910,590,427,1017,37.53508,126.985382
용산구,811, 녹사평역1번출구,201911,426,211,637,37.53508,126.985382
용산구,811, 녹사평역1번출구,201912,426,125,551,37.53508,126.985382
용산구,811, 녹사평역1번출구,202001,347,111,458,37.53508,126.985382
용산구,811, 녹사평역1번출구,202002,328,96,424,37.53508,126.985382
용산구,811, 녹사평역1번출구,202003,610,286,896,37.53508,126.985382
용산구,811, 녹사평역1번출구,202004,634,396,1030,37.53508,126.985382
용산구,811, 녹사평역1번출구,202005,566,279,845,37.53508,126.985382
용산구,811, 녹사평역1번출구,202006,525,226,751,37.53508,126.985382
용산구,812, 용산전쟁기념관,201901,118,150,268,37.53484,126.977661
용산구,812, 용산전쟁기념관,201902,102,141,243,37.53484,126.977661
용산구,812, 용산전쟁기념관,201903,209,237,446,37.53484,126.977661
용산구,812, 용산전쟁기념관,201904,469,445,914,37.53484,126.977661
용산구,812, 용산전쟁기념관,201905,531,507,1038,37.53484,126.977661
용산구,812, 용산전쟁기념관,201906,538,478,1016,37.53484,126.977661
용산구,812, 용산전쟁기념관,201907,515,518,1033,37.53484,126.977661
용산구,812, 용산전쟁기념관,201908,622,628,1250,37.53484,126.977661
용산구,812, 용산전쟁기념관,201909,556,546,1102,37.53484,126.977661
용산구,812, 용산전쟁기념관,201910,601,565,1166,37.53484,126.977661
용산구,812, 용산전쟁기념관,201911,378,375,753,37.53484,126.977661
용산구,812, 용산전쟁기념관,201912,237,221,458,37.53484,126.977661
용산구,812, 용산전쟁기념관,202001,191,201,392,37.53484,126.977661
용산구,812, 용산전쟁기념관,202002,171,185,356,37.53484,126.977661
용산구,812, 용산전쟁기념관,202003,382,370,752,37.53484,126.977661
용산구,812, 용산전쟁기념관,202004,412,406,818,37.53484,126.977661
용산구,812, 용산전쟁기념관,202005,252,243,495,37.53484,126.977661
용산구,812, 용산전쟁기념관,202006,178,172,350,37.53484,126.977661
용산구,813, 삼각지역 3번출구,201901,268,344,612,37.533512,126.972275
용산구,813, 삼각지역 3번출구,201902,267,285,552,37.533512,126.972275
용산구,813, 삼각지역 3번출구,201903,475,543,1018,37.533512,126.972275
용산구,813, 삼각지역 3번출구,201904,726,735,1461,37.533512,126.972275
용산구,813, 삼각지역 3번출구,201905,1216,1099,2315,37.533512,126.972275
용산구,813, 삼각지역 3번출구,201906,1332,1206,2538,37.533512,126.972275
용산구,813, 삼각지역 3번출구,201907,1205,1122,2327,37.533512,126.972275
용산구,813, 삼각지역 3번출구,201908,1180,1113,2293,37.533512,126.972275
용산구,813, 삼각지역 3번출구,201909,1217,1166,2383,37.533512,126.972275
용산구,813, 삼각지역 3번출구,201910,1422,1382,2804,37.533512,126.972275
용산구,813, 삼각지역 3번출구,201911,817,837,1654,37.533512,126.972275
용산구,813, 삼각지역 3번출구,201912,424,485,909,37.533512,126.972275
용산구,813, 삼각지역 3번출구,202001,358,491,849,37.533512,126.972275
용산구,813, 삼각지역 3번출구,202002,431,436,867,37.533512,126.972275
용산구,813, 삼각지역 3번출구,202003,819,778,1597,37.533512,126.972275
용산구,813, 삼각지역 3번출구,202004,1100,996,2096,37.533512,126.972275
용산구,813, 삼각지역 3번출구,202005,1117,1023,2140,37.533512,126.972275
용산구,813, 삼각지역 3번출구,202006,1117,1022,2139,37.533512,126.972275
용산구,815, LIG강촌아파트 103동앞,201901,282,264,546,37.518509,126.978798
용산구,815, LIG강촌아파트 103동앞,201902,324,299,623,37.518509,126.978798
용산구,815, LIG강촌아파트 103동앞,201903,590,551,1141,37.518509,126.978798
용산구,815, LIG강촌아파트 103동앞,201904,1034,1114,2148,37.518509,126.978798
용산구,815, LIG강촌아파트 103동앞,201905,1708,1892,3600,37.518509,126.978798
용산구,815, LIG강촌아파트 103동앞,201906,1800,1896,3696,37.518509,126.978798
용산구,815, LIG강촌아파트 103동앞,201907,1569,1597,3166,37.518509,126.978798
용산구,815, LIG강촌아파트 103동앞,201908,1635,1702,3337,37.518509,126.978798
용산구,815, LIG강촌아파트 103동앞,201909,1647,1710,3357,37.518509,126.978798
용산구,815, LIG강촌아파트 103동앞,201910,1888,1992,3880,37.518509,126.978798
용산구,815, LIG강촌아파트 103동앞,201911,905,1039,1944,37.518509,126.978798
용산구,815, LIG강촌아파트 103동앞,201912,572,546,1118,37.518509,126.978798
용산구,815, LIG강촌아파트 103동앞,202001,490,498,988,37.518509,126.978798
용산구,815, LIG강촌아파트 103동앞,202002,492,526,1018,37.518509,126.978798
용산구,815, LIG강촌아파트 103동앞,202003,1382,1363,2745,37.518509,126.978798
용산구,815, LIG강촌아파트 103동앞,202004,2009,2032,4041,37.518509,126.978798
용산구,815, LIG강촌아파트 103동앞,202005,2488,2477,4965,37.518509,126.978798
용산구,815, LIG강촌아파트 103동앞,202006,2150,2234,4384,37.518509,126.978798
용산구,816, 신용산역 6번출구 앞,201901,621,803,1424,37.530148,126.968483
용산구,816, 신용산역 6번출구 앞,201902,680,794,1474,37.530148,126.968483
용산구,816, 신용산역 6번출구 앞,201903,1258,1423,2681,37.530148,126.968483
용산구,816, 신용산역 6번출구 앞,201904,1945,1983,3928,37.530148,126.968483
용산구,816, 신용산역 6번출구 앞,201905,3420,3422,6842,37.530148,126.968483
용산구,816, 신용산역 6번출구 앞,201906,3863,3867,7730,37.530148,126.968483
용산구,816, 신용산역 6번출구 앞,201907,2975,2991,5966,37.530148,126.968483
용산구,816, 신용산역 6번출구 앞,201908,2091,2080,4171,37.530148,126.968483
용산구,816, 신용산역 6번출구 앞,201909,2909,2933,5842,37.530148,126.968483
용산구,816, 신용산역 6번출구 앞,201910,3660,3705,7365,37.530148,126.968483
용산구,816, 신용산역 6번출구 앞,201911,2072,2112,4184,37.530148,126.968483
용산구,816, 신용산역 6번출구 앞,201912,1202,1307,2509,37.530148,126.968483
용산구,816, 신용산역 6번출구 앞,202001,981,1072,2053,37.530148,126.968483
용산구,816, 신용산역 6번출구 앞,202002,1012,1108,2120,37.530148,126.968483
용산구,816, 신용산역 6번출구 앞,202003,2174,2170,4344,37.530148,126.968483
용산구,816, 신용산역 6번출구 앞,202004,2936,2932,5868,37.530148,126.968483
용산구,816, 신용산역 6번출구 앞,202005,3159,3170,6329,37.530148,126.968483
용산구,816, 신용산역 6번출구 앞,202006,2841,2828,5669,37.530148,126.968483
용산구,817, 삼각지역 4번출구 앞,201901,148,210,358,37.533451,126.971733
용산구,817, 삼각지역 4번출구 앞,201902,137,172,309,37.533451,126.971733
용산구,817, 삼각지역 4번출구 앞,201903,327,340,667,37.533451,126.971733
용산구,817, 삼각지역 4번출구 앞,201904,536,543,1079,37.533451,126.971733
용산구,817, 삼각지역 4번출구 앞,201905,728,717,1445,37.533451,126.971733
용산구,817, 삼각지역 4번출구 앞,201906,695,688,1383,37.533451,126.971733
용산구,817, 삼각지역 4번출구 앞,201907,712,699,1411,37.533451,126.971733
용산구,817, 삼각지역 4번출구 앞,201908,773,772,1545,37.533451,126.971733
용산구,817, 삼각지역 4번출구 앞,201909,720,706,1426,37.533451,126.971733
용산구,817, 삼각지역 4번출구 앞,201910,773,774,1547,37.533451,126.971733
용산구,817, 삼각지역 4번출구 앞,201911,523,527,1050,37.533451,126.971733
용산구,817, 삼각지역 4번출구 앞,201912,304,337,641,37.533451,126.971733
용산구,817, 삼각지역 4번출구 앞,202001,237,285,522,37.533451,126.971733
용산구,817, 삼각지역 4번출구 앞,202002,252,264,516,37.533451,126.971733
용산구,817, 삼각지역 4번출구 앞,202003,546,526,1072,37.533451,126.971733
용산구,817, 삼각지역 4번출구 앞,202004,687,682,1369,37.533451,126.971733
용산구,817, 삼각지역 4번출구 앞,202005,641,638,1279,37.533451,126.971733
용산구,817, 삼각지역 4번출구 앞,202006,635,626,1261,37.533451,126.971733
용산구,818, 숙명여대 입구 교차로,201901,413,403,816,37.544895,126.969383
용산구,818, 숙명여대 입구 교차로,201902,332,365,697,37.544895,126.969383
용산구,818, 숙명여대 입구 교차로,201903,697,682,1379,37.544895,126.969383
용산구,818, 숙명여대 입구 교차로,201904,996,1046,2042,37.544895,126.969383
용산구,818, 숙명여대 입구 교차로,201905,1515,1507,3022,37.544895,126.969383
용산구,818, 숙명여대 입구 교차로,201906,1724,1732,3456,37.544895,126.969383
용산구,818, 숙명여대 입구 교차로,201907,1508,1569,3077,37.544895,126.969383
용산구,818, 숙명여대 입구 교차로,201908,1441,1518,2959,37.544895,126.969383
용산구,818, 숙명여대 입구 교차로,201909,1477,1480,2957,37.544895,126.969383
용산구,818, 숙명여대 입구 교차로,201910,1746,1763,3509,37.544895,126.969383
용산구,818, 숙명여대 입구 교차로,201911,1050,1049,2099,37.544895,126.969383
용산구,818, 숙명여대 입구 교차로,201912,573,704,1277,37.544895,126.969383
용산구,818, 숙명여대 입구 교차로,202001,487,457,944,37.544895,126.969383
용산구,818, 숙명여대 입구 교차로,202002,448,477,925,37.544895,126.969383
용산구,818, 숙명여대 입구 교차로,202003,866,872,1738,37.544895,126.969383
용산구,818, 숙명여대 입구 교차로,202004,1449,1509,2958,37.544895,126.969383
용산구,818, 숙명여대 입구 교차로,202005,1509,1523,3032,37.544895,126.969383
용산구,818, 숙명여대 입구 교차로,202006,1585,1587,3172,37.544895,126.969383
용산구,819, 선린인터넷 고등학교,201901,195,251,446,37.541653,126.970505
용산구,819, 선린인터넷 고등학교,201902,198,237,435,37.541653,126.970505
용산구,819, 선린인터넷 고등학교,201903,384,419,803,37.541653,126.970505
용산구,819, 선린인터넷 고등학교,201904,651,716,1367,37.541653,126.970505
용산구,819, 선린인터넷 고등학교,201905,1213,1226,2439,37.541653,126.970505
용산구,819, 선린인터넷 고등학교,201906,1139,1147,2286,37.541653,126.970505
용산구,819, 선린인터넷 고등학교,201907,1058,1080,2138,37.541653,126.970505
용산구,819, 선린인터넷 고등학교,201908,964,947,1911,37.541653,126.970505
용산구,819, 선린인터넷 고등학교,201909,964,974,1938,37.541653,126.970505
용산구,819, 선린인터넷 고등학교,201910,1122,1111,2233,37.541653,126.970505
용산구,819, 선린인터넷 고등학교,201911,762,787,1549,37.541653,126.970505
용산구,819, 선린인터넷 고등학교,201912,435,499,934,37.541653,126.970505
용산구,819, 선린인터넷 고등학교,202001,346,449,795,37.541653,126.970505
용산구,819, 선린인터넷 고등학교,202002,320,330,650,37.541653,126.970505
용산구,819, 선린인터넷 고등학교,202003,653,643,1296,37.541653,126.970505
용산구,819, 선린인터넷 고등학교,202004,1063,1049,2112,37.541653,126.970505
용산구,819, 선린인터넷 고등학교,202005,1043,1062,2105,37.541653,126.970505
용산구,819, 선린인터넷 고등학교,202006,1188,1161,2349,37.541653,126.970505
용산구,820, 청파동입구 교차로,201901,213,234,447,37.549026,126.971947
용산구,820, 청파동입구 교차로,201902,169,181,350,37.549026,126.971947
용산구,820, 청파동입구 교차로,201903,377,390,767,37.549026,126.971947
용산구,820, 청파동입구 교차로,201904,613,652,1265,37.549026,126.971947
용산구,820, 청파동입구 교차로,201905,809,805,1614,37.549026,126.971947
용산구,820, 청파동입구 교차로,201906,911,903,1814,37.549026,126.971947
용산구,820, 청파동입구 교차로,201907,969,886,1855,37.549026,126.971947
용산구,820, 청파동입구 교차로,201908,865,779,1644,37.549026,126.971947
용산구,820, 청파동입구 교차로,201909,815,765,1580,37.549026,126.971947
용산구,820, 청파동입구 교차로,201910,984,948,1932,37.549026,126.971947
용산구,820, 청파동입구 교차로,201911,643,617,1260,37.549026,126.971947
용산구,820, 청파동입구 교차로,201912,357,395,752,37.549026,126.971947
용산구,820, 청파동입구 교차로,202001,328,335,663,37.549026,126.971947
용산구,820, 청파동입구 교차로,202002,306,297,603,37.549026,126.971947
용산구,820, 청파동입구 교차로,202003,571,555,1126,37.549026,126.971947
용산구,820, 청파동입구 교차로,202004,793,765,1558,37.549026,126.971947
용산구,820, 청파동입구 교차로,202005,828,799,1627,37.549026,126.971947
용산구,820, 청파동입구 교차로,202006,1022,968,1990,37.549026,126.971947
용산구,822, 이촌1동 마을공원,201901,96,82,178,37.522041,126.965523
용산구,822, 이촌1동 마을공원,201902,86,88,174,37.522041,126.965523
용산구,822, 이촌1동 마을공원,201903,199,180,379,37.522041,126.965523
용산구,822, 이촌1동 마을공원,201904,300,259,559,37.522041,126.965523
용산구,822, 이촌1동 마을공원,201905,501,450,951,37.522041,126.965523
용산구,822, 이촌1동 마을공원,201906,459,429,888,37.522041,126.965523
용산구,822, 이촌1동 마을공원,201907,397,386,783,37.522041,126.965523
용산구,822, 이촌1동 마을공원,201908,348,334,682,37.522041,126.965523
용산구,822, 이촌1동 마을공원,201909,406,407,813,37.522041,126.965523
용산구,822, 이촌1동 마을공원,201910,505,505,1010,37.522041,126.965523
용산구,822, 이촌1동 마을공원,201911,281,260,541,37.522041,126.965523
용산구,822, 이촌1동 마을공원,201912,184,138,322,37.522041,126.965523
용산구,822, 이촌1동 마을공원,202001,180,146,326,37.522041,126.965523
용산구,822, 이촌1동 마을공원,202002,172,148,320,37.522041,126.965523
용산구,822, 이촌1동 마을공원,202003,363,345,708,37.522041,126.965523
용산구,822, 이촌1동 마을공원,202004,591,590,1181,37.522041,126.965523
용산구,822, 이촌1동 마을공원,202005,614,603,1217,37.522041,126.965523
용산구,822, 이촌1동 마을공원,202006,524,523,1047,37.522041,126.965523
용산구,823, 효창동주민센터 앞,201901,122,94,216,37.54232,126.96196
용산구,823, 효창동주민센터 앞,201902,117,78,195,37.54232,126.96196
용산구,823, 효창동주민센터 앞,201903,255,165,420,37.54232,126.96196
용산구,823, 효창동주민센터 앞,201904,368,266,634,37.54232,126.96196
용산구,823, 효창동주민센터 앞,201905,445,374,819,37.54232,126.96196
용산구,823, 효창동주민센터 앞,201906,408,351,759,37.54232,126.96196
용산구,823, 효창동주민센터 앞,201907,368,309,677,37.54232,126.96196
용산구,823, 효창동주민센터 앞,201908,311,253,564,37.54232,126.96196
용산구,823, 효창동주민센터 앞,201909,291,249,540,37.54232,126.96196
용산구,823, 효창동주민센터 앞,201910,390,330,720,37.54232,126.96196
용산구,823, 효창동주민센터 앞,201911,271,214,485,37.54232,126.96196
용산구,823, 효창동주민센터 앞,201912,163,132,295,37.54232,126.96196
용산구,823, 효창동주민센터 앞,202001,123,91,214,37.54232,126.96196
용산구,823, 효창동주민센터 앞,202002,108,81,189,37.54232,126.96196
용산구,823, 효창동주민센터 앞,202003,215,173,388,37.54232,126.96196
용산구,823, 효창동주민센터 앞,202004,263,247,510,37.54232,126.96196
용산구,823, 효창동주민센터 앞,202005,291,296,587,37.54232,126.96196
용산구,823, 효창동주민센터 앞,202006,327,290,617,37.54232,126.96196
용산구,825, 서빙고동 주민센터 앞,201901,394,375,769,37.520336,126.994263
용산구,825, 서빙고동 주민센터 앞,201902,358,416,774,37.520336,126.994263
용산구,825, 서빙고동 주민센터 앞,201903,849,936,1785,37.520336,126.994263
용산구,825, 서빙고동 주민센터 앞,201904,1641,1947,3588,37.520336,126.994263
용산구,825, 서빙고동 주민센터 앞,201905,2937,3337,6274,37.520336,126.994263
용산구,825, 서빙고동 주민센터 앞,201906,3074,3452,6526,37.520336,126.994263
용산구,825, 서빙고동 주민센터 앞,201907,2458,2811,5269,37.520336,126.994263
용산구,825, 서빙고동 주민센터 앞,201908,3084,3475,6559,37.520336,126.994263
용산구,825, 서빙고동 주민센터 앞,201909,3084,3416,6500,37.520336,126.994263
용산구,825, 서빙고동 주민센터 앞,201910,3292,3703,6995,37.520336,126.994263
용산구,825, 서빙고동 주민센터 앞,201911,1308,1423,2731,37.520336,126.994263
용산구,825, 서빙고동 주민센터 앞,201912,535,557,1092,37.520336,126.994263
용산구,825, 서빙고동 주민센터 앞,202001,595,651,1246,37.520336,126.994263
용산구,825, 서빙고동 주민센터 앞,202002,748,844,1592,37.520336,126.994263
용산구,825, 서빙고동 주민센터 앞,202003,3250,3875,7125,37.520336,126.994263
용산구,825, 서빙고동 주민센터 앞,202004,4210,4884,9094,37.520336,126.994263
용산구,825, 서빙고동 주민센터 앞,202005,5005,5362,10367,37.520336,126.994263
용산구,825, 서빙고동 주민센터 앞,202006,4303,4569,8872,37.520336,126.994263
중구,826, 서울역 서부교차로2,201901,358,430,788,37.555367,126.968643
중구,826, 서울역 서부교차로2,201902,354,374,728,37.555367,126.968643
중구,826, 서울역 서부교차로2,201903,671,678,1349,37.555367,126.968643
중구,826, 서울역 서부교차로2,201904,1010,977,1987,37.555367,126.968643
중구,826, 서울역 서부교차로2,201905,1406,1344,2750,37.555367,126.968643
중구,826, 서울역 서부교차로2,201906,1240,1188,2428,37.555367,126.968643
중구,826, 서울역 서부교차로2,201907,1228,1210,2438,37.555367,126.968643
중구,826, 서울역 서부교차로2,201908,1085,1085,2170,37.555367,126.968643
중구,826, 서울역 서부교차로2,201909,1134,1115,2249,37.555367,126.968643
중구,826, 서울역 서부교차로2,201910,1404,1352,2756,37.555367,126.968643
중구,826, 서울역 서부교차로2,201911,981,1070,2051,37.555367,126.968643
중구,826, 서울역 서부교차로2,201912,599,671,1270,37.555367,126.968643
중구,826, 서울역 서부교차로2,202001,512,584,1096,37.555367,126.968643
중구,826, 서울역 서부교차로2,202002,478,569,1047,37.555367,126.968643
중구,826, 서울역 서부교차로2,202003,819,840,1659,37.555367,126.968643
중구,826, 서울역 서부교차로2,202004,1307,1282,2589,37.555367,126.968643
중구,826, 서울역 서부교차로2,202005,1339,1305,2644,37.555367,126.968643
중구,826, 서울역 서부교차로2,202006,1469,1345,2814,37.555367,126.968643
용산구,827, 국군복지단,201901,228,164,392,37.541885,126.97966
용산구,827, 국군복지단,201902,188,135,323,37.541885,126.97966
용산구,827, 국군복지단,201903,275,206,481,37.541885,126.97966
용산구,827, 국군복지단,201904,375,325,700,37.541885,126.97966
용산구,827, 국군복지단,201905,309,306,615,37.541885,126.97966
용산구,827, 국군복지단,201906,425,427,852,37.541885,126.97966
용산구,827, 국군복지단,201907,372,294,666,37.541885,126.97966
용산구,827, 국군복지단,201908,322,152,474,37.541885,126.97966
용산구,827, 국군복지단,201909,280,159,439,37.541885,126.97966
용산구,827, 국군복지단,201910,349,209,558,37.541885,126.97966
용산구,827, 국군복지단,201911,266,147,413,37.541885,126.97966
용산구,827, 국군복지단,201912,237,78,315,37.541885,126.97966
용산구,827, 국군복지단,202001,213,44,257,37.541885,126.97966
용산구,827, 국군복지단,202002,123,26,149,37.541885,126.97966
용산구,827, 국군복지단,202003,141,42,183,37.541885,126.97966
용산구,827, 국군복지단,202004,100,34,134,37.541885,126.97966
용산구,827, 국군복지단,202005,69,31,100,37.541885,126.97966
용산구,827, 국군복지단,202006,96,27,123,37.541885,126.97966
용산구,828, 숙대입구역 8번,201901,175,183,358,37.544079,126.972
용산구,828, 숙대입구역 8번,201902,164,157,321,37.544079,126.972
용산구,828, 숙대입구역 8번,201903,328,327,655,37.544079,126.972
용산구,828, 숙대입구역 8번,201904,521,547,1068,37.544079,126.972
용산구,828, 숙대입구역 8번,201905,871,859,1730,37.544079,126.972
용산구,828, 숙대입구역 8번,201906,914,928,1842,37.544079,126.972
용산구,828, 숙대입구역 8번,201907,981,982,1963,37.544079,126.972
용산구,828, 숙대입구역 8번,201908,842,850,1692,37.544079,126.972
용산구,828, 숙대입구역 8번,201909,834,838,1672,37.544079,126.972
용산구,828, 숙대입구역 8번,201910,1033,1040,2073,37.544079,126.972
용산구,828, 숙대입구역 8번,201911,637,641,1278,37.544079,126.972
용산구,828, 숙대입구역 8번,201912,396,447,843,37.544079,126.972
용산구,828, 숙대입구역 8번,202001,309,330,639,37.544079,126.972
용산구,828, 숙대입구역 8번,202002,327,337,664,37.544079,126.972
용산구,828, 숙대입구역 8번,202003,570,556,1126,37.544079,126.972
용산구,828, 숙대입구역 8번,202004,794,801,1595,37.544079,126.972
용산구,828, 숙대입구역 8번,202005,877,870,1747,37.544079,126.972
용산구,828, 숙대입구역 8번,202006,853,857,1710,37.544079,126.972
용산구,829, 베르가모앞,201901,409,385,794,37.52293,126.961693
용산구,829, 베르가모앞,201902,481,481,962,37.52293,126.961693
용산구,829, 베르가모앞,201903,1033,968,2001,37.52293,126.961693
용산구,829, 베르가모앞,201904,1983,1780,3763,37.52293,126.961693
용산구,829, 베르가모앞,201905,3236,3049,6285,37.52293,126.961693
용산구,829, 베르가모앞,201906,3620,3260,6880,37.52293,126.961693
용산구,829, 베르가모앞,201907,3118,2814,5932,37.52293,126.961693
용산구,829, 베르가모앞,201908,3072,2767,5839,37.52293,126.961693
용산구,829, 베르가모앞,201909,3231,2981,6212,37.52293,126.961693
용산구,829, 베르가모앞,201910,4095,3768,7863,37.52293,126.961693
용산구,829, 베르가모앞,201911,1916,1734,3650,37.52293,126.961693
용산구,829, 베르가모앞,201912,898,813,1711,37.52293,126.961693
용산구,829, 베르가모앞,202001,811,738,1549,37.52293,126.961693
용산구,829, 베르가모앞,202002,1033,1008,2041,37.52293,126.961693
용산구,829, 베르가모앞,202003,3076,2985,6061,37.52293,126.961693
용산구,829, 베르가모앞,202004,4414,4340,8754,37.52293,126.961693
용산구,829, 베르가모앞,202005,4377,4335,8712,37.52293,126.961693
용산구,829, 베르가모앞,202006,3961,3910,7871,37.52293,126.961693
용산구,830, 청암자이아파트앞,201901,194,140,334,37.534424,126.94857
용산구,830, 청암자이아파트앞,201902,201,152,353,37.534424,126.94857
용산구,830, 청암자이아파트앞,201903,272,247,519,37.534424,126.94857
용산구,830, 청암자이아파트앞,201904,440,420,860,37.534424,126.94857
용산구,830, 청암자이아파트앞,201905,595,589,1184,37.534424,126.94857
용산구,830, 청암자이아파트앞,201906,649,650,1299,37.534424,126.94857
용산구,830, 청암자이아파트앞,201907,647,632,1279,37.534424,126.94857
용산구,830, 청암자이아파트앞,201908,618,603,1221,37.534424,126.94857
용산구,830, 청암자이아파트앞,201909,606,597,1203,37.534424,126.94857
용산구,830, 청암자이아파트앞,201910,671,599,1270,37.534424,126.94857
용산구,830, 청암자이아파트앞,201911,439,391,830,37.534424,126.94857
용산구,830, 청암자이아파트앞,201912,262,212,474,37.534424,126.94857
용산구,830, 청암자이아파트앞,202001,271,209,480,37.534424,126.94857
용산구,830, 청암자이아파트앞,202002,262,234,496,37.534424,126.94857
용산구,830, 청암자이아파트앞,202003,550,492,1042,37.534424,126.94857
용산구,830, 청암자이아파트앞,202004,672,656,1328,37.534424,126.94857
용산구,830, 청암자이아파트앞,202005,817,824,1641,37.534424,126.94857
용산구,830, 청암자이아파트앞,202006,719,642,1361,37.534424,126.94857
용산구,831, 이태원관광특구입구,201901,272,120,392,37.534279,126.988564
용산구,831, 이태원관광특구입구,201902,247,119,366,37.534279,126.988564
용산구,831, 이태원관광특구입구,201903,423,230,653,37.534279,126.988564
용산구,831, 이태원관광특구입구,201904,660,405,1065,37.534279,126.988564
용산구,831, 이태원관광특구입구,201905,667,503,1170,37.534279,126.988564
용산구,831, 이태원관광특구입구,201906,723,551,1274,37.534279,126.988564
용산구,831, 이태원관광특구입구,201907,565,460,1025,37.534279,126.988564
용산구,831, 이태원관광특구입구,201908,537,451,988,37.534279,126.988564
용산구,831, 이태원관광특구입구,201909,382,382,764,37.534279,126.988564
용산구,831, 이태원관광특구입구,201910,550,543,1093,37.534279,126.988564
용산구,831, 이태원관광특구입구,201911,373,288,661,37.534279,126.988564
용산구,831, 이태원관광특구입구,201912,240,165,405,37.534279,126.988564
용산구,831, 이태원관광특구입구,202001,315,175,490,37.534279,126.988564
용산구,831, 이태원관광특구입구,202002,272,158,430,37.534279,126.988564
용산구,831, 이태원관광특구입구,202003,496,411,907,37.534279,126.988564
용산구,831, 이태원관광특구입구,202004,520,447,967,37.534279,126.988564
용산구,831, 이태원관광특구입구,202005,265,265,530,37.534279,126.988564
용산구,831, 이태원관광특구입구,202006,273,258,531,37.534279,126.988564
용산구,832, 이촌1동 주민센터 뒤,201901,350,399,749,37.521282,126.973465
용산구,832, 이촌1동 주민센터 뒤,201902,381,394,775,37.521282,126.973465
용산구,832, 이촌1동 주민센터 뒤,201903,853,857,1710,37.521282,126.973465
용산구,832, 이촌1동 주민센터 뒤,201904,1444,1506,2950,37.521282,126.973465
용산구,832, 이촌1동 주민센터 뒤,201905,2513,2616,5129,37.521282,126.973465
용산구,832, 이촌1동 주민센터 뒤,201906,2577,2638,5215,37.521282,126.973465
용산구,832, 이촌1동 주민센터 뒤,201907,2209,2282,4491,37.521282,126.973465
용산구,832, 이촌1동 주민센터 뒤,201908,2487,2539,5026,37.521282,126.973465
용산구,832, 이촌1동 주민센터 뒤,201909,2515,2650,5165,37.521282,126.973465
용산구,832, 이촌1동 주민센터 뒤,201910,2912,3025,5937,37.521282,126.973465
용산구,832, 이촌1동 주민센터 뒤,201911,1296,1356,2652,37.521282,126.973465
용산구,832, 이촌1동 주민센터 뒤,201912,605,636,1241,37.521282,126.973465
용산구,832, 이촌1동 주민센터 뒤,202001,619,618,1237,37.521282,126.973465
용산구,832, 이촌1동 주민센터 뒤,202002,747,788,1535,37.521282,126.973465
용산구,832, 이촌1동 주민센터 뒤,202003,2392,2587,4979,37.521282,126.973465
용산구,832, 이촌1동 주민센터 뒤,202004,3442,3566,7008,37.521282,126.973465
용산구,832, 이촌1동 주민센터 뒤,202005,4169,4284,8453,37.521282,126.973465
용산구,832, 이촌1동 주민센터 뒤,202006,3203,3308,6511,37.521282,126.973465
용산구,834, 효창공원앞역 3번출구 뒤,201901,501,496,997,37.539009,126.96138
용산구,834, 효창공원앞역 3번출구 뒤,201902,498,476,974,37.539009,126.96138
용산구,834, 효창공원앞역 3번출구 뒤,201903,807,805,1612,37.539009,126.96138
용산구,834, 효창공원앞역 3번출구 뒤,201904,1125,1157,2282,37.539009,126.96138
용산구,834, 효창공원앞역 3번출구 뒤,201905,1749,1757,3506,37.539009,126.96138
용산구,834, 효창공원앞역 3번출구 뒤,201906,1877,2029,3906,37.539009,126.96138
용산구,834, 효창공원앞역 3번출구 뒤,201907,1704,1754,3458,37.539009,126.96138
용산구,834, 효창공원앞역 3번출구 뒤,201908,1508,1536,3044,37.539009,126.96138
용산구,834, 효창공원앞역 3번출구 뒤,201909,1683,1708,3391,37.539009,126.96138
용산구,834, 효창공원앞역 3번출구 뒤,201910,1864,1989,3853,37.539009,126.96138
용산구,834, 효창공원앞역 3번출구 뒤,201911,1181,1226,2407,37.539009,126.96138
용산구,834, 효창공원앞역 3번출구 뒤,201912,791,760,1551,37.539009,126.96138
용산구,834, 효창공원앞역 3번출구 뒤,202001,706,708,1414,37.539009,126.96138
용산구,834, 효창공원앞역 3번출구 뒤,202002,590,590,1180,37.539009,126.96138
용산구,834, 효창공원앞역 3번출구 뒤,202003,1239,1203,2442,37.539009,126.96138
용산구,834, 효창공원앞역 3번출구 뒤,202004,1820,1834,3654,37.539009,126.96138
용산구,834, 효창공원앞역 3번출구 뒤,202005,2165,2154,4319,37.539009,126.96138
용산구,834, 효창공원앞역 3번출구 뒤,202006,2349,2310,4659,37.539009,126.96138
용산구,835, 남영역 건너편,201901,232,209,441,37.541981,126.971542
용산구,835, 남영역 건너편,201902,224,216,440,37.541981,126.971542
용산구,835, 남영역 건너편,201903,395,360,755,37.541981,126.971542
용산구,835, 남영역 건너편,201904,643,639,1282,37.541981,126.971542
용산구,835, 남영역 건너편,201905,924,908,1832,37.541981,126.971542
용산구,835, 남영역 건너편,201906,1050,1060,2110,37.541981,126.971542
용산구,835, 남영역 건너편,201907,1063,1060,2123,37.541981,126.971542
용산구,835, 남영역 건너편,201908,908,907,1815,37.541981,126.971542
용산구,835, 남영역 건너편,201909,930,931,1861,37.541981,126.971542
용산구,835, 남영역 건너편,201910,1166,1162,2328,37.541981,126.971542
용산구,835, 남영역 건너편,201911,726,715,1441,37.541981,126.971542
용산구,835, 남영역 건너편,201912,374,394,768,37.541981,126.971542
용산구,835, 남영역 건너편,202001,325,329,654,37.541981,126.971542
용산구,835, 남영역 건너편,202002,298,296,594,37.541981,126.971542
용산구,835, 남영역 건너편,202003,651,635,1286,37.541981,126.971542
용산구,835, 남영역 건너편,202004,974,979,1953,37.541981,126.971542
용산구,835, 남영역 건너편,202005,945,938,1883,37.541981,126.971542
용산구,835, 남영역 건너편,202006,968,982,1950,37.541981,126.971542
용산구,836, 현대자동차서비스 앞,201901,126,117,243,37.531422,126.9515
용산구,836, 현대자동차서비스 앞,201902,149,160,309,37.531422,126.9515
용산구,836, 현대자동차서비스 앞,201903,311,318,629,37.531422,126.9515
용산구,836, 현대자동차서비스 앞,201904,611,619,1230,37.531422,126.9515
용산구,836, 현대자동차서비스 앞,201905,1043,1069,2112,37.531422,126.9515
용산구,836, 현대자동차서비스 앞,201906,1061,1067,2128,37.531422,126.9515
용산구,836, 현대자동차서비스 앞,201907,936,954,1890,37.531422,126.9515
용산구,836, 현대자동차서비스 앞,201908,1022,1096,2118,37.531422,126.9515
용산구,836, 현대자동차서비스 앞,201909,1178,1231,2409,37.531422,126.9515
용산구,836, 현대자동차서비스 앞,201910,1267,1309,2576,37.531422,126.9515
용산구,836, 현대자동차서비스 앞,201911,610,661,1271,37.531422,126.9515
용산구,836, 현대자동차서비스 앞,201912,357,336,693,37.531422,126.9515
용산구,836, 현대자동차서비스 앞,202001,350,316,666,37.531422,126.9515
용산구,836, 현대자동차서비스 앞,202002,401,373,774,37.531422,126.9515
용산구,836, 현대자동차서비스 앞,202003,1301,1300,2601,37.531422,126.9515
용산구,836, 현대자동차서비스 앞,202004,1629,1628,3257,37.531422,126.9515
용산구,836, 현대자동차서비스 앞,202005,2038,2042,4080,37.531422,126.9515
용산구,836, 현대자동차서비스 앞,202006,1909,2007,3916,37.531422,126.9515
용산구,837, 한남나들목 입구,201901,218,269,487,37.52906,127.006729
용산구,837, 한남나들목 입구,201902,289,302,591,37.52906,127.006729
용산구,837, 한남나들목 입구,201903,628,776,1404,37.52906,127.006729
용산구,837, 한남나들목 입구,201904,1180,1360,2540,37.52906,127.006729
용산구,837, 한남나들목 입구,201905,2189,2402,4591,37.52906,127.006729
용산구,837, 한남나들목 입구,201906,2212,2452,4664,37.52906,127.006729
용산구,837, 한남나들목 입구,201907,1805,1936,3741,37.52906,127.006729
용산구,837, 한남나들목 입구,201908,1927,2119,4046,37.52906,127.006729
용산구,837, 한남나들목 입구,201909,2013,2209,4222,37.52906,127.006729
용산구,837, 한남나들목 입구,201910,2341,2496,4837,37.52906,127.006729
용산구,837, 한남나들목 입구,201911,995,1084,2079,37.52906,127.006729
용산구,837, 한남나들목 입구,201912,390,395,785,37.52906,127.006729
용산구,837, 한남나들목 입구,202001,426,483,909,37.52906,127.006729
용산구,837, 한남나들목 입구,202002,520,578,1098,37.52906,127.006729
용산구,837, 한남나들목 입구,202003,2060,2383,4443,37.52906,127.006729
용산구,837, 한남나들목 입구,202004,3063,3269,6332,37.52906,127.006729
용산구,837, 한남나들목 입구,202005,3264,3387,6651,37.52906,127.006729
용산구,837, 한남나들목 입구,202006,2954,3010,5964,37.52906,127.006729
용산구,838, 숙대입구역 4번출구,201901,274,344,618,37.54446,126.972389
용산구,838, 숙대입구역 4번출구,201902,267,350,617,37.54446,126.972389
용산구,838, 숙대입구역 4번출구,201903,481,543,1024,37.54446,126.972389
용산구,838, 숙대입구역 4번출구,201904,752,869,1621,37.54446,126.972389
용산구,838, 숙대입구역 4번출구,201905,1241,1235,2476,37.54446,126.972389
용산구,838, 숙대입구역 4번출구,201906,1291,1277,2568,37.54446,126.972389
용산구,838, 숙대입구역 4번출구,201907,1233,1269,2502,37.54446,126.972389
용산구,838, 숙대입구역 4번출구,201908,1217,1240,2457,37.54446,126.972389
용산구,838, 숙대입구역 4번출구,201909,1193,1191,2384,37.54446,126.972389
용산구,838, 숙대입구역 4번출구,201910,1433,1463,2896,37.54446,126.972389
용산구,838, 숙대입구역 4번출구,201911,785,885,1670,37.54446,126.972389
용산구,838, 숙대입구역 4번출구,201912,375,568,943,37.54446,126.972389
용산구,838, 숙대입구역 4번출구,202001,328,520,848,37.54446,126.972389
용산구,838, 숙대입구역 4번출구,202002,374,475,849,37.54446,126.972389
용산구,838, 숙대입구역 4번출구,202003,784,785,1569,37.54446,126.972389
용산구,838, 숙대입구역 4번출구,202004,1089,1103,2192,37.54446,126.972389
용산구,838, 숙대입구역 4번출구,202005,1327,1326,2653,37.54446,126.972389
용산구,838, 숙대입구역 4번출구,202006,1244,1253,2497,37.54446,126.972389
용산구,839, 보광동 삼성리버빌아파트 앞,201901,57,61,118,37.52401,127.00145
용산구,839, 보광동 삼성리버빌아파트 앞,201902,84,81,165,37.52401,127.00145
용산구,839, 보광동 삼성리버빌아파트 앞,201903,202,198,400,37.52401,127.00145
용산구,839, 보광동 삼성리버빌아파트 앞,201904,442,462,904,37.52401,127.00145
용산구,839, 보광동 삼성리버빌아파트 앞,201905,820,873,1693,37.52401,127.00145
용산구,839, 보광동 삼성리버빌아파트 앞,201906,844,912,1756,37.52401,127.00145
용산구,839, 보광동 삼성리버빌아파트 앞,201907,817,870,1687,37.52401,127.00145
용산구,839, 보광동 삼성리버빌아파트 앞,201908,641,741,1382,37.52401,127.00145
용산구,839, 보광동 삼성리버빌아파트 앞,201909,829,869,1698,37.52401,127.00145
용산구,839, 보광동 삼성리버빌아파트 앞,201910,903,1039,1942,37.52401,127.00145
용산구,839, 보광동 삼성리버빌아파트 앞,201911,520,563,1083,37.52401,127.00145
용산구,839, 보광동 삼성리버빌아파트 앞,201912,269,289,558,37.52401,127.00145
용산구,839, 보광동 삼성리버빌아파트 앞,202001,234,261,495,37.52401,127.00145
용산구,839, 보광동 삼성리버빌아파트 앞,202002,308,347,655,37.52401,127.00145
용산구,839, 보광동 삼성리버빌아파트 앞,202003,1029,1063,2092,37.52401,127.00145
용산구,839, 보광동 삼성리버빌아파트 앞,202004,1240,1370,2610,37.52401,127.00145
용산구,839, 보광동 삼성리버빌아파트 앞,202005,1492,1602,3094,37.52401,127.00145
용산구,839, 보광동 삼성리버빌아파트 앞,202006,1403,1458,2861,37.52401,127.00145
용산구,840, 용산 파크타워 앞,201901,121,107,228,37.523651,126.970268
용산구,840, 용산 파크타워 앞,201902,127,108,235,37.523651,126.970268
용산구,840, 용산 파크타워 앞,201903,180,158,338,37.523651,126.970268
용산구,840, 용산 파크타워 앞,201904,328,296,624,37.523651,126.970268
용산구,840, 용산 파크타워 앞,201905,587,563,1150,37.523651,126.970268
용산구,840, 용산 파크타워 앞,201906,552,550,1102,37.523651,126.970268
용산구,840, 용산 파크타워 앞,201907,494,494,988,37.523651,126.970268
용산구,840, 용산 파크타워 앞,201908,469,473,942,37.523651,126.970268
용산구,840, 용산 파크타워 앞,201909,539,525,1064,37.523651,126.970268
용산구,840, 용산 파크타워 앞,201910,734,725,1459,37.523651,126.970268
용산구,840, 용산 파크타워 앞,201911,323,328,651,37.523651,126.970268
용산구,840, 용산 파크타워 앞,201912,181,179,360,37.523651,126.970268
용산구,840, 용산 파크타워 앞,202001,199,171,370,37.523651,126.970268
용산구,840, 용산 파크타워 앞,202002,172,181,353,37.523651,126.970268
용산구,840, 용산 파크타워 앞,202003,481,462,943,37.523651,126.970268
용산구,840, 용산 파크타워 앞,202004,616,598,1214,37.523651,126.970268
용산구,840, 용산 파크타워 앞,202005,671,663,1334,37.523651,126.970268
용산구,840, 용산 파크타워 앞,202006,588,563,1151,37.523651,126.970268
용산구,841, 신용산역 1번 출구,201901,384,414,798,37.52961,126.968872
용산구,841, 신용산역 1번 출구,201902,363,412,775,37.52961,126.968872
용산구,841, 신용산역 1번 출구,201903,688,795,1483,37.52961,126.968872
용산구,841, 신용산역 1번 출구,201904,1308,1352,2660,37.52961,126.968872
용산구,841, 신용산역 1번 출구,201905,2205,2239,4444,37.52961,126.968872
용산구,841, 신용산역 1번 출구,201906,2256,2331,4587,37.52961,126.968872
용산구,841, 신용산역 1번 출구,201907,1834,1908,3742,37.52961,126.968872
용산구,841, 신용산역 1번 출구,201908,2144,2197,4341,37.52961,126.968872
용산구,841, 신용산역 1번 출구,201909,2058,2125,4183,37.52961,126.968872
용산구,841, 신용산역 1번 출구,201910,2493,2584,5077,37.52961,126.968872
용산구,841, 신용산역 1번 출구,201911,1388,1442,2830,37.52961,126.968872
용산구,841, 신용산역 1번 출구,201912,751,916,1667,37.52961,126.968872
용산구,841, 신용산역 1번 출구,202001,633,820,1453,37.52961,126.968872
용산구,841, 신용산역 1번 출구,202002,608,741,1349,37.52961,126.968872
용산구,841, 신용산역 1번 출구,202003,1555,1594,3149,37.52961,126.968872
용산구,841, 신용산역 1번 출구,202004,2234,2258,4492,37.52961,126.968872
용산구,841, 신용산역 1번 출구,202005,2542,2580,5122,37.52961,126.968872
용산구,841, 신용산역 1번 출구,202006,2368,2448,4816,37.52961,126.968872
용산구,843, 녹사평역 광장,201901,144,121,265,37.533798,126.98867
용산구,843, 녹사평역 광장,201902,171,151,322,37.533798,126.98867
용산구,843, 녹사평역 광장,201903,481,347,828,37.533798,126.98867
용산구,843, 녹사평역 광장,201904,782,604,1386,37.533798,126.98867
용산구,843, 녹사평역 광장,201905,1180,949,2129,37.533798,126.98867
용산구,843, 녹사평역 광장,201906,1491,1062,2553,37.533798,126.98867
용산구,843, 녹사평역 광장,201907,1144,704,1848,37.533798,126.98867
용산구,843, 녹사평역 광장,201908,1204,767,1971,37.533798,126.98867
용산구,843, 녹사평역 광장,201909,1044,751,1795,37.533798,126.98867
용산구,843, 녹사평역 광장,201910,1476,1146,2622,37.533798,126.98867
용산구,843, 녹사평역 광장,201911,742,547,1289,37.533798,126.98867
용산구,843, 녹사평역 광장,201912,380,230,610,37.533798,126.98867
용산구,843, 녹사평역 광장,202001,429,247,676,37.533798,126.98867
용산구,843, 녹사평역 광장,202002,495,325,820,37.533798,126.98867
용산구,843, 녹사평역 광장,202003,1081,899,1980,37.533798,126.98867
용산구,843, 녹사평역 광장,202004,1403,1262,2665,37.533798,126.98867
용산구,843, 녹사평역 광장,202005,984,816,1800,37.533798,126.98867
용산구,843, 녹사평역 광장,202006,773,625,1398,37.533798,126.98867
용산구,844, 이촌2동 동원베네스트 아파트 앞,201901,159,212,371,37.527149,126.955162
용산구,844, 이촌2동 동원베네스트 아파트 앞,201902,172,238,410,37.527149,126.955162
용산구,844, 이촌2동 동원베네스트 아파트 앞,201903,288,389,677,37.527149,126.955162
용산구,844, 이촌2동 동원베네스트 아파트 앞,201904,524,641,1165,37.527149,126.955162
용산구,844, 이촌2동 동원베네스트 아파트 앞,201905,933,1116,2049,37.527149,126.955162
용산구,844, 이촌2동 동원베네스트 아파트 앞,201906,985,1220,2205,37.527149,126.955162
용산구,844, 이촌2동 동원베네스트 아파트 앞,201907,854,1186,2040,37.527149,126.955162
용산구,844, 이촌2동 동원베네스트 아파트 앞,201908,878,1189,2067,37.527149,126.955162
용산구,844, 이촌2동 동원베네스트 아파트 앞,201909,912,1035,1947,37.527149,126.955162
용산구,844, 이촌2동 동원베네스트 아파트 앞,201910,1002,1291,2293,37.527149,126.955162
용산구,844, 이촌2동 동원베네스트 아파트 앞,201911,648,808,1456,37.527149,126.955162
용산구,844, 이촌2동 동원베네스트 아파트 앞,201912,410,482,892,37.527149,126.955162
용산구,844, 이촌2동 동원베네스트 아파트 앞,202001,367,431,798,37.527149,126.955162
용산구,844, 이촌2동 동원베네스트 아파트 앞,202002,380,434,814,37.527149,126.955162
용산구,844, 이촌2동 동원베네스트 아파트 앞,202003,753,827,1580,37.527149,126.955162
용산구,844, 이촌2동 동원베네스트 아파트 앞,202004,1089,1149,2238,37.527149,126.955162
용산구,844, 이촌2동 동원베네스트 아파트 앞,202005,1209,1254,2463,37.527149,126.955162
용산구,844, 이촌2동 동원베네스트 아파트 앞,202006,1233,1339,2572,37.527149,126.955162
용산구,845, 용산 선인상가,201901,210,233,443,37.5327,126.964378
용산구,845, 용산 선인상가,201902,185,212,397,37.5327,126.964378
용산구,845, 용산 선인상가,201903,339,334,673,37.5327,126.964378
용산구,845, 용산 선인상가,201904,505,476,981,37.5327,126.964378
용산구,845, 용산 선인상가,201905,759,745,1504,37.5327,126.964378
용산구,845, 용산 선인상가,201906,876,846,1722,37.5327,126.964378
용산구,845, 용산 선인상가,201907,628,647,1275,37.5327,126.964378
용산구,845, 용산 선인상가,201908,670,642,1312,37.5327,126.964378
용산구,845, 용산 선인상가,201909,675,689,1364,37.5327,126.964378
용산구,845, 용산 선인상가,201910,850,840,1690,37.5327,126.964378
용산구,845, 용산 선인상가,201911,644,679,1323,37.5327,126.964378
용산구,845, 용산 선인상가,201912,437,450,887,37.5327,126.964378
용산구,845, 용산 선인상가,202001,346,380,726,37.5327,126.964378
용산구,845, 용산 선인상가,202002,349,401,750,37.5327,126.964378
용산구,845, 용산 선인상가,202003,569,586,1155,37.5327,126.964378
용산구,845, 용산 선인상가,202004,772,776,1548,37.5327,126.964378
용산구,845, 용산 선인상가,202005,764,766,1530,37.5327,126.964378
용산구,845, 용산 선인상가,202006,877,883,1760,37.5327,126.964378
용산구,846, 용산중학교,201901,109,125,234,37.546638,126.981041
용산구,846, 용산중학교,201902,159,172,331,37.546638,126.981041
용산구,846, 용산중학교,201903,380,382,762,37.546638,126.981041
용산구,846, 용산중학교,201904,624,687,1311,37.546638,126.981041
용산구,846, 용산중학교,201905,1009,995,2004,37.546638,126.981041
용산구,846, 용산중학교,201906,989,1007,1996,37.546638,126.981041
용산구,846, 용산중학교,201907,862,843,1705,37.546638,126.981041
용산구,846, 용산중학교,201908,846,844,1690,37.546638,126.981041
용산구,846, 용산중학교,201909,712,717,1429,37.546638,126.981041
용산구,846, 용산중학교,201910,898,873,1771,37.546638,126.981041
용산구,846, 용산중학교,201911,614,592,1206,37.546638,126.981041
용산구,846, 용산중학교,201912,474,405,879,37.546638,126.981041
용산구,846, 용산중학교,202001,382,364,746,37.546638,126.981041
용산구,846, 용산중학교,202002,312,309,621,37.546638,126.981041
용산구,846, 용산중학교,202003,624,623,1247,37.546638,126.981041
용산구,846, 용산중학교,202004,894,898,1792,37.546638,126.981041
용산구,846, 용산중학교,202005,1026,1023,2049,37.546638,126.981041
용산구,846, 용산중학교,202006,1106,1133,2239,37.546638,126.981041
용산구,847, 국방부민원실옆,202004,75,53,128,37.534523,126.977501
용산구,847, 국방부민원실옆,202005,118,103,221,37.534523,126.977501
용산구,847, 국방부민원실옆,202006,144,136,280,37.534523,126.977501
용산구,848, 삼각지12번 출구,202004,120,110,230,37.535259,126.975052
용산구,848, 삼각지12번 출구,202005,160,160,320,37.535259,126.975052
용산구,848, 삼각지12번 출구,202006,195,193,388,37.535259,126.975052
용산구,849, 삼각지 자이아파트,202004,320,295,615,37.536079,126.973419
용산구,849, 삼각지 자이아파트,202005,454,458,912,37.536079,126.973419
용산구,849, 삼각지 자이아파트,202006,608,602,1210,37.536079,126.973419
용산구,850, KCC용산월츠타워,202004,160,139,299,37.537399,126.968926
용산구,850, KCC용산월츠타워,202005,262,262,524,37.537399,126.968926
용산구,850, KCC용산월츠타워,202006,430,418,848,37.537399,126.968926
용산구,851,효창 푸르지오 앞,202004,58,50,108,37.540478,126.958115
용산구,851,효창 푸르지오 앞,202005,98,99,197,37.540478,126.958115
용산구,851,효창 푸르지오 앞,202006,215,181,396,37.540478,126.958115
용산구,852,청암자이APT(103동),202004,1,1,2,37.534527,126.947182
용산구,852,청암자이APT(103동),202006,250,222,472,37.534527,126.947182
용산구,853,용산역 맞은편,202004,1,1,2,37.528568,126.965691
용산구,853,용산역 맞은편,202006,1063,1001,2064,37.528568,126.965691
용산구,854,HID 유족동지회 앞,202004,93,75,168,37.538727,127.001549
용산구,854,HID 유족동지회 앞,202005,103,105,208,37.538727,127.001549
용산구,854,HID 유족동지회 앞,202006,144,124,268,37.538727,127.001549
용산구,855,이촌역5번출구 앞,202004,1,1,2,37.522724,126.972771
용산구,855,이촌역5번출구 앞,202006,39,36,75,37.522724,126.972771
용산구,857, 현대 안성타워,202004,1,1,2,37.535023,126.998055
용산구,857, 현대 안성타워,202006,156,157,313,37.535023,126.998055
용산구,858,녹사평역3번 출구,202004,2,2,4,37.534409,126.986893
용산구,858,녹사평역3번 출구,202006,63,62,125,37.534409,126.986893
용산구,859,남산공원 야외식물원 앞,202004,1,1,2,37.541885,126.995865
용산구,860,LG한강 자이아파트 앞,202004,1,1,2,37.520695,126.970978
용산구,860,LG한강 자이아파트 앞,202006,543,542,1085,37.520695,126.970978
용산구,861,삼익상가 앞,202004,2,2,4,#N/A,#N/A
용산구,862,원효아파트,202004,1,1,2,#N/A,#N/A
용산구,863,이촌역2번 출구,202004,3,3,6,37.52177,126.977005
용산구,863,이촌역2번 출구,202006,116,91,207,37.52177,126.977005
용산구,864,순천향대학병원(한남오거리),202004,267,242,509,37.535141,127.006004
용산구,864,순천향대학병원(한남오거리),202005,591,579,1170,37.535141,127.006004
용산구,864,순천향대학병원(한남오거리),202006,794,787,1581,37.535141,127.006004
용산구,865,하얏트호텔 앞,202004,33,19,52,37.540794,126.997849
용산구,865,하얏트호텔 앞,202005,22,21,43,37.540794,126.997849
용산구,865,하얏트호텔 앞,202006,26,26,52,37.540794,126.997849
용산구,866,브라운스톤 남산아파트,202004,1,3,4,37.551548,126.97686
용산구,866,브라운스톤 남산아파트,202006,169,157,326,37.551548,126.97686
용산구,867,서빙고역 광장(1번출구),202004,4,3,7,37.519909,126.989235
용산구,867,서빙고역 광장(1번출구),202006,93,94,187,37.519909,126.989235
용산구,868,롯데하이마트 용산점 앞,202004,109,91,200,37.53722,126.965019
용산구,868,롯데하이마트 용산점 앞,202005,195,195,390,37.53722,126.965019
용산구,868,롯데하이마트 용산점 앞,202006,299,300,599,37.53722,126.965019
용산구,869,노들섬 동측 앞,202004,134,120,254,37.517296,126.959145
용산구,869,노들섬 동측 앞,202005,323,326,649,37.517296,126.959145
용산구,869,노들섬 동측 앞,202006,441,441,882,37.517296,126.959145
용산구,870,노들섬 서측 앞,202004,452,441,893,37.517319,126.958298
용산구,870,노들섬 서측 앞,202005,1298,1287,2585,37.517319,126.958298
용산구,870,노들섬 서측 앞,202006,1615,1625,3240,37.517319,126.958298
은평구,900, 은평예술회관,201901,166,168,334,37.603943,126.927696
은평구,900, 은평예술회관,201902,182,196,378,37.603943,126.927696
은평구,900, 은평예술회관,201903,370,381,751,37.603943,126.927696
은평구,900, 은평예술회관,201904,587,550,1137,37.603943,126.927696
은평구,900, 은평예술회관,201905,760,709,1469,37.603943,126.927696
은평구,900, 은평예술회관,201906,815,753,1568,37.603943,126.927696
은평구,900, 은평예술회관,201907,763,667,1430,37.603943,126.927696
은평구,900, 은평예술회관,201908,691,702,1393,37.603943,126.927696
은평구,900, 은평예술회관,201909,898,789,1687,37.603943,126.927696
은평구,900, 은평예술회관,201910,1009,923,1932,37.603943,126.927696
은평구,900, 은평예술회관,201911,673,637,1310,37.603943,126.927696
은평구,900, 은평예술회관,201912,430,406,836,37.603943,126.927696
은평구,900, 은평예술회관,202001,391,330,721,37.603943,126.927696
은평구,900, 은평예술회관,202002,378,324,702,37.603943,126.927696
은평구,900, 은평예술회관,202003,666,596,1262,37.603943,126.927696
은평구,900, 은평예술회관,202004,868,831,1699,37.603943,126.927696
은평구,900, 은평예술회관,202005,920,846,1766,37.603943,126.927696
은평구,900, 은평예술회관,202006,1011,869,1880,37.603943,126.927696
은평구,901, 응암1동사무소,201901,234,281,515,37.600975,126.926956
은평구,901, 응암1동사무소,201902,206,221,427,37.600975,126.926956
은평구,901, 응암1동사무소,201903,464,487,951,37.600975,126.926956
은평구,901, 응암1동사무소,201904,696,700,1396,37.600975,126.926956
은평구,901, 응암1동사무소,201905,1081,1124,2205,37.600975,126.926956
은평구,901, 응암1동사무소,201906,1194,1310,2504,37.600975,126.926956
은평구,901, 응암1동사무소,201907,1224,1380,2604,37.600975,126.926956
은평구,901, 응암1동사무소,201908,1225,1292,2517,37.600975,126.926956
은평구,901, 응암1동사무소,201909,1088,1087,2175,37.600975,126.926956
은평구,901, 응암1동사무소,201910,1374,1392,2766,37.600975,126.926956
은평구,901, 응암1동사무소,201911,857,855,1712,37.600975,126.926956
은평구,901, 응암1동사무소,201912,526,515,1041,37.600975,126.926956
은평구,901, 응암1동사무소,202001,491,489,980,37.600975,126.926956
은평구,901, 응암1동사무소,202002,429,442,871,37.600975,126.926956
은평구,901, 응암1동사무소,202003,775,772,1547,37.600975,126.926956
은평구,901, 응암1동사무소,202004,1071,1060,2131,37.600975,126.926956
은평구,901, 응암1동사무소,202005,1301,1291,2592,37.600975,126.926956
은평구,901, 응암1동사무소,202006,1446,1437,2883,37.600975,126.926956
은평구,902, 진관동 은빛초등학교,201901,84,64,148,37.643108,126.918221
은평구,902, 진관동 은빛초등학교,201902,90,77,167,37.643108,126.918221
은평구,902, 진관동 은빛초등학교,201903,133,133,266,37.643108,126.918221
은평구,902, 진관동 은빛초등학교,201904,156,199,355,37.643108,126.918221
은평구,902, 진관동 은빛초등학교,201905,253,233,486,37.643108,126.918221
은평구,902, 진관동 은빛초등학교,201906,319,297,616,37.643108,126.918221
은평구,902, 진관동 은빛초등학교,201907,375,364,739,37.643108,126.918221
은평구,902, 진관동 은빛초등학교,201908,354,309,663,37.643108,126.918221
은평구,902, 진관동 은빛초등학교,201909,323,293,616,37.643108,126.918221
은평구,902, 진관동 은빛초등학교,201910,398,356,754,37.643108,126.918221
은평구,902, 진관동 은빛초등학교,201911,213,196,409,37.643108,126.918221
은평구,902, 진관동 은빛초등학교,201912,117,78,195,37.643108,126.918221
은평구,902, 진관동 은빛초등학교,202001,110,102,212,37.643108,126.918221
은평구,902, 진관동 은빛초등학교,202002,111,88,199,37.643108,126.918221
은평구,902, 진관동 은빛초등학교,202003,278,244,522,37.643108,126.918221
은평구,902, 진관동 은빛초등학교,202004,330,338,668,37.643108,126.918221
은평구,902, 진관동 은빛초등학교,202005,444,439,883,37.643108,126.918221
은평구,902, 진관동 은빛초등학교,202006,336,309,645,37.643108,126.918221
은평구,903, 은평뉴타운 아이파크,201901,162,155,317,37.645866,126.927391
은평구,903, 은평뉴타운 아이파크,201902,161,163,324,37.645866,126.927391
은평구,903, 은평뉴타운 아이파크,201903,275,277,552,37.645866,126.927391
은평구,903, 은평뉴타운 아이파크,201904,397,429,826,37.645866,126.927391
은평구,903, 은평뉴타운 아이파크,201905,562,677,1239,37.645866,126.927391
은평구,903, 은평뉴타운 아이파크,201906,641,765,1406,37.645866,126.927391
은평구,903, 은평뉴타운 아이파크,201907,553,690,1243,37.645866,126.927391
은평구,903, 은평뉴타운 아이파크,201908,598,715,1313,37.645866,126.927391
은평구,903, 은평뉴타운 아이파크,201909,642,681,1323,37.645866,126.927391
은평구,903, 은평뉴타운 아이파크,201910,745,767,1512,37.645866,126.927391
은평구,903, 은평뉴타운 아이파크,201911,473,503,976,37.645866,126.927391
은평구,903, 은평뉴타운 아이파크,201912,311,377,688,37.645866,126.927391
은평구,903, 은평뉴타운 아이파크,202001,273,326,599,37.645866,126.927391
은평구,903, 은평뉴타운 아이파크,202002,267,296,563,37.645866,126.927391
은평구,903, 은평뉴타운 아이파크,202003,553,579,1132,37.645866,126.927391
은평구,903, 은평뉴타운 아이파크,202004,765,753,1518,37.645866,126.927391
은평구,903, 은평뉴타운 아이파크,202005,1056,1060,2116,37.645866,126.927391
은평구,903, 은평뉴타운 아이파크,202006,1143,1196,2339,37.645866,126.927391
은평구,904, 은평뉴타운 푸르지오,201901,152,157,309,37.648674,126.930702
은평구,904, 은평뉴타운 푸르지오,201902,132,139,271,37.648674,126.930702
은평구,904, 은평뉴타운 푸르지오,201903,283,287,570,37.648674,126.930702
은평구,904, 은평뉴타운 푸르지오,201904,411,417,828,37.648674,126.930702
은평구,904, 은평뉴타운 푸르지오,201905,588,677,1265,37.648674,126.930702
은평구,904, 은평뉴타운 푸르지오,201906,693,754,1447,37.648674,126.930702
은평구,904, 은평뉴타운 푸르지오,201907,593,793,1386,37.648674,126.930702
은평구,904, 은평뉴타운 푸르지오,201908,550,711,1261,37.648674,126.930702
은평구,904, 은평뉴타운 푸르지오,201909,550,609,1159,37.648674,126.930702
은평구,904, 은평뉴타운 푸르지오,201910,664,751,1415,37.648674,126.930702
은평구,904, 은평뉴타운 푸르지오,201911,395,411,806,37.648674,126.930702
은평구,904, 은평뉴타운 푸르지오,201912,299,295,594,37.648674,126.930702
은평구,904, 은평뉴타운 푸르지오,202001,274,288,562,37.648674,126.930702
은평구,904, 은평뉴타운 푸르지오,202002,267,288,555,37.648674,126.930702
은평구,904, 은평뉴타운 푸르지오,202003,564,556,1120,37.648674,126.930702
은평구,904, 은평뉴타운 푸르지오,202004,912,928,1840,37.648674,126.930702
은평구,904, 은평뉴타운 푸르지오,202005,1017,1029,2046,37.648674,126.930702
은평구,904, 은평뉴타운 푸르지오,202006,1030,1092,2122,37.648674,126.930702
은평구,905, 구파발역 2번출구,201901,354,701,1055,37.636234,126.918999
은평구,905, 구파발역 2번출구,201902,355,627,982,37.636234,126.918999
은평구,905, 구파발역 2번출구,201903,776,1296,2072,37.636234,126.918999
은평구,905, 구파발역 2번출구,201904,1191,1730,2921,37.636234,126.918999
은평구,905, 구파발역 2번출구,201905,1742,2276,4018,37.636234,126.918999
은평구,905, 구파발역 2번출구,201906,2006,2490,4496,37.636234,126.918999
은평구,905, 구파발역 2번출구,201907,1968,2374,4342,37.636234,126.918999
은평구,905, 구파발역 2번출구,201908,1991,2275,4266,37.636234,126.918999
은평구,905, 구파발역 2번출구,201909,1861,2246,4107,37.636234,126.918999
은평구,905, 구파발역 2번출구,201910,2071,2527,4598,37.636234,126.918999
은평구,905, 구파발역 2번출구,201911,1255,1676,2931,37.636234,126.918999
은평구,905, 구파발역 2번출구,201912,773,1187,1960,37.636234,126.918999
은평구,905, 구파발역 2번출구,202001,679,1070,1749,37.636234,126.918999
은평구,905, 구파발역 2번출구,202002,624,916,1540,37.636234,126.918999
은평구,905, 구파발역 2번출구,202003,1271,1503,2774,37.636234,126.918999
은평구,905, 구파발역 2번출구,202004,1925,2007,3932,37.636234,126.918999
은평구,905, 구파발역 2번출구,202005,2260,2326,4586,37.636234,126.918999
은평구,905, 구파발역 2번출구,202006,2486,2675,5161,37.636234,126.918999
은평구,906, 연신내역 5번출구150M 아래,201901,439,622,1061,37.61721,126.919579
은평구,906, 연신내역 5번출구150M 아래,201902,504,715,1219,37.61721,126.919579
은평구,906, 연신내역 5번출구150M 아래,201903,892,1072,1964,37.61721,126.919579
은평구,906, 연신내역 5번출구150M 아래,201904,1385,1627,3012,37.61721,126.919579
은평구,906, 연신내역 5번출구150M 아래,201905,2422,2835,5257,37.61721,126.919579
은평구,906, 연신내역 5번출구150M 아래,201906,2700,3083,5783,37.61721,126.919579
은평구,906, 연신내역 5번출구150M 아래,201907,2686,2962,5648,37.61721,126.919579
은평구,906, 연신내역 5번출구150M 아래,201908,2545,2704,5249,37.61721,126.919579
은평구,906, 연신내역 5번출구150M 아래,201909,2740,2895,5635,37.61721,126.919579
은평구,906, 연신내역 5번출구150M 아래,201910,3116,3400,6516,37.61721,126.919579
은평구,906, 연신내역 5번출구150M 아래,201911,1862,2107,3969,37.61721,126.919579
은평구,906, 연신내역 5번출구150M 아래,201912,1148,1259,2407,37.61721,126.919579
은평구,906, 연신내역 5번출구150M 아래,202001,972,1085,2057,37.61721,126.919579
은평구,906, 연신내역 5번출구150M 아래,202002,923,986,1909,37.61721,126.919579
은평구,906, 연신내역 5번출구150M 아래,202003,1873,2084,3957,37.61721,126.919579
은평구,906, 연신내역 5번출구150M 아래,202004,3161,3218,6379,37.61721,126.919579
은평구,906, 연신내역 5번출구150M 아래,202005,3631,3704,7335,37.61721,126.919579
은평구,906, 연신내역 5번출구150M 아래,202006,3938,3997,7935,37.61721,126.919579
은평구,907, CJ 드림시티,201901,899,1250,2149,37.599491,126.916862
은평구,907, CJ 드림시티,201902,950,1319,2269,37.599491,126.916862
은평구,907, CJ 드림시티,201903,1797,2502,4299,37.599491,126.916862
은평구,907, CJ 드림시티,201904,3448,4535,7983,37.599491,126.916862
은평구,907, CJ 드림시티,201905,5259,6677,11936,37.599491,126.916862
은평구,907, CJ 드림시티,201906,5502,6863,12365,37.599491,126.916862
은평구,907, CJ 드림시티,201907,4731,6239,10970,37.599491,126.916862
은평구,907, CJ 드림시티,201908,5116,6443,11559,37.599491,126.916862
은평구,907, CJ 드림시티,201909,5894,6971,12865,37.599491,126.916862
은평구,907, CJ 드림시티,201910,6345,7459,13804,37.599491,126.916862
은평구,907, CJ 드림시티,201911,3484,4132,7616,37.599491,126.916862
은평구,907, CJ 드림시티,201912,1802,2208,4010,37.599491,126.916862
은평구,907, CJ 드림시티,202001,1669,2095,3764,37.599491,126.916862
은평구,907, CJ 드림시티,202002,1699,2078,3777,37.599491,126.916862
은평구,907, CJ 드림시티,202003,5209,5922,11131,37.599491,126.916862
은평구,907, CJ 드림시티,202004,7420,8067,15487,37.599491,126.916862
은평구,907, CJ 드림시티,202005,8048,8770,16818,37.599491,126.916862
은평구,907, CJ 드림시티,202006,6726,7918,14644,37.599491,126.916862
은평구,908, 구산역 4번출구,201901,195,190,385,37.613186,126.917351
은평구,908, 구산역 4번출구,201902,188,203,391,37.613186,126.917351
은평구,908, 구산역 4번출구,201903,345,377,722,37.613186,126.917351
은평구,908, 구산역 4번출구,201904,562,561,1123,37.613186,126.917351
은평구,908, 구산역 4번출구,201905,905,911,1816,37.613186,126.917351
은평구,908, 구산역 4번출구,201906,1065,1051,2116,37.613186,126.917351
은평구,908, 구산역 4번출구,201907,987,985,1972,37.613186,126.917351
은평구,908, 구산역 4번출구,201908,1063,1050,2113,37.613186,126.917351
은평구,908, 구산역 4번출구,201909,939,927,1866,37.613186,126.917351
은평구,908, 구산역 4번출구,201910,1016,1044,2060,37.613186,126.917351
은평구,908, 구산역 4번출구,201911,640,668,1308,37.613186,126.917351
은평구,908, 구산역 4번출구,201912,516,521,1037,37.613186,126.917351
은평구,908, 구산역 4번출구,202001,429,404,833,37.613186,126.917351
은평구,908, 구산역 4번출구,202002,440,420,860,37.613186,126.917351
은평구,908, 구산역 4번출구,202003,719,670,1389,37.613186,126.917351
은평구,908, 구산역 4번출구,202004,927,902,1829,37.613186,126.917351
은평구,908, 구산역 4번출구,202005,1130,1124,2254,37.613186,126.917351
은평구,908, 구산역 4번출구,202006,1295,1323,2618,37.613186,126.917351
은평구,909, 백련산 힐스테이트 3차,201901,195,59,254,37.586994,126.922882
은평구,909, 백련산 힐스테이트 3차,201902,153,56,209,37.586994,126.922882
은평구,909, 백련산 힐스테이트 3차,201903,324,119,443,37.586994,126.922882
은평구,909, 백련산 힐스테이트 3차,201904,427,167,594,37.586994,126.922882
은평구,909, 백련산 힐스테이트 3차,201905,673,272,945,37.586994,126.922882
은평구,909, 백련산 힐스테이트 3차,201906,672,301,973,37.586994,126.922882
은평구,909, 백련산 힐스테이트 3차,201907,673,278,951,37.586994,126.922882
은평구,909, 백련산 힐스테이트 3차,201908,548,224,772,37.586994,126.922882
은평구,909, 백련산 힐스테이트 3차,201909,589,219,808,37.586994,126.922882
은평구,909, 백련산 힐스테이트 3차,201910,726,269,995,37.586994,126.922882
은평구,909, 백련산 힐스테이트 3차,201911,484,199,683,37.586994,126.922882
은평구,909, 백련산 힐스테이트 3차,201912,327,114,441,37.586994,126.922882
은평구,909, 백련산 힐스테이트 3차,202001,276,104,380,37.586994,126.922882
은평구,909, 백련산 힐스테이트 3차,202002,252,77,329,37.586994,126.922882
은평구,909, 백련산 힐스테이트 3차,202003,334,120,454,37.586994,126.922882
은평구,909, 백련산 힐스테이트 3차,202004,355,177,532,37.586994,126.922882
은평구,909, 백련산 힐스테이트 3차,202005,397,172,569,37.586994,126.922882
은평구,909, 백련산 힐스테이트 3차,202006,454,191,645,37.586994,126.922882
은평구,911, 은평평화공원(역촌역4번출구),201901,441,369,810,37.605583,126.922935
은평구,911, 은평평화공원(역촌역4번출구),201902,417,396,813,37.605583,126.922935
은평구,911, 은평평화공원(역촌역4번출구),201903,806,728,1534,37.605583,126.922935
은평구,911, 은평평화공원(역촌역4번출구),201904,1117,1082,2199,37.605583,126.922935
은평구,911, 은평평화공원(역촌역4번출구),201905,2036,2063,4099,37.605583,126.922935
은평구,911, 은평평화공원(역촌역4번출구),201906,2258,2470,4728,37.605583,126.922935
은평구,911, 은평평화공원(역촌역4번출구),201907,2375,2558,4933,37.605583,126.922935
은평구,911, 은평평화공원(역촌역4번출구),201908,2300,2453,4753,37.605583,126.922935
은평구,911, 은평평화공원(역촌역4번출구),201909,2235,2272,4507,37.605583,126.922935
은평구,911, 은평평화공원(역촌역4번출구),201910,2617,2641,5258,37.605583,126.922935
은평구,911, 은평평화공원(역촌역4번출구),201911,1630,1614,3244,37.605583,126.922935
은평구,911, 은평평화공원(역촌역4번출구),201912,1009,971,1980,37.605583,126.922935
은평구,911, 은평평화공원(역촌역4번출구),202001,850,860,1710,37.605583,126.922935
은평구,911, 은평평화공원(역촌역4번출구),202002,738,720,1458,37.605583,126.922935
은평구,911, 은평평화공원(역촌역4번출구),202003,1475,1464,2939,37.605583,126.922935
은평구,911, 은평평화공원(역촌역4번출구),202004,1935,1911,3846,37.605583,126.922935
은평구,911, 은평평화공원(역촌역4번출구),202005,2214,2183,4397,37.605583,126.922935
은평구,911, 은평평화공원(역촌역4번출구),202006,2514,2512,5026,37.605583,126.922935
은평구,912, 응암오거리,201901,596,683,1279,37.589661,126.916946
은평구,912, 응암오거리,201902,522,666,1188,37.589661,126.916946
은평구,912, 응암오거리,201903,893,1119,2012,37.589661,126.916946
은평구,912, 응암오거리,201904,1290,1660,2950,37.589661,126.916946
은평구,912, 응암오거리,201905,2011,2674,4685,37.589661,126.916946
은평구,912, 응암오거리,201906,2270,2967,5237,37.589661,126.916946
은평구,912, 응암오거리,201907,2275,2900,5175,37.589661,126.916946
은평구,912, 응암오거리,201908,2079,2625,4704,37.589661,126.916946
은평구,912, 응암오거리,201909,2134,2579,4713,37.589661,126.916946
은평구,912, 응암오거리,201910,2496,3092,5588,37.589661,126.916946
은평구,912, 응암오거리,201911,1635,2169,3804,37.589661,126.916946
은평구,912, 응암오거리,201912,1015,1366,2381,37.589661,126.916946
은평구,912, 응암오거리,202001,933,1218,2151,37.589661,126.916946
은평구,912, 응암오거리,202002,844,1146,1990,37.589661,126.916946
은평구,912, 응암오거리,202003,1705,2075,3780,37.589661,126.916946
은평구,912, 응암오거리,202004,2576,2900,5476,37.589661,126.916946
은평구,912, 응암오거리,202005,2960,3346,6306,37.589661,126.916946
은평구,912, 응암오거리,202006,2794,3489,6283,37.589661,126.916946
은평구,913, 이마트 은평점,201901,675,717,1392,37.6007,126.920128
은평구,913, 이마트 은평점,201902,664,659,1323,37.6007,126.920128
은평구,913, 이마트 은평점,201903,1255,1342,2597,37.6007,126.920128
은평구,913, 이마트 은평점,201904,1779,1854,3633,37.6007,126.920128
은평구,913, 이마트 은평점,201905,2565,2673,5238,37.6007,126.920128
은평구,913, 이마트 은평점,201906,2859,2946,5805,37.6007,126.920128
은평구,913, 이마트 은평점,201907,2715,2790,5505,37.6007,126.920128
은평구,913, 이마트 은평점,201908,2766,2925,5691,37.6007,126.920128
은평구,913, 이마트 은평점,201909,2620,2765,5385,37.6007,126.920128
은평구,913, 이마트 은평점,201910,3002,3050,6052,37.6007,126.920128
은평구,913, 이마트 은평점,201911,2147,2174,4321,37.6007,126.920128
은평구,913, 이마트 은평점,201912,1285,1258,2543,37.6007,126.920128
은평구,913, 이마트 은평점,202001,1106,1130,2236,37.6007,126.920128
은평구,913, 이마트 은평점,202002,1116,1078,2194,37.6007,126.920128
은평구,913, 이마트 은평점,202003,2005,1984,3989,37.6007,126.920128
은평구,913, 이마트 은평점,202004,2857,2800,5657,37.6007,126.920128
은평구,913, 이마트 은평점,202005,3070,3035,6105,37.6007,126.920128
은평구,913, 이마트 은평점,202006,3608,3635,7243,37.6007,126.920128
은평구,914, 새절역 2번출구,201901,664,719,1383,37.590797,126.913651
은평구,914, 새절역 2번출구,201902,677,741,1418,37.590797,126.913651
은평구,914, 새절역 2번출구,201903,1357,1450,2807,37.590797,126.913651
은평구,914, 새절역 2번출구,201904,2482,2832,5314,37.590797,126.913651
은평구,914, 새절역 2번출구,201905,3349,4128,7477,37.590797,126.913651
은평구,914, 새절역 2번출구,201906,3499,4256,7755,37.590797,126.913651
은평구,914, 새절역 2번출구,201907,3051,3926,6977,37.590797,126.913651
은평구,914, 새절역 2번출구,201908,3142,3875,7017,37.590797,126.913651
은평구,914, 새절역 2번출구,201909,3447,3950,7397,37.590797,126.913651
은평구,914, 새절역 2번출구,201910,3983,4423,8406,37.590797,126.913651
은평구,914, 새절역 2번출구,201911,2265,2562,4827,37.590797,126.913651
은평구,914, 새절역 2번출구,201912,1268,1458,2726,37.590797,126.913651
은평구,914, 새절역 2번출구,202001,1147,1265,2412,37.590797,126.913651
은평구,914, 새절역 2번출구,202002,1203,1358,2561,37.590797,126.913651
은평구,914, 새절역 2번출구,202003,3385,3697,7082,37.590797,126.913651
은평구,914, 새절역 2번출구,202004,4640,5203,9843,37.590797,126.913651
은평구,914, 새절역 2번출구,202005,5045,5314,10359,37.590797,126.913651
은평구,914, 새절역 2번출구,202006,4791,5518,10309,37.590797,126.913651
은평구,915, 증산역 4번출구,201901,437,487,924,37.584381,126.909897
은평구,915, 증산역 4번출구,201902,414,487,901,37.584381,126.909897
은평구,915, 증산역 4번출구,201903,706,789,1495,37.584381,126.909897
은평구,915, 증산역 4번출구,201904,1141,1225,2366,37.584381,126.909897
은평구,915, 증산역 4번출구,201905,1449,1641,3090,37.584381,126.909897
은평구,915, 증산역 4번출구,201906,1573,1767,3340,37.584381,126.909897
은평구,915, 증산역 4번출구,201907,1474,1662,3136,37.584381,126.909897
은평구,915, 증산역 4번출구,201908,1542,1749,3291,37.584381,126.909897
은평구,915, 증산역 4번출구,201909,1474,1665,3139,37.584381,126.909897
은평구,915, 증산역 4번출구,201910,1687,1859,3546,37.584381,126.909897
은평구,915, 증산역 4번출구,201911,1009,1176,2185,37.584381,126.909897
은평구,915, 증산역 4번출구,201912,571,665,1236,37.584381,126.909897
은평구,915, 증산역 4번출구,202001,562,613,1175,37.584381,126.909897
은평구,915, 증산역 4번출구,202002,520,582,1102,37.584381,126.909897
은평구,915, 증산역 4번출구,202003,1321,1419,2740,37.584381,126.909897
은평구,915, 증산역 4번출구,202004,1857,1960,3817,37.584381,126.909897
은평구,915, 증산역 4번출구,202005,1975,2080,4055,37.584381,126.909897
은평구,915, 증산역 4번출구,202006,2028,2227,4255,37.584381,126.909897
은평구,916, 평생학습관 앞,201901,340,332,672,37.607849,126.921326
은평구,916, 평생학습관 앞,201902,283,271,554,37.607849,126.921326
은평구,916, 평생학습관 앞,201903,540,571,1111,37.607849,126.921326
은평구,916, 평생학습관 앞,201904,722,747,1469,37.607849,126.921326
은평구,916, 평생학습관 앞,201905,1268,1310,2578,37.607849,126.921326
은평구,916, 평생학습관 앞,201906,1249,1286,2535,37.607849,126.921326
은평구,916, 평생학습관 앞,201907,927,1076,2003,37.607849,126.921326
은평구,916, 평생학습관 앞,201908,922,1077,1999,37.607849,126.921326
은평구,916, 평생학습관 앞,201909,1149,1200,2349,37.607849,126.921326
은평구,916, 평생학습관 앞,201910,1399,1438,2837,37.607849,126.921326
은평구,916, 평생학습관 앞,201911,809,835,1644,37.607849,126.921326
은평구,916, 평생학습관 앞,201912,496,493,989,37.607849,126.921326
은평구,916, 평생학습관 앞,202001,451,471,922,37.607849,126.921326
은평구,916, 평생학습관 앞,202002,431,507,938,37.607849,126.921326
은평구,916, 평생학습관 앞,202003,710,728,1438,37.607849,126.921326
은평구,916, 평생학습관 앞,202004,935,942,1877,37.607849,126.921326
은평구,916, 평생학습관 앞,202005,1211,1253,2464,37.607849,126.921326
은평구,916, 평생학습관 앞,202006,1373,1492,2865,37.607849,126.921326
은평구,917, 녹번역 4번출구,201901,543,381,924,37.601299,126.935349
은평구,917, 녹번역 4번출구,201902,499,384,883,37.601299,126.935349
은평구,917, 녹번역 4번출구,201903,952,830,1782,37.601299,126.935349
은평구,917, 녹번역 4번출구,201904,1132,926,2058,37.601299,126.935349
은평구,917, 녹번역 4번출구,201905,1562,1333,2895,37.601299,126.935349
은평구,917, 녹번역 4번출구,201906,1532,1287,2819,37.601299,126.935349
은평구,917, 녹번역 4번출구,201907,1656,1404,3060,37.601299,126.935349
은평구,917, 녹번역 4번출구,201908,1601,1354,2955,37.601299,126.935349
은평구,917, 녹번역 4번출구,201909,1403,1322,2725,37.601299,126.935349
은평구,917, 녹번역 4번출구,201910,1664,1605,3269,37.601299,126.935349
은평구,917, 녹번역 4번출구,201911,1231,1189,2420,37.601299,126.935349
은평구,917, 녹번역 4번출구,201912,777,726,1503,37.601299,126.935349
은평구,917, 녹번역 4번출구,202001,652,600,1252,37.601299,126.935349
은평구,917, 녹번역 4번출구,202002,580,545,1125,37.601299,126.935349
은평구,917, 녹번역 4번출구,202003,814,770,1584,37.601299,126.935349
은평구,917, 녹번역 4번출구,202004,1167,1138,2305,37.601299,126.935349
은평구,917, 녹번역 4번출구,202005,1340,1302,2642,37.601299,126.935349
은평구,917, 녹번역 4번출구,202006,1544,1517,3061,37.601299,126.935349
은평구,919, 서울혁신파크,201901,146,139,285,37.607948,126.932503
은평구,919, 서울혁신파크,201902,109,109,218,37.607948,126.932503
은평구,919, 서울혁신파크,201903,271,268,539,37.607948,126.932503
은평구,919, 서울혁신파크,201904,477,483,960,37.607948,126.932503
은평구,919, 서울혁신파크,201905,688,630,1318,37.607948,126.932503
은평구,919, 서울혁신파크,201906,764,703,1467,37.607948,126.932503
은평구,919, 서울혁신파크,201907,766,725,1491,37.607948,126.932503
은평구,919, 서울혁신파크,201908,772,700,1472,37.607948,126.932503
은평구,919, 서울혁신파크,201909,771,741,1512,37.607948,126.932503
은평구,919, 서울혁신파크,201910,923,884,1807,37.607948,126.932503
은평구,919, 서울혁신파크,201911,617,595,1212,37.607948,126.932503
은평구,919, 서울혁신파크,201912,400,371,771,37.607948,126.932503
은평구,919, 서울혁신파크,202001,323,291,614,37.607948,126.932503
은평구,919, 서울혁신파크,202002,317,274,591,37.607948,126.932503
은평구,919, 서울혁신파크,202003,629,598,1227,37.607948,126.932503
은평구,919, 서울혁신파크,202004,816,787,1603,37.607948,126.932503
은평구,919, 서울혁신파크,202005,881,868,1749,37.607948,126.932503
은평구,919, 서울혁신파크,202006,900,889,1789,37.607948,126.932503
은평구,921, 신도고등학교,201901,153,84,237,37.630016,126.919029
은평구,921, 신도고등학교,201902,152,90,242,37.630016,126.919029
은평구,921, 신도고등학교,201903,322,167,489,37.630016,126.919029
은평구,921, 신도고등학교,201904,435,270,705,37.630016,126.919029
은평구,921, 신도고등학교,201905,580,355,935,37.630016,126.919029
은평구,921, 신도고등학교,201906,671,432,1103,37.630016,126.919029
은평구,921, 신도고등학교,201907,656,392,1048,37.630016,126.919029
은평구,921, 신도고등학교,201908,613,366,979,37.630016,126.919029
은평구,921, 신도고등학교,201909,550,395,945,37.630016,126.919029
은평구,921, 신도고등학교,201910,619,438,1057,37.630016,126.919029
은평구,921, 신도고등학교,201911,438,248,686,37.630016,126.919029
은평구,921, 신도고등학교,201912,302,168,470,37.630016,126.919029
은평구,921, 신도고등학교,202001,325,143,468,37.630016,126.919029
은평구,921, 신도고등학교,202002,291,140,431,37.630016,126.919029
은평구,921, 신도고등학교,202003,481,290,771,37.630016,126.919029
은평구,921, 신도고등학교,202004,436,346,782,37.630016,126.919029
은평구,921, 신도고등학교,202005,464,402,866,37.630016,126.919029
은평구,921, 신도고등학교,202006,615,434,1049,37.630016,126.919029
은평구,922, 연신내역 4번출구,201901,116,94,210,37.617802,126.921967
은평구,922, 연신내역 4번출구,201902,111,89,200,37.617802,126.921967
은평구,922, 연신내역 4번출구,201903,246,227,473,37.617802,126.921967
은평구,922, 연신내역 4번출구,201904,392,337,729,37.617802,126.921967
은평구,922, 연신내역 4번출구,201905,598,545,1143,37.617802,126.921967
은평구,922, 연신내역 4번출구,201906,669,603,1272,37.617802,126.921967
은평구,922, 연신내역 4번출구,201907,671,566,1237,37.617802,126.921967
은평구,922, 연신내역 4번출구,201908,685,586,1271,37.617802,126.921967
은평구,922, 연신내역 4번출구,201909,593,560,1153,37.617802,126.921967
은평구,922, 연신내역 4번출구,201910,602,568,1170,37.617802,126.921967
은평구,922, 연신내역 4번출구,201911,277,238,515,37.617802,126.921967
은평구,922, 연신내역 4번출구,201912,157,141,298,37.617802,126.921967
은평구,922, 연신내역 4번출구,202001,146,142,288,37.617802,126.921967
은평구,922, 연신내역 4번출구,202002,191,155,346,37.617802,126.921967
은평구,922, 연신내역 4번출구,202003,371,341,712,37.617802,126.921967
은평구,922, 연신내역 4번출구,202004,528,509,1037,37.617802,126.921967
은평구,922, 연신내역 4번출구,202005,496,500,996,37.617802,126.921967
은평구,922, 연신내역 4번출구,202006,655,651,1306,37.617802,126.921967
은평구,923, 국민은행 연서지점,201901,211,212,423,37.620949,126.925636
은평구,923, 국민은행 연서지점,201902,170,170,340,37.620949,126.925636
은평구,923, 국민은행 연서지점,201903,309,245,554,37.620949,126.925636
은평구,923, 국민은행 연서지점,201904,438,431,869,37.620949,126.925636
은평구,923, 국민은행 연서지점,201905,683,658,1341,37.620949,126.925636
은평구,923, 국민은행 연서지점,201906,768,733,1501,37.620949,126.925636
은평구,923, 국민은행 연서지점,201907,718,731,1449,37.620949,126.925636
은평구,923, 국민은행 연서지점,201908,636,678,1314,37.620949,126.925636
은평구,923, 국민은행 연서지점,201909,668,665,1333,37.620949,126.925636
은평구,923, 국민은행 연서지점,201910,714,722,1436,37.620949,126.925636
은평구,923, 국민은행 연서지점,201911,465,472,937,37.620949,126.925636
은평구,923, 국민은행 연서지점,201912,265,311,576,37.620949,126.925636
은평구,923, 국민은행 연서지점,202001,305,300,605,37.620949,126.925636
은평구,923, 국민은행 연서지점,202002,279,309,588,37.620949,126.925636
은평구,923, 국민은행 연서지점,202003,480,485,965,37.620949,126.925636
은평구,923, 국민은행 연서지점,202004,673,663,1336,37.620949,126.925636
은평구,923, 국민은행 연서지점,202005,622,619,1241,37.620949,126.925636
은평구,923, 국민은행 연서지점,202006,814,832,1646,37.620949,126.925636
은평구,924, 메뚜기다리,201901,66,41,107,37.628517,126.929581
은평구,924, 메뚜기다리,201902,67,38,105,37.628517,126.929581
은평구,924, 메뚜기다리,201903,147,66,213,37.628517,126.929581
은평구,924, 메뚜기다리,201904,179,97,276,37.628517,126.929581
은평구,924, 메뚜기다리,201905,349,201,550,37.628517,126.929581
은평구,924, 메뚜기다리,201906,361,201,562,37.628517,126.929581
은평구,924, 메뚜기다리,201907,332,230,562,37.628517,126.929581
은평구,924, 메뚜기다리,201908,374,177,551,37.628517,126.929581
은평구,924, 메뚜기다리,201909,362,205,567,37.628517,126.929581
은평구,924, 메뚜기다리,201910,421,225,646,37.628517,126.929581
은평구,924, 메뚜기다리,201911,306,136,442,37.628517,126.929581
은평구,924, 메뚜기다리,201912,159,57,216,37.628517,126.929581
은평구,924, 메뚜기다리,202001,138,65,203,37.628517,126.929581
은평구,924, 메뚜기다리,202002,134,59,193,37.628517,126.929581
은평구,924, 메뚜기다리,202003,253,152,405,37.628517,126.929581
은평구,924, 메뚜기다리,202004,232,169,401,37.628517,126.929581
은평구,924, 메뚜기다리,202005,321,210,531,37.628517,126.929581
은평구,924, 메뚜기다리,202006,318,193,511,37.628517,126.929581
은평구,925, 불광역 2번출구,201901,142,151,293,37.609566,126.930977
은평구,925, 불광역 2번출구,201902,159,146,305,37.609566,126.930977
은평구,925, 불광역 2번출구,201903,255,224,479,37.609566,126.930977
은평구,925, 불광역 2번출구,201904,317,309,626,37.609566,126.930977
은평구,925, 불광역 2번출구,201905,504,493,997,37.609566,126.930977
은평구,925, 불광역 2번출구,201906,562,537,1099,37.609566,126.930977
은평구,925, 불광역 2번출구,201907,489,474,963,37.609566,126.930977
은평구,925, 불광역 2번출구,201908,544,510,1054,37.609566,126.930977
은평구,925, 불광역 2번출구,201909,477,445,922,37.609566,126.930977
은평구,925, 불광역 2번출구,201910,540,522,1062,37.609566,126.930977
은평구,925, 불광역 2번출구,201911,355,334,689,37.609566,126.930977
은평구,925, 불광역 2번출구,201912,200,178,378,37.609566,126.930977
은평구,925, 불광역 2번출구,202001,217,206,423,37.609566,126.930977
은평구,925, 불광역 2번출구,202002,207,193,400,37.609566,126.930977
은평구,925, 불광역 2번출구,202003,369,366,735,37.609566,126.930977
은평구,925, 불광역 2번출구,202004,523,508,1031,37.609566,126.930977
은평구,925, 불광역 2번출구,202005,560,564,1124,37.609566,126.930977
은평구,925, 불광역 2번출구,202006,623,624,1247,37.609566,126.930977
은평구,926, 불광역 8번출구,201901,394,447,841,#N/A,#N/A
은평구,926, 불광역 8번출구,201902,369,421,790,#N/A,#N/A
은평구,926, 불광역 8번출구,201903,681,773,1454,#N/A,#N/A
은평구,926, 불광역 8번출구,201904,962,1072,2034,#N/A,#N/A
은평구,926, 불광역 8번출구,201905,1455,1528,2983,#N/A,#N/A
은평구,926, 불광역 8번출구,201906,1626,1674,3300,#N/A,#N/A
은평구,926, 불광역 8번출구,201907,1635,1729,3364,#N/A,#N/A
은평구,926, 불광역 8번출구,201908,1723,1784,3507,#N/A,#N/A
은평구,926, 불광역 8번출구,201909,1515,1553,3068,#N/A,#N/A
은평구,926, 불광역 8번출구,201910,1830,1852,3682,#N/A,#N/A
은평구,926, 불광역 8번출구,201911,1141,1186,2327,#N/A,#N/A
은평구,926, 불광역 8번출구,201912,702,728,1430,#N/A,#N/A
은평구,926, 불광역 8번출구,202001,581,603,1184,#N/A,#N/A
은평구,926, 불광역 8번출구,202002,552,577,1129,#N/A,#N/A
은평구,926, 불광역 8번출구,202003,973,982,1955,#N/A,#N/A
은평구,926, 불광역 8번출구,202004,1319,1324,2643,#N/A,#N/A
은평구,926, 불광역 8번출구,202005,1584,1591,3175,#N/A,#N/A
은평구,926, 불광역 8번출구,202006,1880,1876,3756,#N/A,#N/A
은평구,927, 연신내역 3번출구 인근,201901,135,151,286,37.617855,126.922523
은평구,927, 연신내역 3번출구 인근,201902,146,127,273,37.617855,126.922523
은평구,927, 연신내역 3번출구 인근,201903,267,320,587,37.617855,126.922523
은평구,927, 연신내역 3번출구 인근,201904,351,400,751,37.617855,126.922523
은평구,927, 연신내역 3번출구 인근,201905,578,598,1176,37.617855,126.922523
은평구,927, 연신내역 3번출구 인근,201906,608,606,1214,37.617855,126.922523
은평구,927, 연신내역 3번출구 인근,201907,617,614,1231,37.617855,126.922523
은평구,927, 연신내역 3번출구 인근,201908,669,681,1350,37.617855,126.922523
은평구,927, 연신내역 3번출구 인근,201909,628,614,1242,37.617855,126.922523
은평구,927, 연신내역 3번출구 인근,201910,607,599,1206,37.617855,126.922523
은평구,927, 연신내역 3번출구 인근,201911,424,428,852,37.617855,126.922523
은평구,927, 연신내역 3번출구 인근,201912,255,261,516,37.617855,126.922523
은평구,927, 연신내역 3번출구 인근,202001,216,249,465,37.617855,126.922523
은평구,927, 연신내역 3번출구 인근,202002,194,212,406,37.617855,126.922523
은평구,927, 연신내역 3번출구 인근,202003,322,320,642,37.617855,126.922523
은평구,927, 연신내역 3번출구 인근,202004,454,438,892,37.617855,126.922523
은평구,927, 연신내역 3번출구 인근,202005,578,576,1154,37.617855,126.922523
은평구,927, 연신내역 3번출구 인근,202006,639,629,1268,37.617855,126.922523
은평구,928, 은평역사한옥박물관,201901,24,17,41,37.641315,126.938042
은평구,928, 은평역사한옥박물관,201902,47,38,85,37.641315,126.938042
은평구,928, 은평역사한옥박물관,201903,87,62,149,37.641315,126.938042
은평구,928, 은평역사한옥박물관,201904,172,121,293,37.641315,126.938042
은평구,928, 은평역사한옥박물관,201905,259,157,416,37.641315,126.938042
은평구,928, 은평역사한옥박물관,201906,294,182,476,37.641315,126.938042
은평구,928, 은평역사한옥박물관,201907,259,147,406,37.641315,126.938042
은평구,928, 은평역사한옥박물관,201908,297,179,476,37.641315,126.938042
은평구,928, 은평역사한옥박물관,201909,290,159,449,37.641315,126.938042
은평구,928, 은평역사한옥박물관,201910,404,272,676,37.641315,126.938042
은평구,928, 은평역사한옥박물관,201911,237,128,365,37.641315,126.938042
은평구,928, 은평역사한옥박물관,201912,100,58,158,37.641315,126.938042
은평구,928, 은평역사한옥박물관,202001,102,34,136,37.641315,126.938042
은평구,928, 은평역사한옥박물관,202002,109,88,197,37.641315,126.938042
은평구,928, 은평역사한옥박물관,202003,357,275,632,37.641315,126.938042
은평구,928, 은평역사한옥박물관,202004,530,428,958,37.641315,126.938042
은평구,928, 은평역사한옥박물관,202005,457,375,832,37.641315,126.938042
은평구,928, 은평역사한옥박물관,202006,345,282,627,37.641315,126.938042
은평구,930, 구 서부경찰서 건너편,201901,181,175,356,37.601662,126.920303
은평구,930, 구 서부경찰서 건너편,201902,186,187,373,37.601662,126.920303
은평구,930, 구 서부경찰서 건너편,201903,327,318,645,37.601662,126.920303
은평구,930, 구 서부경찰서 건너편,201904,474,486,960,37.601662,126.920303
은평구,930, 구 서부경찰서 건너편,201905,620,692,1312,37.601662,126.920303
은평구,930, 구 서부경찰서 건너편,201906,640,701,1341,37.601662,126.920303
은평구,930, 구 서부경찰서 건너편,201907,732,811,1543,37.601662,126.920303
은평구,930, 구 서부경찰서 건너편,201908,750,790,1540,37.601662,126.920303
은평구,930, 구 서부경찰서 건너편,201909,588,611,1199,37.601662,126.920303
은평구,930, 구 서부경찰서 건너편,201910,772,809,1581,37.601662,126.920303
은평구,930, 구 서부경찰서 건너편,201911,524,556,1080,37.601662,126.920303
은평구,930, 구 서부경찰서 건너편,201912,334,358,692,37.601662,126.920303
은평구,930, 구 서부경찰서 건너편,202001,285,329,614,37.601662,126.920303
은평구,930, 구 서부경찰서 건너편,202002,234,259,493,37.601662,126.920303
은평구,930, 구 서부경찰서 건너편,202003,490,501,991,37.601662,126.920303
은평구,930, 구 서부경찰서 건너편,202004,801,797,1598,37.601662,126.920303
은평구,930, 구 서부경찰서 건너편,202005,937,921,1858,37.601662,126.920303
은평구,930, 구 서부경찰서 건너편,202006,1114,1176,2290,37.601662,126.920303
은평구,931, 역촌파출소,201901,577,719,1296,37.604736,126.915337
은평구,931, 역촌파출소,201902,541,654,1195,37.604736,126.915337
은평구,931, 역촌파출소,201903,1104,1294,2398,37.604736,126.915337
은평구,931, 역촌파출소,201904,1402,1735,3137,37.604736,126.915337
은평구,931, 역촌파출소,201905,2157,2739,4896,37.604736,126.915337
은평구,931, 역촌파출소,201906,2381,3044,5425,37.604736,126.915337
은평구,931, 역촌파출소,201907,2381,3144,5525,37.604736,126.915337
은평구,931, 역촌파출소,201908,2264,3031,5295,37.604736,126.915337
은평구,931, 역촌파출소,201909,2347,2997,5344,37.604736,126.915337
은평구,931, 역촌파출소,201910,2749,3330,6079,37.604736,126.915337
은평구,931, 역촌파출소,201911,1876,2295,4171,37.604736,126.915337
은평구,931, 역촌파출소,201912,1161,1466,2627,37.604736,126.915337
은평구,931, 역촌파출소,202001,1149,1305,2454,37.604736,126.915337
은평구,931, 역촌파출소,202002,1056,1274,2330,37.604736,126.915337
은평구,931, 역촌파출소,202003,1967,2070,4037,37.604736,126.915337
은평구,931, 역촌파출소,202004,2965,3120,6085,37.604736,126.915337
은평구,931, 역촌파출소,202005,3227,3480,6707,37.604736,126.915337
은평구,931, 역촌파출소,202006,3291,3921,7212,37.604736,126.915337
은평구,932, 예일여중,201901,190,201,391,37.610004,126.916397
은평구,932, 예일여중,201902,206,206,412,37.610004,126.916397
은평구,932, 예일여중,201903,373,397,770,37.610004,126.916397
은평구,932, 예일여중,201904,540,568,1108,37.610004,126.916397
은평구,932, 예일여중,201905,865,911,1776,37.610004,126.916397
은평구,932, 예일여중,201906,894,904,1798,37.610004,126.916397
은평구,932, 예일여중,201907,922,940,1862,37.610004,126.916397
은평구,932, 예일여중,201908,925,948,1873,37.610004,126.916397
은평구,932, 예일여중,201909,968,992,1960,37.610004,126.916397
은평구,932, 예일여중,201910,1154,1121,2275,37.610004,126.916397
은평구,932, 예일여중,201911,731,710,1441,37.610004,126.916397
은평구,932, 예일여중,201912,403,388,791,37.610004,126.916397
은평구,932, 예일여중,202001,359,356,715,37.610004,126.916397
은평구,932, 예일여중,202002,358,326,684,37.610004,126.916397
은평구,932, 예일여중,202003,561,518,1079,37.610004,126.916397
은평구,932, 예일여중,202004,1002,969,1971,37.610004,126.916397
은평구,932, 예일여중,202005,1098,1111,2209,37.610004,126.916397
은평구,932, 예일여중,202006,1340,1374,2714,37.610004,126.916397
은평구,933, LG서비스 역촌점,201901,407,397,804,37.612484,126.914879
은평구,933, LG서비스 역촌점,201902,390,366,756,37.612484,126.914879
은평구,933, LG서비스 역촌점,201903,604,642,1246,37.612484,126.914879
은평구,933, LG서비스 역촌점,201904,893,987,1880,37.612484,126.914879
은평구,933, LG서비스 역촌점,201905,1258,1549,2807,37.612484,126.914879
은평구,933, LG서비스 역촌점,201906,1368,1566,2934,37.612484,126.914879
은평구,933, LG서비스 역촌점,201907,1388,1627,3015,37.612484,126.914879
은평구,933, LG서비스 역촌점,201908,1489,1787,3276,37.612484,126.914879
은평구,933, LG서비스 역촌점,201909,1388,1657,3045,37.612484,126.914879
은평구,933, LG서비스 역촌점,201910,1617,1856,3473,37.612484,126.914879
은평구,933, LG서비스 역촌점,201911,1044,1164,2208,37.612484,126.914879
은평구,933, LG서비스 역촌점,201912,704,722,1426,37.612484,126.914879
은평구,933, LG서비스 역촌점,202001,620,623,1243,37.612484,126.914879
은평구,933, LG서비스 역촌점,202002,603,611,1214,37.612484,126.914879
은평구,933, LG서비스 역촌점,202003,1138,1169,2307,37.612484,126.914879
은평구,933, LG서비스 역촌점,202004,1739,1803,3542,37.612484,126.914879
은평구,933, LG서비스 역촌점,202005,1939,2039,3978,37.612484,126.914879
은평구,933, LG서비스 역촌점,202006,2073,2159,4232,37.612484,126.914879
은평구,934, 신사동 성당,201901,233,239,472,37.597141,126.909599
은평구,934, 신사동 성당,201902,239,217,456,37.597141,126.909599
은평구,934, 신사동 성당,201903,508,371,879,37.597141,126.909599
은평구,934, 신사동 성당,201904,660,560,1220,37.597141,126.909599
은평구,934, 신사동 성당,201905,983,889,1872,37.597141,126.909599
은평구,934, 신사동 성당,201906,1168,1118,2286,37.597141,126.909599
은평구,934, 신사동 성당,201907,1166,1176,2342,37.597141,126.909599
은평구,934, 신사동 성당,201908,1176,1154,2330,37.597141,126.909599
은평구,934, 신사동 성당,201909,1004,968,1972,37.597141,126.909599
은평구,934, 신사동 성당,201910,1129,1113,2242,37.597141,126.909599
은평구,934, 신사동 성당,201911,832,762,1594,37.597141,126.909599
은평구,934, 신사동 성당,201912,542,413,955,37.597141,126.909599
은평구,934, 신사동 성당,202001,479,411,890,37.597141,126.909599
은평구,934, 신사동 성당,202002,445,386,831,37.597141,126.909599
은평구,934, 신사동 성당,202003,724,645,1369,37.597141,126.909599
은평구,934, 신사동 성당,202004,1002,1005,2007,37.597141,126.909599
은평구,934, 신사동 성당,202005,1172,1161,2333,37.597141,126.909599
은평구,934, 신사동 성당,202006,1277,1268,2545,37.597141,126.909599
은평구,935, 역촌역 1번 출구,201901,389,395,784,#N/A,#N/A
은평구,935, 역촌역 1번 출구,201902,325,337,662,#N/A,#N/A
은평구,935, 역촌역 1번 출구,201903,536,535,1071,#N/A,#N/A
은평구,935, 역촌역 1번 출구,201904,720,768,1488,#N/A,#N/A
은평구,935, 역촌역 1번 출구,201905,45,40,85,#N/A,#N/A
은평구,937, 상림마을 롯데캐슬2단지 옆,201901,10,9,19,37.645851,126.923798
은평구,937, 상림마을 롯데캐슬2단지 옆,201902,5,3,8,37.645851,126.923798
은평구,937, 상림마을 롯데캐슬2단지 옆,201903,23,20,43,37.645851,126.923798
은평구,937, 상림마을 롯데캐슬2단지 옆,201904,43,44,87,37.645851,126.923798
은평구,937, 상림마을 롯데캐슬2단지 옆,201905,73,77,150,37.645851,126.923798
은평구,937, 상림마을 롯데캐슬2단지 옆,201906,77,98,175,37.645851,126.923798
은평구,937, 상림마을 롯데캐슬2단지 옆,201907,82,93,175,37.645851,126.923798
은평구,937, 상림마을 롯데캐슬2단지 옆,201908,81,75,156,37.645851,126.923798
은평구,937, 상림마을 롯데캐슬2단지 옆,201909,89,96,185,37.645851,126.923798
은평구,937, 상림마을 롯데캐슬2단지 옆,201910,144,147,291,37.645851,126.923798
은평구,937, 상림마을 롯데캐슬2단지 옆,201911,48,57,105,37.645851,126.923798
은평구,937, 상림마을 롯데캐슬2단지 옆,201912,25,44,69,37.645851,126.923798
은평구,937, 상림마을 롯데캐슬2단지 옆,202001,12,28,40,37.645851,126.923798
은평구,937, 상림마을 롯데캐슬2단지 옆,202002,33,47,80,37.645851,126.923798
은평구,937, 상림마을 롯데캐슬2단지 옆,202003,120,109,229,37.645851,126.923798
은평구,937, 상림마을 롯데캐슬2단지 옆,202004,225,206,431,37.645851,126.923798
은평구,937, 상림마을 롯데캐슬2단지 옆,202005,220,188,408,37.645851,126.923798
은평구,937, 상림마을 롯데캐슬2단지 옆,202006,199,177,376,37.645851,126.923798
은평구,938, 금암 문화공원,201901,6,13,19,37.644684,126.918457
은평구,938, 금암 문화공원,201902,13,20,33,37.644684,126.918457
은평구,938, 금암 문화공원,201903,26,27,53,37.644684,126.918457
은평구,938, 금암 문화공원,201904,56,58,114,37.644684,126.918457
은평구,938, 금암 문화공원,201905,106,94,200,37.644684,126.918457
은평구,938, 금암 문화공원,201906,141,126,267,37.644684,126.918457
은평구,938, 금암 문화공원,201907,110,95,205,37.644684,126.918457
은평구,938, 금암 문화공원,201908,106,85,191,37.644684,126.918457
은평구,938, 금암 문화공원,201909,152,132,284,37.644684,126.918457
은평구,938, 금암 문화공원,201910,217,179,396,37.644684,126.918457
은평구,938, 금암 문화공원,201911,82,96,178,37.644684,126.918457
은평구,938, 금암 문화공원,201912,67,53,120,37.644684,126.918457
은평구,938, 금암 문화공원,202001,44,36,80,37.644684,126.918457
은평구,938, 금암 문화공원,202002,56,57,113,37.644684,126.918457
은평구,938, 금암 문화공원,202003,219,193,412,37.644684,126.918457
은평구,938, 금암 문화공원,202004,314,291,605,37.644684,126.918457
은평구,938, 금암 문화공원,202005,295,255,550,37.644684,126.918457
은평구,938, 금암 문화공원,202006,294,306,600,37.644684,126.918457
은평구,939, 은평구청 교차로,201901,172,142,314,37.6017,126.927422
은평구,939, 은평구청 교차로,201902,143,141,284,37.6017,126.927422
은평구,939, 은평구청 교차로,201903,322,244,566,37.6017,126.927422
은평구,939, 은평구청 교차로,201904,530,447,977,37.6017,126.927422
은평구,939, 은평구청 교차로,201905,757,654,1411,37.6017,126.927422
은평구,939, 은평구청 교차로,201906,792,669,1461,37.6017,126.927422
은평구,939, 은평구청 교차로,201907,770,688,1458,37.6017,126.927422
은평구,939, 은평구청 교차로,201908,730,638,1368,37.6017,126.927422
은평구,939, 은평구청 교차로,201909,744,645,1389,37.6017,126.927422
은평구,939, 은평구청 교차로,201910,796,686,1482,37.6017,126.927422
은평구,939, 은평구청 교차로,201911,525,431,956,37.6017,126.927422
은평구,939, 은평구청 교차로,201912,343,327,670,37.6017,126.927422
은평구,939, 은평구청 교차로,202001,322,255,577,37.6017,126.927422
은평구,939, 은평구청 교차로,202002,269,239,508,37.6017,126.927422
은평구,939, 은평구청 교차로,202003,474,370,844,37.6017,126.927422
은평구,939, 은평구청 교차로,202004,574,510,1084,37.6017,126.927422
은평구,939, 은평구청 교차로,202005,650,618,1268,37.6017,126.927422
은평구,939, 은평구청 교차로,202006,812,682,1494,37.6017,126.927422
은평구,941, 은평뉴타운 도서관,201901,320,124,444,37.637222,126.933304
은평구,941, 은평뉴타운 도서관,201902,317,135,452,37.637222,126.933304
은평구,941, 은평뉴타운 도서관,201903,585,245,830,37.637222,126.933304
은평구,941, 은평뉴타운 도서관,201904,709,311,1020,37.637222,126.933304
은평구,941, 은평뉴타운 도서관,201905,816,381,1197,37.637222,126.933304
은평구,941, 은평뉴타운 도서관,201906,901,465,1366,37.637222,126.933304
은평구,941, 은평뉴타운 도서관,201907,779,320,1099,37.637222,126.933304
은평구,941, 은평뉴타운 도서관,201908,747,337,1084,37.637222,126.933304
은평구,941, 은평뉴타운 도서관,201909,645,349,994,37.637222,126.933304
은평구,941, 은평뉴타운 도서관,201910,656,308,964,37.637222,126.933304
은평구,941, 은평뉴타운 도서관,201911,609,269,878,37.637222,126.933304
은평구,941, 은평뉴타운 도서관,201912,474,144,618,37.637222,126.933304
은평구,941, 은평뉴타운 도서관,202001,388,144,532,37.637222,126.933304
은평구,941, 은평뉴타운 도서관,202002,297,91,388,37.637222,126.933304
은평구,941, 은평뉴타운 도서관,202003,474,230,704,37.637222,126.933304
은평구,941, 은평뉴타운 도서관,202004,439,293,732,37.637222,126.933304
은평구,941, 은평뉴타운 도서관,202005,482,318,800,37.637222,126.933304
은평구,941, 은평뉴타운 도서관,202006,568,383,951,37.637222,126.933304
은평구,942, 상림마을 생태공원,201901,73,43,116,37.644081,126.929283
은평구,942, 상림마을 생태공원,201902,86,66,152,37.644081,126.929283
은평구,942, 상림마을 생태공원,201903,194,168,362,37.644081,126.929283
은평구,942, 상림마을 생태공원,201904,213,235,448,37.644081,126.929283
은평구,942, 상림마을 생태공원,201905,389,376,765,37.644081,126.929283
은평구,942, 상림마을 생태공원,201906,431,459,890,37.644081,126.929283
은평구,942, 상림마을 생태공원,201907,456,457,913,37.644081,126.929283
은평구,942, 상림마을 생태공원,201908,432,461,893,37.644081,126.929283
은평구,942, 상림마을 생태공원,201909,435,437,872,37.644081,126.929283
은평구,942, 상림마을 생태공원,201910,490,437,927,37.644081,126.929283
은평구,942, 상림마을 생태공원,201911,259,215,474,37.644081,126.929283
은평구,942, 상림마을 생태공원,201912,147,148,295,37.644081,126.929283
은평구,942, 상림마을 생태공원,202001,174,148,322,37.644081,126.929283
은평구,942, 상림마을 생태공원,202002,156,131,287,37.644081,126.929283
은평구,942, 상림마을 생태공원,202003,221,188,409,37.644081,126.929283
은평구,942, 상림마을 생태공원,202004,321,297,618,37.644081,126.929283
은평구,942, 상림마을 생태공원,202005,444,433,877,37.644081,126.929283
은평구,942, 상림마을 생태공원,202006,511,483,994,37.644081,126.929283
은평구,943, 은평구청 보건소,201901,376,447,823,37.602402,126.92865
은평구,943, 은평구청 보건소,201902,322,367,689,37.602402,126.92865
은평구,943, 은평구청 보건소,201903,799,897,1696,37.602402,126.92865
은평구,943, 은평구청 보건소,201904,970,1111,2081,37.602402,126.92865
은평구,943, 은평구청 보건소,201905,1452,1570,3022,37.602402,126.92865
은평구,943, 은평구청 보건소,201906,1533,1722,3255,37.602402,126.92865
은평구,943, 은평구청 보건소,201907,1456,1652,3108,37.602402,126.92865
은평구,943, 은평구청 보건소,201908,1613,1873,3486,37.602402,126.92865
은평구,943, 은평구청 보건소,201909,1632,1854,3486,37.602402,126.92865
은평구,943, 은평구청 보건소,201910,1833,2117,3950,37.602402,126.92865
은평구,943, 은평구청 보건소,201911,1413,1510,2923,37.602402,126.92865
은평구,943, 은평구청 보건소,201912,858,1001,1859,37.602402,126.92865
은평구,943, 은평구청 보건소,202001,732,902,1634,37.602402,126.92865
은평구,943, 은평구청 보건소,202002,606,754,1360,37.602402,126.92865
은평구,943, 은평구청 보건소,202003,880,1022,1902,37.602402,126.92865
은평구,943, 은평구청 보건소,202004,1201,1265,2466,37.602402,126.92865
은평구,943, 은평구청 보건소,202005,1484,1502,2986,37.602402,126.92865
은평구,943, 은평구청 보건소,202006,1775,1892,3667,37.602402,126.92865
은평구,945, 기자촌 사거리,201901,261,71,332,37.63414,126.932343
은평구,945, 기자촌 사거리,201902,221,79,300,37.63414,126.932343
은평구,945, 기자촌 사거리,201903,326,116,442,37.63414,126.932343
은평구,945, 기자촌 사거리,201904,453,174,627,37.63414,126.932343
은평구,945, 기자촌 사거리,201905,635,334,969,37.63414,126.932343
은평구,945, 기자촌 사거리,201906,694,383,1077,37.63414,126.932343
은평구,945, 기자촌 사거리,201907,700,291,991,37.63414,126.932343
은평구,945, 기자촌 사거리,201908,621,214,835,37.63414,126.932343
은평구,945, 기자촌 사거리,201909,494,209,703,37.63414,126.932343
은평구,945, 기자촌 사거리,201910,611,275,886,37.63414,126.932343
은평구,945, 기자촌 사거리,201911,358,117,475,37.63414,126.932343
은평구,945, 기자촌 사거리,201912,315,82,397,37.63414,126.932343
은평구,945, 기자촌 사거리,202001,327,91,418,37.63414,126.932343
은평구,945, 기자촌 사거리,202002,318,115,433,37.63414,126.932343
은평구,945, 기자촌 사거리,202003,437,244,681,37.63414,126.932343
은평구,945, 기자촌 사거리,202004,390,256,646,37.63414,126.932343
은평구,945, 기자촌 사거리,202005,497,353,850,37.63414,126.932343
은평구,945, 기자촌 사거리,202006,619,394,1013,37.63414,126.932343
은평구,946, 독바위역,201901,205,145,350,37.618439,126.932884
은평구,946, 독바위역,201902,197,123,320,37.618439,126.932884
은평구,946, 독바위역,201903,391,247,638,37.618439,126.932884
은평구,946, 독바위역,201904,476,356,832,37.618439,126.932884
은평구,946, 독바위역,201905,586,503,1089,37.618439,126.932884
은평구,946, 독바위역,201906,713,657,1370,37.618439,126.932884
은평구,946, 독바위역,201907,796,680,1476,37.618439,126.932884
은평구,946, 독바위역,201908,719,632,1351,37.618439,126.932884
은평구,946, 독바위역,201909,705,655,1360,37.618439,126.932884
은평구,946, 독바위역,201910,806,774,1580,37.618439,126.932884
은평구,946, 독바위역,201911,456,425,881,37.618439,126.932884
은평구,946, 독바위역,201912,343,299,642,37.618439,126.932884
은평구,946, 독바위역,202001,333,287,620,37.618439,126.932884
은평구,946, 독바위역,202002,324,293,617,37.618439,126.932884
은평구,946, 독바위역,202003,427,392,819,37.618439,126.932884
은평구,946, 독바위역,202004,544,533,1077,37.618439,126.932884
은평구,946, 독바위역,202005,752,737,1489,37.618439,126.932884
은평구,946, 독바위역,202006,731,676,1407,37.618439,126.932884
은평구,947, 연신내 선일하이츠빌 정류소,201901,171,169,340,37.622669,126.919991
은평구,947, 연신내 선일하이츠빌 정류소,201902,144,158,302,37.622669,126.919991
은평구,947, 연신내 선일하이츠빌 정류소,201903,254,280,534,37.622669,126.919991
은평구,947, 연신내 선일하이츠빌 정류소,201904,401,408,809,37.622669,126.919991
은평구,947, 연신내 선일하이츠빌 정류소,201905,701,705,1406,37.622669,126.919991
은평구,947, 연신내 선일하이츠빌 정류소,201906,751,801,1552,37.622669,126.919991
은평구,947, 연신내 선일하이츠빌 정류소,201907,664,659,1323,37.622669,126.919991
은평구,947, 연신내 선일하이츠빌 정류소,201908,636,623,1259,37.622669,126.919991
은평구,947, 연신내 선일하이츠빌 정류소,201909,683,701,1384,37.622669,126.919991
은평구,947, 연신내 선일하이츠빌 정류소,201910,776,746,1522,37.622669,126.919991
은평구,947, 연신내 선일하이츠빌 정류소,201911,515,451,966,37.622669,126.919991
은평구,947, 연신내 선일하이츠빌 정류소,201912,297,262,559,37.622669,126.919991
은평구,947, 연신내 선일하이츠빌 정류소,202001,288,245,533,37.622669,126.919991
은평구,947, 연신내 선일하이츠빌 정류소,202002,297,238,535,37.622669,126.919991
은평구,947, 연신내 선일하이츠빌 정류소,202003,600,545,1145,37.622669,126.919991
은평구,947, 연신내 선일하이츠빌 정류소,202004,922,912,1834,37.622669,126.919991
은평구,947, 연신내 선일하이츠빌 정류소,202005,970,963,1933,37.622669,126.919991
은평구,947, 연신내 선일하이츠빌 정류소,202006,1146,1130,2276,37.622669,126.919991
은평구,948, 디지털미디어 시티역 4번출구,201901,301,213,514,37.577202,126.902351
은평구,948, 디지털미디어 시티역 4번출구,201902,228,149,377,37.577202,126.902351
은평구,948, 디지털미디어 시티역 4번출구,201903,438,330,768,37.577202,126.902351
은평구,948, 디지털미디어 시티역 4번출구,201904,411,344,755,37.577202,126.902351
은평구,948, 디지털미디어 시티역 4번출구,201905,665,581,1246,37.577202,126.902351
은평구,948, 디지털미디어 시티역 4번출구,201906,765,726,1491,37.577202,126.902351
은평구,948, 디지털미디어 시티역 4번출구,201907,745,665,1410,37.577202,126.902351
은평구,948, 디지털미디어 시티역 4번출구,201908,791,706,1497,37.577202,126.902351
은평구,948, 디지털미디어 시티역 4번출구,201909,715,676,1391,37.577202,126.902351
은평구,948, 디지털미디어 시티역 4번출구,201910,734,721,1455,37.577202,126.902351
은평구,948, 디지털미디어 시티역 4번출구,201911,624,573,1197,37.577202,126.902351
은평구,948, 디지털미디어 시티역 4번출구,201912,374,314,688,37.577202,126.902351
은평구,948, 디지털미디어 시티역 4번출구,202001,346,293,639,37.577202,126.902351
은평구,948, 디지털미디어 시티역 4번출구,202002,301,283,584,37.577202,126.902351
은평구,948, 디지털미디어 시티역 4번출구,202003,455,444,899,37.577202,126.902351
은평구,948, 디지털미디어 시티역 4번출구,202004,534,524,1058,37.577202,126.902351
은평구,948, 디지털미디어 시티역 4번출구,202005,583,565,1148,37.577202,126.902351
은평구,948, 디지털미디어 시티역 4번출구,202006,748,709,1457,37.577202,126.902351
은평구,949, 연신내역 1번 출구,201901,77,213,290,37.619781,126.920807
은평구,949, 연신내역 1번 출구,201902,81,207,288,37.619781,126.920807
은평구,949, 연신내역 1번 출구,201903,152,329,481,37.619781,126.920807
은평구,949, 연신내역 1번 출구,201904,319,488,807,37.619781,126.920807
은평구,949, 연신내역 1번 출구,201905,583,785,1368,37.619781,126.920807
은평구,949, 연신내역 1번 출구,201906,660,797,1457,37.619781,126.920807
은평구,949, 연신내역 1번 출구,201907,716,872,1588,37.619781,126.920807
은평구,949, 연신내역 1번 출구,201908,750,933,1683,37.619781,126.920807
은평구,949, 연신내역 1번 출구,201909,760,824,1584,37.619781,126.920807
은평구,949, 연신내역 1번 출구,201910,825,951,1776,37.619781,126.920807
은평구,949, 연신내역 1번 출구,201911,528,823,1351,37.619781,126.920807
은평구,949, 연신내역 1번 출구,201912,326,552,878,37.619781,126.920807
은평구,949, 연신내역 1번 출구,202001,329,464,793,37.619781,126.920807
은평구,949, 연신내역 1번 출구,202002,286,416,702,37.619781,126.920807
은평구,949, 연신내역 1번 출구,202003,463,581,1044,37.619781,126.920807
은평구,949, 연신내역 1번 출구,202004,758,776,1534,37.619781,126.920807
은평구,949, 연신내역 1번 출구,202005,872,876,1748,37.619781,126.920807
은평구,949, 연신내역 1번 출구,202006,1069,1154,2223,37.619781,126.920807
은평구,950, 구산역 2번 출구,201901,291,308,599,37.610779,126.917351
은평구,950, 구산역 2번 출구,201902,305,348,653,37.610779,126.917351
은평구,950, 구산역 2번 출구,201903,568,700,1268,37.610779,126.917351
은평구,950, 구산역 2번 출구,201904,793,960,1753,37.610779,126.917351
은평구,950, 구산역 2번 출구,201905,1087,1355,2442,37.610779,126.917351
은평구,950, 구산역 2번 출구,201906,1171,1403,2574,37.610779,126.917351
은평구,950, 구산역 2번 출구,201907,1141,1392,2533,37.610779,126.917351
은평구,950, 구산역 2번 출구,201908,1124,1424,2548,37.610779,126.917351
은평구,950, 구산역 2번 출구,201909,1189,1435,2624,37.610779,126.917351
은평구,950, 구산역 2번 출구,201910,1526,1804,3330,37.610779,126.917351
은평구,950, 구산역 2번 출구,201911,964,1166,2130,37.610779,126.917351
은평구,950, 구산역 2번 출구,201912,543,752,1295,37.610779,126.917351
은평구,950, 구산역 2번 출구,202001,479,633,1112,37.610779,126.917351
은평구,950, 구산역 2번 출구,202002,506,640,1146,37.610779,126.917351
은평구,950, 구산역 2번 출구,202003,1075,1200,2275,37.610779,126.917351
은평구,950, 구산역 2번 출구,202004,1753,1824,3577,37.610779,126.917351
은평구,950, 구산역 2번 출구,202005,1802,1913,3715,37.610779,126.917351
은평구,950, 구산역 2번 출구,202006,1953,2196,4149,37.610779,126.917351
은평구,951, 연신내역 6번출구옆,201901,353,293,646,#N/A,#N/A
은평구,951, 연신내역 6번출구옆,201902,394,325,719,#N/A,#N/A
은평구,951, 연신내역 6번출구옆,201903,680,573,1253,#N/A,#N/A
은평구,951, 연신내역 6번출구옆,201904,931,786,1717,#N/A,#N/A
은평구,951, 연신내역 6번출구옆,201905,1282,1176,2458,#N/A,#N/A
은평구,951, 연신내역 6번출구옆,201906,1438,1408,2846,#N/A,#N/A
은평구,951, 연신내역 6번출구옆,201907,1306,1254,2560,#N/A,#N/A
은평구,951, 연신내역 6번출구옆,201908,1329,1266,2595,#N/A,#N/A
은평구,951, 연신내역 6번출구옆,201909,1016,991,2007,#N/A,#N/A
은평구,951, 연신내역 6번출구옆,201910,1309,1296,2605,#N/A,#N/A
은평구,951, 연신내역 6번출구옆,201911,969,969,1938,#N/A,#N/A
은평구,951, 연신내역 6번출구옆,201912,679,674,1353,#N/A,#N/A
은평구,951, 연신내역 6번출구옆,202001,545,522,1067,#N/A,#N/A
은평구,951, 연신내역 6번출구옆,202002,525,528,1053,#N/A,#N/A
은평구,951, 연신내역 6번출구옆,202003,921,919,1840,#N/A,#N/A
은평구,951, 연신내역 6번출구옆,202004,1243,1241,2484,#N/A,#N/A
은평구,951, 연신내역 6번출구옆,202005,1347,1339,2686,#N/A,#N/A
은평구,951, 연신내역 6번출구옆,202006,1584,1587,3171,#N/A,#N/A
은평구,952, 서울연신중학교,201901,157,89,246,37.62265,126.925247
은평구,952, 서울연신중학교,201902,121,81,202,37.62265,126.925247
은평구,952, 서울연신중학교,201903,207,140,347,37.62265,126.925247
은평구,952, 서울연신중학교,201904,284,194,478,37.62265,126.925247
은평구,952, 서울연신중학교,201905,372,293,665,37.62265,126.925247
은평구,952, 서울연신중학교,201906,366,297,663,37.62265,126.925247
은평구,952, 서울연신중학교,201907,405,308,713,37.62265,126.925247
은평구,952, 서울연신중학교,201908,463,378,841,37.62265,126.925247
은평구,952, 서울연신중학교,201909,370,297,667,37.62265,126.925247
은평구,952, 서울연신중학교,201910,459,327,786,37.62265,126.925247
은평구,952, 서울연신중학교,201911,387,264,651,37.62265,126.925247
은평구,952, 서울연신중학교,201912,229,141,370,37.62265,126.925247
은평구,952, 서울연신중학교,202001,205,120,325,37.62265,126.925247
은평구,952, 서울연신중학교,202002,222,128,350,37.62265,126.925247
은평구,952, 서울연신중학교,202003,270,157,427,37.62265,126.925247
은평구,952, 서울연신중학교,202004,233,212,445,37.62265,126.925247
은평구,952, 서울연신중학교,202005,347,338,685,37.62265,126.925247
은평구,952, 서울연신중학교,202006,515,493,1008,37.62265,126.925247
은평구,953, 서울연신초등학교,201901,118,73,191,37.625778,126.928818
은평구,953, 서울연신초등학교,201902,98,96,194,37.625778,126.928818
은평구,953, 서울연신초등학교,201903,166,167,333,37.625778,126.928818
은평구,953, 서울연신초등학교,201904,283,265,548,37.625778,126.928818
은평구,953, 서울연신초등학교,201905,456,408,864,37.625778,126.928818
은평구,953, 서울연신초등학교,201906,631,629,1260,37.625778,126.928818
은평구,953, 서울연신초등학교,201907,554,497,1051,37.625778,126.928818
은평구,953, 서울연신초등학교,201908,448,422,870,37.625778,126.928818
은평구,953, 서울연신초등학교,201909,447,424,871,37.625778,126.928818
은평구,953, 서울연신초등학교,201910,520,507,1027,37.625778,126.928818
은평구,953, 서울연신초등학교,201911,374,367,741,37.625778,126.928818
은평구,953, 서울연신초등학교,201912,249,244,493,37.625778,126.928818
은평구,953, 서울연신초등학교,202001,205,179,384,37.625778,126.928818
은평구,953, 서울연신초등학교,202002,185,158,343,37.625778,126.928818
은평구,953, 서울연신초등학교,202003,394,350,744,37.625778,126.928818
은평구,953, 서울연신초등학교,202004,558,565,1123,37.625778,126.928818
은평구,953, 서울연신초등학교,202005,664,643,1307,37.625778,126.928818
은평구,953, 서울연신초등학교,202006,701,672,1373,37.625778,126.928818
은평구,954, 은평뉴타운구파발9단지,201901,158,137,295,37.642609,126.921478
은평구,954, 은평뉴타운구파발9단지,201902,155,142,297,37.642609,126.921478
은평구,954, 은평뉴타운구파발9단지,201903,280,256,536,37.642609,126.921478
은평구,954, 은평뉴타운구파발9단지,201904,366,366,732,37.642609,126.921478
은평구,954, 은평뉴타운구파발9단지,201905,522,527,1049,37.642609,126.921478
은평구,954, 은평뉴타운구파발9단지,201906,558,597,1155,37.642609,126.921478
은평구,954, 은평뉴타운구파발9단지,201907,562,635,1197,37.642609,126.921478
은평구,954, 은평뉴타운구파발9단지,201908,599,656,1255,37.642609,126.921478
은평구,954, 은평뉴타운구파발9단지,201909,590,656,1246,37.642609,126.921478
은평구,954, 은평뉴타운구파발9단지,201910,646,701,1347,37.642609,126.921478
은평구,954, 은평뉴타운구파발9단지,201911,375,453,828,37.642609,126.921478
은평구,954, 은평뉴타운구파발9단지,201912,207,274,481,37.642609,126.921478
은평구,954, 은평뉴타운구파발9단지,202001,252,281,533,37.642609,126.921478
은평구,954, 은평뉴타운구파발9단지,202002,206,236,442,37.642609,126.921478
은평구,954, 은평뉴타운구파발9단지,202003,420,409,829,37.642609,126.921478
은평구,954, 은평뉴타운구파발9단지,202004,603,615,1218,37.642609,126.921478
은평구,954, 은평뉴타운구파발9단지,202005,736,726,1462,37.642609,126.921478
은평구,954, 은평뉴타운구파발9단지,202006,841,809,1650,37.642609,126.921478
은평구,956, 응암시장교차로,201901,410,454,864,37.594376,126.918159
은평구,956, 응암시장교차로,201902,334,366,700,37.594376,126.918159
은평구,956, 응암시장교차로,201903,667,842,1509,37.594376,126.918159
은평구,956, 응암시장교차로,201904,931,1176,2107,37.594376,126.918159
은평구,956, 응암시장교차로,201905,1602,2005,3607,37.594376,126.918159
은평구,956, 응암시장교차로,201906,1714,2261,3975,37.594376,126.918159
은평구,956, 응암시장교차로,201907,1604,2188,3792,37.594376,126.918159
은평구,956, 응암시장교차로,201908,1630,2338,3968,37.594376,126.918159
은평구,956, 응암시장교차로,201909,1733,2251,3984,37.594376,126.918159
은평구,956, 응암시장교차로,201910,2208,2962,5170,37.594376,126.918159
은평구,956, 응암시장교차로,201911,1466,2046,3512,37.594376,126.918159
은평구,956, 응암시장교차로,201912,999,1368,2367,37.594376,126.918159
은평구,956, 응암시장교차로,202001,916,1231,2147,37.594376,126.918159
은평구,956, 응암시장교차로,202002,767,1070,1837,37.594376,126.918159
은평구,956, 응암시장교차로,202003,1716,2066,3782,37.594376,126.918159
은평구,956, 응암시장교차로,202004,2462,2852,5314,37.594376,126.918159
은평구,956, 응암시장교차로,202005,3026,3385,6411,37.594376,126.918159
은평구,956, 응암시장교차로,202006,3167,3781,6948,37.594376,126.918159
은평구,958, 신한은행 응암동 지점 앞,201901,216,243,459,37.600361,126.922813
은평구,958, 신한은행 응암동 지점 앞,201902,226,242,468,37.600361,126.922813
은평구,958, 신한은행 응암동 지점 앞,201903,405,438,843,37.600361,126.922813
은평구,958, 신한은행 응암동 지점 앞,201904,611,686,1297,37.600361,126.922813
은평구,958, 신한은행 응암동 지점 앞,201905,993,1044,2037,37.600361,126.922813
은평구,958, 신한은행 응암동 지점 앞,201906,1204,1225,2429,37.600361,126.922813
은평구,958, 신한은행 응암동 지점 앞,201907,1219,1368,2587,37.600361,126.922813
은평구,958, 신한은행 응암동 지점 앞,201908,1242,1306,2548,37.600361,126.922813
은평구,958, 신한은행 응암동 지점 앞,201909,1280,1266,2546,37.600361,126.922813
은평구,958, 신한은행 응암동 지점 앞,201910,1502,1552,3054,37.600361,126.922813
은평구,958, 신한은행 응암동 지점 앞,201911,911,913,1824,37.600361,126.922813
은평구,958, 신한은행 응암동 지점 앞,201912,537,575,1112,37.600361,126.922813
은평구,958, 신한은행 응암동 지점 앞,202001,426,473,899,37.600361,126.922813
은평구,958, 신한은행 응암동 지점 앞,202002,479,472,951,37.600361,126.922813
은평구,958, 신한은행 응암동 지점 앞,202003,700,707,1407,37.600361,126.922813
은평구,958, 신한은행 응암동 지점 앞,202004,1176,1162,2338,37.600361,126.922813
은평구,958, 신한은행 응암동 지점 앞,202005,1364,1357,2721,37.600361,126.922813
은평구,958, 신한은행 응암동 지점 앞,202006,1711,1693,3404,37.600361,126.922813
은평구,959, 구파발10단지 인근,201901,91,109,200,37.643661,126.914558
은평구,959, 구파발10단지 인근,201902,66,84,150,37.643661,126.914558
은평구,959, 구파발10단지 인근,201903,102,128,230,37.643661,126.914558
은평구,959, 구파발10단지 인근,201904,145,156,301,37.643661,126.914558
은평구,959, 구파발10단지 인근,201905,196,229,425,37.643661,126.914558
은평구,959, 구파발10단지 인근,201906,220,220,440,37.643661,126.914558
은평구,959, 구파발10단지 인근,201907,245,265,510,37.643661,126.914558
은평구,959, 구파발10단지 인근,201908,194,196,390,37.643661,126.914558
은평구,959, 구파발10단지 인근,201909,233,221,454,37.643661,126.914558
은평구,959, 구파발10단지 인근,201910,333,299,632,37.643661,126.914558
은평구,959, 구파발10단지 인근,201911,219,218,437,37.643661,126.914558
은평구,959, 구파발10단지 인근,201912,172,153,325,37.643661,126.914558
은평구,959, 구파발10단지 인근,202001,157,162,319,37.643661,126.914558
은평구,959, 구파발10단지 인근,202002,163,156,319,37.643661,126.914558
은평구,959, 구파발10단지 인근,202003,326,358,684,37.643661,126.914558
은평구,959, 구파발10단지 인근,202004,448,447,895,37.643661,126.914558
은평구,959, 구파발10단지 인근,202005,463,482,945,37.643661,126.914558
은평구,959, 구파발10단지 인근,202006,507,529,1036,37.643661,126.914558
은평구,960, 구파발역 환승센터,201901,136,114,250,37.638252,126.919456
은평구,960, 구파발역 환승센터,201902,166,151,317,37.638252,126.919456
은평구,960, 구파발역 환승센터,201903,308,314,622,37.638252,126.919456
은평구,960, 구파발역 환승센터,201904,462,503,965,37.638252,126.919456
은평구,960, 구파발역 환승센터,201905,634,691,1325,37.638252,126.919456
은평구,960, 구파발역 환승센터,201906,736,788,1524,37.638252,126.919456
은평구,960, 구파발역 환승센터,201907,740,815,1555,37.638252,126.919456
은평구,960, 구파발역 환승센터,201908,659,673,1332,37.638252,126.919456
은평구,960, 구파발역 환승센터,201909,592,697,1289,37.638252,126.919456
은평구,960, 구파발역 환승센터,201910,700,867,1567,37.638252,126.919456
은평구,960, 구파발역 환승센터,201911,466,579,1045,37.638252,126.919456
은평구,960, 구파발역 환승센터,201912,283,336,619,37.638252,126.919456
은평구,960, 구파발역 환승센터,202001,232,304,536,37.638252,126.919456
은평구,960, 구파발역 환승센터,202002,231,319,550,37.638252,126.919456
은평구,960, 구파발역 환승센터,202003,338,446,784,37.638252,126.919456
은평구,960, 구파발역 환승센터,202004,527,572,1099,37.638252,126.919456
은평구,960, 구파발역 환승센터,202005,718,759,1477,37.638252,126.919456
은평구,960, 구파발역 환승센터,202006,785,881,1666,37.638252,126.919456
은평구,961, 불광역 9번 출구,201901,185,170,355,37.61097,126.92981
은평구,961, 불광역 9번 출구,201902,170,202,372,37.61097,126.92981
은평구,961, 불광역 9번 출구,201903,372,410,782,37.61097,126.92981
은평구,961, 불광역 9번 출구,201904,532,534,1066,37.61097,126.92981
은평구,961, 불광역 9번 출구,201905,897,893,1790,37.61097,126.92981
은평구,961, 불광역 9번 출구,201906,989,983,1972,37.61097,126.92981
은평구,961, 불광역 9번 출구,201907,949,952,1901,37.61097,126.92981
은평구,961, 불광역 9번 출구,201908,851,841,1692,37.61097,126.92981
은평구,961, 불광역 9번 출구,201909,803,800,1603,37.61097,126.92981
은평구,961, 불광역 9번 출구,201910,1065,1079,2144,37.61097,126.92981
은평구,961, 불광역 9번 출구,201911,645,640,1285,37.61097,126.92981
은평구,961, 불광역 9번 출구,201912,391,371,762,37.61097,126.92981
은평구,961, 불광역 9번 출구,202001,367,385,752,37.61097,126.92981
은평구,961, 불광역 9번 출구,202002,341,359,700,37.61097,126.92981
은평구,961, 불광역 9번 출구,202003,558,568,1126,37.61097,126.92981
은평구,961, 불광역 9번 출구,202004,848,824,1672,37.61097,126.92981
은평구,961, 불광역 9번 출구,202005,940,941,1881,37.61097,126.92981
은평구,961, 불광역 9번 출구,202006,1119,1122,2241,37.61097,126.92981
은평구,962, 은평뉴타운 힐데스하임,201901,125,135,260,37.639259,126.918907
은평구,962, 은평뉴타운 힐데스하임,201902,162,140,302,37.639259,126.918907
은평구,962, 은평뉴타운 힐데스하임,201903,292,258,550,37.639259,126.918907
은평구,962, 은평뉴타운 힐데스하임,201904,450,403,853,37.639259,126.918907
은평구,962, 은평뉴타운 힐데스하임,201905,763,784,1547,37.639259,126.918907
은평구,962, 은평뉴타운 힐데스하임,201906,899,892,1791,37.639259,126.918907
은평구,962, 은평뉴타운 힐데스하임,201907,811,782,1593,37.639259,126.918907
은평구,962, 은평뉴타운 힐데스하임,201908,773,797,1570,37.639259,126.918907
은평구,962, 은평뉴타운 힐데스하임,201909,731,728,1459,37.639259,126.918907
은평구,962, 은평뉴타운 힐데스하임,201910,909,893,1802,37.639259,126.918907
은평구,962, 은평뉴타운 힐데스하임,201911,481,478,959,37.639259,126.918907
은평구,962, 은평뉴타운 힐데스하임,201912,307,309,616,37.639259,126.918907
은평구,962, 은평뉴타운 힐데스하임,202001,330,315,645,37.639259,126.918907
은평구,962, 은평뉴타운 힐데스하임,202002,271,257,528,37.639259,126.918907
은평구,962, 은평뉴타운 힐데스하임,202003,567,547,1114,37.639259,126.918907
은평구,962, 은평뉴타운 힐데스하임,202004,902,899,1801,37.639259,126.918907
은평구,962, 은평뉴타운 힐데스하임,202005,1129,1131,2260,37.639259,126.918907
은평구,962, 은평뉴타운 힐데스하임,202006,1297,1297,2594,37.639259,126.918907
은평구,963, 대호프라자아파트,201901,127,114,241,37.614429,126.932579
은평구,963, 대호프라자아파트,201902,132,118,250,37.614429,126.932579
은평구,963, 대호프라자아파트,201903,229,221,450,37.614429,126.932579
은평구,963, 대호프라자아파트,201904,458,367,825,37.614429,126.932579
은평구,963, 대호프라자아파트,201905,573,509,1082,37.614429,126.932579
은평구,963, 대호프라자아파트,201906,649,629,1278,37.614429,126.932579
은평구,963, 대호프라자아파트,201907,678,663,1341,37.614429,126.932579
은평구,963, 대호프라자아파트,201908,691,735,1426,37.614429,126.932579
은평구,963, 대호프라자아파트,201909,694,680,1374,37.614429,126.932579
은평구,963, 대호프라자아파트,201910,804,791,1595,37.614429,126.932579
은평구,963, 대호프라자아파트,201911,544,511,1055,37.614429,126.932579
은평구,963, 대호프라자아파트,201912,432,342,774,37.614429,126.932579
은평구,963, 대호프라자아파트,202001,449,387,836,37.614429,126.932579
은평구,963, 대호프라자아파트,202002,427,400,827,37.614429,126.932579
은평구,963, 대호프라자아파트,202003,620,608,1228,37.614429,126.932579
은평구,963, 대호프라자아파트,202004,782,763,1545,37.614429,126.932579
은평구,963, 대호프라자아파트,202005,807,801,1608,37.614429,126.932579
은평구,963, 대호프라자아파트,202006,1049,1045,2094,37.614429,126.932579
은평구,964, 북한산힐스테이트 7차아파트,201901,165,95,260,37.616112,126.925041
은평구,964, 북한산힐스테이트 7차아파트,201902,203,110,313,37.616112,126.925041
은평구,964, 북한산힐스테이트 7차아파트,201903,325,164,489,37.616112,126.925041
은평구,964, 북한산힐스테이트 7차아파트,201904,422,260,682,37.616112,126.925041
은평구,964, 북한산힐스테이트 7차아파트,201905,634,452,1086,37.616112,126.925041
은평구,964, 북한산힐스테이트 7차아파트,201906,778,541,1319,37.616112,126.925041
은평구,964, 북한산힐스테이트 7차아파트,201907,809,562,1371,37.616112,126.925041
은평구,964, 북한산힐스테이트 7차아파트,201908,979,628,1607,37.616112,126.925041
은평구,964, 북한산힐스테이트 7차아파트,201909,583,445,1028,37.616112,126.925041
은평구,964, 북한산힐스테이트 7차아파트,201910,687,484,1171,37.616112,126.925041
은평구,964, 북한산힐스테이트 7차아파트,201911,522,342,864,37.616112,126.925041
은평구,964, 북한산힐스테이트 7차아파트,201912,371,254,625,37.616112,126.925041
은평구,964, 북한산힐스테이트 7차아파트,202001,253,146,399,37.616112,126.925041
은평구,964, 북한산힐스테이트 7차아파트,202002,255,135,390,37.616112,126.925041
은평구,964, 북한산힐스테이트 7차아파트,202003,324,192,516,37.616112,126.925041
은평구,964, 북한산힐스테이트 7차아파트,202004,299,237,536,37.616112,126.925041
은평구,964, 북한산힐스테이트 7차아파트,202005,435,390,825,37.616112,126.925041
은평구,964, 북한산힐스테이트 7차아파트,202006,461,411,872,37.616112,126.925041
은평구,965, 서울특별시 은평병원,201901,148,59,207,37.593479,126.923187
은평구,965, 서울특별시 은평병원,201902,132,39,171,37.593479,126.923187
은평구,965, 서울특별시 은평병원,201903,255,66,321,37.593479,126.923187
은평구,965, 서울특별시 은평병원,201904,351,130,481,37.593479,126.923187
은평구,965, 서울특별시 은평병원,201905,581,251,832,37.593479,126.923187
은평구,965, 서울특별시 은평병원,201906,686,304,990,37.593479,126.923187
은평구,965, 서울특별시 은평병원,201907,784,286,1070,37.593479,126.923187
은평구,965, 서울특별시 은평병원,201908,637,234,871,37.593479,126.923187
은평구,965, 서울특별시 은평병원,201909,537,215,752,37.593479,126.923187
은평구,965, 서울특별시 은평병원,201910,650,259,909,37.593479,126.923187
은평구,965, 서울특별시 은평병원,201911,539,158,697,37.593479,126.923187
은평구,965, 서울특별시 은평병원,201912,317,109,426,37.593479,126.923187
은평구,965, 서울특별시 은평병원,202001,289,92,381,37.593479,126.923187
은평구,965, 서울특별시 은평병원,202002,253,56,309,37.593479,126.923187
은평구,965, 서울특별시 은평병원,202003,371,138,509,37.593479,126.923187
은평구,965, 서울특별시 은평병원,202004,281,152,433,37.593479,126.923187
은평구,965, 서울특별시 은평병원,202005,357,232,589,37.593479,126.923187
은평구,965, 서울특별시 은평병원,202006,553,257,810,37.593479,126.923187
은평구,966, 서울혁신파크1,201901,119,119,238,37.609032,126.934677
은평구,966, 서울혁신파크1,201902,78,84,162,37.609032,126.934677
은평구,966, 서울혁신파크1,201903,97,116,213,37.609032,126.934677
은평구,966, 서울혁신파크1,201904,183,155,338,37.609032,126.934677
은평구,966, 서울혁신파크1,201905,264,262,526,37.609032,126.934677
은평구,966, 서울혁신파크1,201906,350,313,663,37.609032,126.934677
은평구,966, 서울혁신파크1,201907,368,350,718,37.609032,126.934677
은평구,966, 서울혁신파크1,201908,340,286,626,37.609032,126.934677
은평구,966, 서울혁신파크1,201909,271,228,499,37.609032,126.934677
은평구,966, 서울혁신파크1,201910,262,215,477,37.609032,126.934677
은평구,966, 서울혁신파크1,201911,152,151,303,37.609032,126.934677
은평구,966, 서울혁신파크1,201912,85,73,158,37.609032,126.934677
은평구,966, 서울혁신파크1,202001,45,54,99,37.609032,126.934677
은평구,966, 서울혁신파크1,202002,75,70,145,37.609032,126.934677
은평구,966, 서울혁신파크1,202003,145,130,275,37.609032,126.934677
은평구,966, 서울혁신파크1,202004,290,276,566,37.609032,126.934677
은평구,966, 서울혁신파크1,202005,400,387,787,37.609032,126.934677
은평구,966, 서울혁신파크1,202006,458,472,930,37.609032,126.934677
은평구,967, 서울혁신파크2,201901,91,68,159,37.60891,126.932419
은평구,967, 서울혁신파크2,201902,85,52,137,37.60891,126.932419
은평구,967, 서울혁신파크2,201903,189,122,311,37.60891,126.932419
은평구,967, 서울혁신파크2,201904,351,260,611,37.60891,126.932419
은평구,967, 서울혁신파크2,201905,450,333,783,37.60891,126.932419
은평구,967, 서울혁신파크2,201906,468,347,815,37.60891,126.932419
은평구,967, 서울혁신파크2,201907,415,349,764,37.60891,126.932419
은평구,967, 서울혁신파크2,201908,426,340,766,37.60891,126.932419
은평구,967, 서울혁신파크2,201909,377,290,667,37.60891,126.932419
은평구,967, 서울혁신파크2,201910,493,424,917,37.60891,126.932419
은평구,967, 서울혁신파크2,201911,292,251,543,37.60891,126.932419
은평구,967, 서울혁신파크2,201912,175,131,306,37.60891,126.932419
은평구,967, 서울혁신파크2,202001,185,110,295,37.60891,126.932419
은평구,967, 서울혁신파크2,202002,152,115,267,37.60891,126.932419
은평구,967, 서울혁신파크2,202003,276,232,508,37.60891,126.932419
은평구,967, 서울혁신파크2,202004,463,438,901,37.60891,126.932419
은평구,967, 서울혁신파크2,202005,501,489,990,37.60891,126.932419
은평구,967, 서울혁신파크2,202006,538,521,1059,37.60891,126.932419
은평구,968, 은평뉴타운 상림마을 13단지,201901,28,16,44,37.64209,126.929413
은평구,968, 은평뉴타운 상림마을 13단지,201902,24,6,30,37.64209,126.929413
은평구,968, 은평뉴타운 상림마을 13단지,201903,100,34,134,37.64209,126.929413
은평구,968, 은평뉴타운 상림마을 13단지,201904,194,100,294,37.64209,126.929413
은평구,968, 은평뉴타운 상림마을 13단지,201905,212,138,350,37.64209,126.929413
은평구,968, 은평뉴타운 상림마을 13단지,201906,237,151,388,37.64209,126.929413
은평구,968, 은평뉴타운 상림마을 13단지,201907,254,173,427,37.64209,126.929413
은평구,968, 은평뉴타운 상림마을 13단지,201908,168,107,275,37.64209,126.929413
은평구,968, 은평뉴타운 상림마을 13단지,201909,183,105,288,37.64209,126.929413
은평구,968, 은평뉴타운 상림마을 13단지,201910,276,187,463,37.64209,126.929413
은평구,968, 은평뉴타운 상림마을 13단지,201911,184,114,298,37.64209,126.929413
은평구,968, 은평뉴타운 상림마을 13단지,201912,147,62,209,37.64209,126.929413
은평구,968, 은평뉴타운 상림마을 13단지,202001,116,45,161,37.64209,126.929413
은평구,968, 은평뉴타운 상림마을 13단지,202002,99,49,148,37.64209,126.929413
은평구,968, 은평뉴타운 상림마을 13단지,202003,121,85,206,37.64209,126.929413
은평구,968, 은평뉴타운 상림마을 13단지,202004,190,148,338,37.64209,126.929413
은평구,968, 은평뉴타운 상림마을 13단지,202005,196,159,355,37.64209,126.929413
은평구,968, 은평뉴타운 상림마을 13단지,202006,222,179,401,37.64209,126.929413
은평구,969, 은평 지웰테라스,201901,10,3,13,37.64386,126.931877
은평구,969, 은평 지웰테라스,201902,10,10,20,37.64386,126.931877
은평구,969, 은평 지웰테라스,201903,73,76,149,37.64386,126.931877
은평구,969, 은평 지웰테라스,201904,152,109,261,37.64386,126.931877
은평구,969, 은평 지웰테라스,201905,241,175,416,37.64386,126.931877
은평구,969, 은평 지웰테라스,201906,265,214,479,37.64386,126.931877
은평구,969, 은평 지웰테라스,201907,238,197,435,37.64386,126.931877
은평구,969, 은평 지웰테라스,201908,202,176,378,37.64386,126.931877
은평구,969, 은평 지웰테라스,201909,217,172,389,37.64386,126.931877
은평구,969, 은평 지웰테라스,201910,204,161,365,37.64386,126.931877
은평구,969, 은평 지웰테라스,201911,133,89,222,37.64386,126.931877
은평구,969, 은평 지웰테라스,201912,100,45,145,37.64386,126.931877
은평구,969, 은평 지웰테라스,202001,97,60,157,37.64386,126.931877
은평구,969, 은평 지웰테라스,202002,81,49,130,37.64386,126.931877
은평구,969, 은평 지웰테라스,202003,171,125,296,37.64386,126.931877
은평구,969, 은평 지웰테라스,202004,184,172,356,37.64386,126.931877
은평구,969, 은평 지웰테라스,202005,264,253,517,37.64386,126.931877
은평구,969, 은평 지웰테라스,202006,344,297,641,37.64386,126.931877
은평구,971, 역촌 센트레빌 아파트,201901,144,64,208,37.602329,126.906548
은평구,971, 역촌 센트레빌 아파트,201902,152,87,239,37.602329,126.906548
은평구,971, 역촌 센트레빌 아파트,201903,247,174,421,37.602329,126.906548
은평구,971, 역촌 센트레빌 아파트,201904,272,175,447,37.602329,126.906548
은평구,971, 역촌 센트레빌 아파트,201905,466,342,808,37.602329,126.906548
은평구,971, 역촌 센트레빌 아파트,201906,487,372,859,37.602329,126.906548
은평구,971, 역촌 센트레빌 아파트,201907,516,376,892,37.602329,126.906548
은평구,971, 역촌 센트레빌 아파트,201908,485,297,782,37.602329,126.906548
은평구,971, 역촌 센트레빌 아파트,201909,522,400,922,37.602329,126.906548
은평구,971, 역촌 센트레빌 아파트,201910,492,360,852,37.602329,126.906548
은평구,971, 역촌 센트레빌 아파트,201911,343,168,511,37.602329,126.906548
은평구,971, 역촌 센트레빌 아파트,201912,192,93,285,37.602329,126.906548
은평구,971, 역촌 센트레빌 아파트,202001,176,86,262,37.602329,126.906548
은평구,971, 역촌 센트레빌 아파트,202002,158,98,256,37.602329,126.906548
은평구,971, 역촌 센트레빌 아파트,202003,287,180,467,37.602329,126.906548
은평구,971, 역촌 센트레빌 아파트,202004,261,222,483,37.602329,126.906548
은평구,971, 역촌 센트레빌 아파트,202005,312,258,570,37.602329,126.906548
은평구,971, 역촌 센트레빌 아파트,202006,445,303,748,37.602329,126.906548
은평구,972, 수색역,201906,290,264,554,37.58218,126.894943
은평구,972, 수색역,201907,815,737,1552,37.58218,126.894943
은평구,972, 수색역,201908,874,779,1653,37.58218,126.894943
은평구,972, 수색역,201909,726,699,1425,37.58218,126.894943
은평구,972, 수색역,201910,891,872,1763,37.58218,126.894943
은평구,972, 수색역,201911,654,587,1241,37.58218,126.894943
은평구,972, 수색역,201912,429,380,809,37.58218,126.894943
은평구,972, 수색역,202001,379,306,685,37.58218,126.894943
은평구,972, 수색역,202002,365,326,691,37.58218,126.894943
은평구,972, 수색역,202003,547,471,1018,37.58218,126.894943
은평구,972, 수색역,202004,598,591,1189,37.58218,126.894943
은평구,972, 수색역,202005,716,683,1399,37.58218,126.894943
은평구,972, 수색역,202006,845,785,1630,37.58218,126.894943
은평구,973,제각말푸르지오 5-1단지 아파트,202004,1,1,2,37.637348,126.935844
은평구,973,제각말푸르지오 5-1단지 아파트,202006,29,13,42,37.637348,126.935844
은평구,974,연신초등학교옆 마을마당,202006,19,10,29,37.62672,126.929016
은평구,975,백련산 힐스테이트상가앞,202006,48,15,63,37.590363,126.923012
은평구,976,진관고등학교앞,202004,1,2,3,37.643509,126.924103
은평구,976,진관고등학교앞,202006,74,63,137,37.643509,126.924103
은평구,977,신도중학교앞,202004,1,1,2,37.633102,126.931503
은평구,977,신도중학교앞,202006,23,10,33,37.633102,126.931503
은평구,978,녹번 힐스테이트상가앞,202006,80,55,135,37.601009,126.935928
은평구,979,원풍빌라앞,202004,1,1,2,37.591862,126.906082
은평구,979,원풍빌라앞,202006,159,158,317,37.591862,126.906082
은평구,982,유니클로 은평점앞,202004,3,3,6,37.604126,126.925087
은평구,982,유니클로 은평점앞,202006,145,139,284,37.604126,126.925087
은평구,984,상신초등학교앞 버스정류장,202004,1,1,2,37.59581,126.910263
은평구,984,상신초등학교앞 버스정류장,202006,228,239,467,37.59581,126.910263
은평구,985,은평온누리약국앞,202004,3,3,6,37.601192,126.926384
은평구,985,은평온누리약국앞,202006,138,140,278,37.601192,126.926384
은평구,988,은평뉴타운 우물골2단지(제2경로당),202004,1,1,2,#N/A,#N/A
은평구,989,축산정육식당앞,202004,2,2,4,37.591812,126.914833
은평구,989,응암 꼬꼬닭치킨호프 앞,202006,215,224,439,37.591812,126.914833
은평구,991,흥국사 정류장,202004,1,0,1,37.656769,126.942009
은평구,991,흥국사 정류장,202006,34,32,66,37.656769,126.942009
은평구,992,북한산입구 정류장,202004,1,1,2,37.658428,126.94606
은평구,992,북한산입구 정류장,202006,41,38,79,37.658428,126.94606
은평구,993,은평뉴타운 온뜨락아파트앞,202006,75,55,130,37.630287,126.919563
은평구,994,북한산생태공원입구(교통섬),202006,68,59,127,37.610718,126.93911
은평구,995,은평다목적체육관,202004,1,1,2,37.631409,126.925407
은평구,995,은평다목적체육관,202006,48,39,87,37.631409,126.925407
은평구,996,응암역 1번출구,202004,1,1,2,37.598606,126.915405
은평구,996,응암역 1번출구,202006,680,683,1363,37.598606,126.915405
강동구,1001, 광진교 남단 사거리(디지털프라자앞),201901,387,464,851,37.541805,127.124718
강동구,1001, 광진교 남단 사거리(디지털프라자앞),201902,371,409,780,37.541805,127.124718
강동구,1001, 광진교 남단 사거리(디지털프라자앞),201903,837,903,1740,37.541805,127.124718
강동구,1001, 광진교 남단 사거리(디지털프라자앞),201904,1357,1444,2801,37.541805,127.124718
강동구,1001, 광진교 남단 사거리(디지털프라자앞),201905,2509,2568,5077,37.541805,127.124718
강동구,1001, 광진교 남단 사거리(디지털프라자앞),201906,2586,2599,5185,37.541805,127.124718
강동구,1001, 광진교 남단 사거리(디지털프라자앞),201907,2394,2426,4820,37.541805,127.124718
강동구,1001, 광진교 남단 사거리(디지털프라자앞),201908,2428,2423,4851,37.541805,127.124718
강동구,1001, 광진교 남단 사거리(디지털프라자앞),201909,2474,2476,4950,37.541805,127.124718
강동구,1001, 광진교 남단 사거리(디지털프라자앞),201910,2690,2707,5397,37.541805,127.124718
강동구,1001, 광진교 남단 사거리(디지털프라자앞),201911,1605,1711,3316,37.541805,127.124718
강동구,1001, 광진교 남단 사거리(디지털프라자앞),201912,782,846,1628,37.541805,127.124718
강동구,1001, 광진교 남단 사거리(디지털프라자앞),202001,717,739,1456,37.541805,127.124718
강동구,1001, 광진교 남단 사거리(디지털프라자앞),202002,696,735,1431,37.541805,127.124718
강동구,1001, 광진교 남단 사거리(디지털프라자앞),202003,1802,1906,3708,37.541805,127.124718
강동구,1001, 광진교 남단 사거리(디지털프라자앞),202004,2520,2585,5105,37.541805,127.124718
강동구,1001, 광진교 남단 사거리(디지털프라자앞),202005,2951,2965,5916,37.541805,127.124718
강동구,1001, 광진교 남단 사거리(디지털프라자앞),202006,2648,2660,5308,37.541805,127.124718
강동구,1002, 해공공원(천호동),201901,296,294,590,37.545219,127.125916
강동구,1002, 해공공원(천호동),201902,288,287,575,37.545219,127.125916
강동구,1002, 해공공원(천호동),201903,604,610,1214,37.545219,127.125916
강동구,1002, 해공공원(천호동),201904,899,1012,1911,37.545219,127.125916
강동구,1002, 해공공원(천호동),201905,1597,1914,3511,37.545219,127.125916
강동구,1002, 해공공원(천호동),201906,1795,1989,3784,37.545219,127.125916
강동구,1002, 해공공원(천호동),201907,1883,2004,3887,37.545219,127.125916
강동구,1002, 해공공원(천호동),201908,2041,2211,4252,37.545219,127.125916
강동구,1002, 해공공원(천호동),201909,1993,2119,4112,37.545219,127.125916
강동구,1002, 해공공원(천호동),201910,1979,2209,4188,37.545219,127.125916
강동구,1002, 해공공원(천호동),201911,1175,1259,2434,37.545219,127.125916
강동구,1002, 해공공원(천호동),201912,631,620,1251,37.545219,127.125916
강동구,1002, 해공공원(천호동),202001,569,575,1144,37.545219,127.125916
강동구,1002, 해공공원(천호동),202002,561,579,1140,37.545219,127.125916
강동구,1002, 해공공원(천호동),202003,1685,1901,3586,37.545219,127.125916
강동구,1002, 해공공원(천호동),202004,2398,2709,5107,37.545219,127.125916
강동구,1002, 해공공원(천호동),202005,3064,3363,6427,37.545219,127.125916
강동구,1002, 해공공원(천호동),202006,3119,3326,6445,37.545219,127.125916
강동구,1003, 해공도서관앞,201901,308,294,602,37.543915,127.125458
강동구,1003, 해공도서관앞,201902,287,262,549,37.543915,127.125458
강동구,1003, 해공도서관앞,201903,569,543,1112,37.543915,127.125458
강동구,1003, 해공도서관앞,201904,698,663,1361,37.543915,127.125458
강동구,1003, 해공도서관앞,201905,1160,1149,2309,37.543915,127.125458
강동구,1003, 해공도서관앞,201906,1215,1161,2376,37.543915,127.125458
강동구,1003, 해공도서관앞,201907,1192,1107,2299,37.543915,127.125458
강동구,1003, 해공도서관앞,201908,1247,1184,2431,37.543915,127.125458
강동구,1003, 해공도서관앞,201909,1041,1011,2052,37.543915,127.125458
강동구,1003, 해공도서관앞,201910,1184,1047,2231,37.543915,127.125458
강동구,1003, 해공도서관앞,201911,828,717,1545,37.543915,127.125458
강동구,1003, 해공도서관앞,201912,502,398,900,37.543915,127.125458
강동구,1003, 해공도서관앞,202001,473,403,876,37.543915,127.125458
강동구,1003, 해공도서관앞,202002,447,349,796,37.543915,127.125458
강동구,1003, 해공도서관앞,202003,541,517,1058,37.543915,127.125458
강동구,1003, 해공도서관앞,202004,770,761,1531,37.543915,127.125458
강동구,1003, 해공도서관앞,202005,1166,1105,2271,37.543915,127.125458
강동구,1003, 해공도서관앞,202006,909,897,1806,37.543915,127.125458
강동구,1004, 삼성광나루아파트 버스정류장,201901,308,339,647,37.553349,127.12886
강동구,1004, 삼성광나루아파트 버스정류장,201902,303,381,684,37.553349,127.12886
강동구,1004, 삼성광나루아파트 버스정류장,201903,515,742,1257,37.553349,127.12886
강동구,1004, 삼성광나루아파트 버스정류장,201904,722,1070,1792,37.553349,127.12886
강동구,1004, 삼성광나루아파트 버스정류장,201905,1455,2026,3481,37.553349,127.12886
강동구,1004, 삼성광나루아파트 버스정류장,201906,1567,2131,3698,37.553349,127.12886
강동구,1004, 삼성광나루아파트 버스정류장,201907,1484,2060,3544,37.553349,127.12886
강동구,1004, 삼성광나루아파트 버스정류장,201908,1454,2073,3527,37.553349,127.12886
강동구,1004, 삼성광나루아파트 버스정류장,201909,1489,2201,3690,37.553349,127.12886
강동구,1004, 삼성광나루아파트 버스정류장,201910,1882,2407,4289,37.553349,127.12886
강동구,1004, 삼성광나루아파트 버스정류장,201911,877,1194,2071,37.553349,127.12886
강동구,1004, 삼성광나루아파트 버스정류장,201912,440,573,1013,37.553349,127.12886
강동구,1004, 삼성광나루아파트 버스정류장,202001,428,625,1053,37.553349,127.12886
강동구,1004, 삼성광나루아파트 버스정류장,202002,435,617,1052,37.553349,127.12886
강동구,1004, 삼성광나루아파트 버스정류장,202003,1266,1607,2873,37.553349,127.12886
강동구,1004, 삼성광나루아파트 버스정류장,202004,1828,2364,4192,37.553349,127.12886
강동구,1004, 삼성광나루아파트 버스정류장,202005,2230,2738,4968,37.553349,127.12886
강동구,1004, 삼성광나루아파트 버스정류장,202006,2172,2775,4947,37.553349,127.12886
강동구,1006, 롯데캐슬 115동앞,201901,235,134,369,37.55492,127.142799
강동구,1006, 롯데캐슬 115동앞,201902,226,135,361,37.55492,127.142799
강동구,1006, 롯데캐슬 115동앞,201903,402,269,671,37.55492,127.142799
강동구,1006, 롯데캐슬 115동앞,201904,572,353,925,37.55492,127.142799
강동구,1006, 롯데캐슬 115동앞,201905,780,551,1331,37.55492,127.142799
강동구,1006, 롯데캐슬 115동앞,201906,746,515,1261,37.55492,127.142799
강동구,1006, 롯데캐슬 115동앞,201907,933,650,1583,37.55492,127.142799
강동구,1006, 롯데캐슬 115동앞,201908,925,645,1570,37.55492,127.142799
강동구,1006, 롯데캐슬 115동앞,201909,819,603,1422,37.55492,127.142799
강동구,1006, 롯데캐슬 115동앞,201910,1046,734,1780,37.55492,127.142799
강동구,1006, 롯데캐슬 115동앞,201911,635,476,1111,37.55492,127.142799
강동구,1006, 롯데캐슬 115동앞,201912,408,295,703,37.55492,127.142799
강동구,1006, 롯데캐슬 115동앞,202001,461,293,754,37.55492,127.142799
강동구,1006, 롯데캐슬 115동앞,202002,357,273,630,37.55492,127.142799
강동구,1006, 롯데캐슬 115동앞,202003,756,609,1365,37.55492,127.142799
강동구,1006, 롯데캐슬 115동앞,202004,887,806,1693,37.55492,127.142799
강동구,1006, 롯데캐슬 115동앞,202005,1111,1015,2126,37.55492,127.142799
강동구,1006, 롯데캐슬 115동앞,202006,907,768,1675,37.55492,127.142799
강동구,1007,암사동 선사유적지,201901,32,34,66,37.559517,127.130844
강동구,1007,암사동 선사유적지,201902,50,43,93,37.559517,127.130844
강동구,1007,암사동 선사유적지,201903,47,44,91,37.559517,127.130844
강동구,1007,암사동 선사유적지,201904,95,95,190,37.559517,127.130844
강동구,1007,암사동 선사유적지,201905,165,165,330,37.559517,127.130844
강동구,1007,암사동 선사유적지,201906,160,161,321,37.559517,127.130844
강동구,1007,암사동 선사유적지,201907,102,101,203,37.559517,127.130844
강동구,1007,암사동 선사유적지,201908,91,102,193,37.559517,127.130844
강동구,1007,암사동 선사유적지,201909,115,91,206,37.559517,127.130844
강동구,1007,암사동 선사유적지,201910,109,95,204,37.559517,127.130844
강동구,1007,암사동 선사유적지,201911,100,100,200,37.559517,127.130844
강동구,1007,암사동 선사유적지,201912,59,49,108,37.559517,127.130844
강동구,1007,암사동 선사유적지,202001,68,57,125,37.559517,127.130844
강동구,1007,암사동 선사유적지,202002,54,52,106,37.559517,127.130844
강동구,1007,암사동 선사유적지,202003,180,162,342,37.559517,127.130844
강동구,1007,암사동 선사유적지,202004,268,253,521,37.559517,127.130844
강동구,1007,암사동 선사유적지,202005,325,305,630,37.559517,127.130844
강동구,1007,암사동 선사유적지,202006,207,197,404,37.559517,127.130844
강동구,1008, 암사역 3번출구(국민은행앞),201901,541,608,1149,37.549549,127.127151
강동구,1008, 암사역 3번출구(국민은행앞),201902,573,658,1231,37.549549,127.127151
강동구,1008, 암사역 3번출구(국민은행앞),201903,1145,1358,2503,37.549549,127.127151
강동구,1008, 암사역 3번출구(국민은행앞),201904,1713,2113,3826,37.549549,127.127151
강동구,1008, 암사역 3번출구(국민은행앞),201905,2899,3802,6701,37.549549,127.127151
강동구,1008, 암사역 3번출구(국민은행앞),201906,3275,4180,7455,37.549549,127.127151
강동구,1008, 암사역 3번출구(국민은행앞),201907,3296,3980,7276,37.549549,127.127151
강동구,1008, 암사역 3번출구(국민은행앞),201908,3185,3921,7106,37.549549,127.127151
강동구,1008, 암사역 3번출구(국민은행앞),201909,3209,3892,7101,37.549549,127.127151
강동구,1008, 암사역 3번출구(국민은행앞),201910,3574,4271,7845,37.549549,127.127151
강동구,1008, 암사역 3번출구(국민은행앞),201911,2173,2588,4761,37.549549,127.127151
강동구,1008, 암사역 3번출구(국민은행앞),201912,1127,1294,2421,37.549549,127.127151
강동구,1008, 암사역 3번출구(국민은행앞),202001,1120,1305,2425,37.549549,127.127151
강동구,1008, 암사역 3번출구(국민은행앞),202002,1086,1373,2459,37.549549,127.127151
강동구,1008, 암사역 3번출구(국민은행앞),202003,2359,2903,5262,37.549549,127.127151
강동구,1008, 암사역 3번출구(국민은행앞),202004,3452,4084,7536,37.549549,127.127151
강동구,1008, 암사역 3번출구(국민은행앞),202005,4266,4866,9132,37.549549,127.127151
강동구,1008, 암사역 3번출구(국민은행앞),202006,4323,4939,9262,37.549549,127.127151
강동구,1009, 천호역4번출구(현대백화점),201901,801,816,1617,37.538658,127.124214
강동구,1009, 천호역4번출구(현대백화점),201902,752,752,1504,37.538658,127.124214
강동구,1009, 천호역4번출구(현대백화점),201903,1534,1531,3065,37.538658,127.124214
강동구,1009, 천호역4번출구(현대백화점),201904,2558,2434,4992,37.538658,127.124214
강동구,1009, 천호역4번출구(현대백화점),201905,4318,4230,8548,37.538658,127.124214
강동구,1009, 천호역4번출구(현대백화점),201906,4541,4521,9062,37.538658,127.124214
강동구,1009, 천호역4번출구(현대백화점),201907,4337,4301,8638,37.538658,127.124214
강동구,1009, 천호역4번출구(현대백화점),201908,4174,4161,8335,37.538658,127.124214
강동구,1009, 천호역4번출구(현대백화점),201909,4301,4276,8577,37.538658,127.124214
강동구,1009, 천호역4번출구(현대백화점),201910,5132,5147,10279,37.538658,127.124214
강동구,1009, 천호역4번출구(현대백화점),201911,3107,3198,6305,37.538658,127.124214
강동구,1009, 천호역4번출구(현대백화점),201912,1690,1729,3419,37.538658,127.124214
강동구,1009, 천호역4번출구(현대백화점),202001,1613,1619,3232,37.538658,127.124214
강동구,1009, 천호역4번출구(현대백화점),202002,1606,1607,3213,37.538658,127.124214
강동구,1009, 천호역4번출구(현대백화점),202003,3232,3241,6473,37.538658,127.124214
강동구,1009, 천호역4번출구(현대백화점),202004,4705,4682,9387,37.538658,127.124214
강동구,1009, 천호역4번출구(현대백화점),202005,5311,5332,10643,37.538658,127.124214
강동구,1009, 천호역4번출구(현대백화점),202006,5068,5212,10280,37.538658,127.124214
강동구,1010, 강동세무서,201901,549,546,1095,37.534481,127.138344
강동구,1010, 강동세무서,201902,537,541,1078,37.534481,127.138344
강동구,1010, 강동세무서,201903,1043,1025,2068,37.534481,127.138344
강동구,1010, 강동세무서,201904,1519,1502,3021,37.534481,127.138344
강동구,1010, 강동세무서,201905,2720,2681,5401,37.534481,127.138344
강동구,1010, 강동세무서,201906,2977,2897,5874,37.534481,127.138344
강동구,1010, 강동세무서,201907,3010,2989,5999,37.534481,127.138344
강동구,1010, 강동세무서,201908,2992,2898,5890,37.534481,127.138344
강동구,1010, 강동세무서,201909,3015,2868,5883,37.534481,127.138344
강동구,1010, 강동세무서,201910,3380,3224,6604,37.534481,127.138344
강동구,1010, 강동세무서,201911,2233,2141,4374,37.534481,127.138344
강동구,1010, 강동세무서,201912,1233,1193,2426,37.534481,127.138344
강동구,1010, 강동세무서,202001,1126,1126,2252,37.534481,127.138344
강동구,1010, 강동세무서,202002,1161,1150,2311,37.534481,127.138344
강동구,1010, 강동세무서,202003,2088,2114,4202,37.534481,127.138344
강동구,1010, 강동세무서,202004,2922,2849,5771,37.534481,127.138344
강동구,1010, 강동세무서,202005,3507,3403,6910,37.534481,127.138344
강동구,1010, 강동세무서,202006,3411,3382,6793,37.534481,127.138344
강동구,1011, LIGA 아파트 앞,201901,622,628,1250,37.534771,127.135239
강동구,1011, LIGA 아파트 앞,201902,574,541,1115,37.534771,127.135239
강동구,1011, LIGA 아파트 앞,201903,1223,1189,2412,37.534771,127.135239
강동구,1011, LIGA 아파트 앞,201904,1985,2016,4001,37.534771,127.135239
강동구,1011, LIGA 아파트 앞,201905,3280,3268,6548,37.534771,127.135239
강동구,1011, LIGA 아파트 앞,201906,3674,3640,7314,37.534771,127.135239
강동구,1011, LIGA 아파트 앞,201907,3659,3660,7319,37.534771,127.135239
강동구,1011, LIGA 아파트 앞,201908,3568,3533,7101,37.534771,127.135239
강동구,1011, LIGA 아파트 앞,201909,3506,3471,6977,37.534771,127.135239
강동구,1011, LIGA 아파트 앞,201910,4153,4103,8256,37.534771,127.135239
강동구,1011, LIGA 아파트 앞,201911,2492,2455,4947,37.534771,127.135239
강동구,1011, LIGA 아파트 앞,201912,1333,1354,2687,37.534771,127.135239
강동구,1011, LIGA 아파트 앞,202001,1184,1174,2358,37.534771,127.135239
강동구,1011, LIGA 아파트 앞,202002,828,827,1655,37.534771,127.135239
강동구,1011, LIGA 아파트 앞,202003,2052,2083,4135,37.534771,127.135239
강동구,1011, LIGA 아파트 앞,202004,3048,3070,6118,37.534771,127.135239
강동구,1011, LIGA 아파트 앞,202005,3568,3548,7116,37.534771,127.135239
강동구,1011, LIGA 아파트 앞,202006,3783,3764,7547,37.534771,127.135239
강동구,1012, 서울 상운차량,201901,194,197,391,37.536026,127.122726
강동구,1012, 서울 상운차량,201902,233,218,451,37.536026,127.122726
강동구,1012, 서울 상운차량,201903,517,485,1002,37.536026,127.122726
강동구,1012, 서울 상운차량,201904,751,718,1469,37.536026,127.122726
강동구,1012, 서울 상운차량,201905,1146,1064,2210,37.536026,127.122726
강동구,1012, 서울 상운차량,201906,1209,1147,2356,37.536026,127.122726
강동구,1012, 서울 상운차량,201907,1286,1115,2401,37.536026,127.122726
강동구,1012, 서울 상운차량,201908,1367,1042,2409,37.536026,127.122726
강동구,1012, 서울 상운차량,201909,1254,1080,2334,37.536026,127.122726
강동구,1012, 서울 상운차량,201910,1435,1235,2670,37.536026,127.122726
강동구,1012, 서울 상운차량,201911,962,831,1793,37.536026,127.122726
강동구,1012, 서울 상운차량,201912,535,464,999,37.536026,127.122726
강동구,1012, 서울 상운차량,202001,515,412,927,37.536026,127.122726
강동구,1012, 서울 상운차량,202002,445,438,883,37.536026,127.122726
강동구,1012, 서울 상운차량,202003,744,682,1426,37.536026,127.122726
강동구,1012, 서울 상운차량,202004,924,899,1823,37.536026,127.122726
강동구,1012, 서울 상운차량,202005,1089,1049,2138,37.536026,127.122726
강동구,1012, 서울 상운차량,202006,1157,1114,2271,37.536026,127.122726
강동구,1013, 강동구청역 1번 출입구,201901,356,364,720,37.530773,127.120926
강동구,1013, 강동구청역 1번 출입구,201902,357,350,707,37.530773,127.120926
강동구,1013, 강동구청역 1번 출입구,201903,685,691,1376,37.530773,127.120926
강동구,1013, 강동구청역 1번 출입구,201904,1076,1007,2083,37.530773,127.120926
강동구,1013, 강동구청역 1번 출입구,201905,1546,1543,3089,37.530773,127.120926
강동구,1013, 강동구청역 1번 출입구,201906,1661,1625,3286,37.530773,127.120926
강동구,1013, 강동구청역 1번 출입구,201907,1530,1527,3057,37.530773,127.120926
강동구,1013, 강동구청역 1번 출입구,201908,1608,1534,3142,37.530773,127.120926
강동구,1013, 강동구청역 1번 출입구,201909,1589,1579,3168,37.530773,127.120926
강동구,1013, 강동구청역 1번 출입구,201910,2024,2012,4036,37.530773,127.120926
강동구,1013, 강동구청역 1번 출입구,201911,1485,1463,2948,37.530773,127.120926
강동구,1013, 강동구청역 1번 출입구,201912,832,760,1592,37.530773,127.120926
강동구,1013, 강동구청역 1번 출입구,202001,679,676,1355,37.530773,127.120926
강동구,1013, 강동구청역 1번 출입구,202002,607,586,1193,37.530773,127.120926
강동구,1013, 강동구청역 1번 출입구,202003,1010,976,1986,37.530773,127.120926
강동구,1013, 강동구청역 1번 출입구,202004,1295,1296,2591,37.530773,127.120926
강동구,1013, 강동구청역 1번 출입구,202005,1398,1403,2801,37.530773,127.120926
강동구,1013, 강동구청역 1번 출입구,202006,1523,1527,3050,37.530773,127.120926
강동구,1014, 강동구평생학습관앞,201901,283,202,485,37.5508,127.142624
강동구,1014, 강동구평생학습관앞,201902,236,174,410,37.5508,127.142624
강동구,1014, 강동구평생학습관앞,201903,470,379,849,37.5508,127.142624
강동구,1014, 강동구평생학습관앞,201904,817,670,1487,37.5508,127.142624
강동구,1014, 강동구평생학습관앞,201905,1216,1081,2297,37.5508,127.142624
강동구,1014, 강동구평생학습관앞,201906,1325,1181,2506,37.5508,127.142624
강동구,1014, 강동구평생학습관앞,201907,1108,1128,2236,37.5508,127.142624
강동구,1014, 강동구평생학습관앞,201908,1127,1132,2259,37.5508,127.142624
강동구,1014, 강동구평생학습관앞,201909,1207,1138,2345,37.5508,127.142624
강동구,1014, 강동구평생학습관앞,201910,1243,1204,2447,37.5508,127.142624
강동구,1014, 강동구평생학습관앞,201911,815,768,1583,37.5508,127.142624
강동구,1014, 강동구평생학습관앞,201912,437,422,859,37.5508,127.142624
강동구,1014, 강동구평생학습관앞,202001,530,472,1002,37.5508,127.142624
강동구,1014, 강동구평생학습관앞,202002,449,388,837,37.5508,127.142624
강동구,1014, 강동구평생학습관앞,202003,860,815,1675,37.5508,127.142624
강동구,1014, 강동구평생학습관앞,202004,1355,1303,2658,37.5508,127.142624
강동구,1014, 강동구평생학습관앞,202005,1535,1510,3045,37.5508,127.142624
강동구,1014, 강동구평생학습관앞,202006,1408,1395,2803,37.5508,127.142624
강동구,1015, 샛마을 근린공원,201901,267,240,507,37.550079,127.146912
강동구,1015, 샛마을 근린공원,201902,243,246,489,37.550079,127.146912
강동구,1015, 샛마을 근린공원,201903,514,497,1011,37.550079,127.146912
강동구,1015, 샛마을 근린공원,201904,640,661,1301,37.550079,127.146912
강동구,1015, 샛마을 근린공원,201905,1159,1196,2355,37.550079,127.146912
강동구,1015, 샛마을 근린공원,201906,1408,1438,2846,37.550079,127.146912
강동구,1015, 샛마을 근린공원,201907,1207,1239,2446,37.550079,127.146912
강동구,1015, 샛마을 근린공원,201908,1064,1075,2139,37.550079,127.146912
강동구,1015, 샛마을 근린공원,201909,1115,1065,2180,37.550079,127.146912
강동구,1015, 샛마을 근린공원,201910,1428,1429,2857,37.550079,127.146912
강동구,1015, 샛마을 근린공원,201911,817,790,1607,37.550079,127.146912
강동구,1015, 샛마을 근린공원,201912,431,429,860,37.550079,127.146912
강동구,1015, 샛마을 근린공원,202001,472,442,914,37.550079,127.146912
강동구,1015, 샛마을 근린공원,202002,434,378,812,37.550079,127.146912
강동구,1015, 샛마을 근린공원,202003,854,851,1705,37.550079,127.146912
강동구,1015, 샛마을 근린공원,202004,1331,1320,2651,37.550079,127.146912
강동구,1015, 샛마을 근린공원,202005,1769,1765,3534,37.550079,127.146912
강동구,1015, 샛마을 근린공원,202006,1362,1368,2730,37.550079,127.146912
강동구,1016, 해뜨는 주유소옆 리엔파크 109동앞,201901,185,198,383,37.559399,127.171158
강동구,1016, 해뜨는 주유소옆 리엔파크 109동앞,201902,197,254,451,37.559399,127.171158
강동구,1016, 해뜨는 주유소옆 리엔파크 109동앞,201903,253,322,575,37.559399,127.171158
강동구,1016, 해뜨는 주유소옆 리엔파크 109동앞,201904,415,456,871,37.559399,127.171158
강동구,1016, 해뜨는 주유소옆 리엔파크 109동앞,201905,625,716,1341,37.559399,127.171158
강동구,1016, 해뜨는 주유소옆 리엔파크 109동앞,201906,671,738,1409,37.559399,127.171158
강동구,1016, 해뜨는 주유소옆 리엔파크 109동앞,201907,566,572,1138,37.559399,127.171158
강동구,1016, 해뜨는 주유소옆 리엔파크 109동앞,201908,538,596,1134,37.559399,127.171158
강동구,1016, 해뜨는 주유소옆 리엔파크 109동앞,201909,650,653,1303,37.559399,127.171158
강동구,1016, 해뜨는 주유소옆 리엔파크 109동앞,201910,726,776,1502,37.559399,127.171158
강동구,1016, 해뜨는 주유소옆 리엔파크 109동앞,201911,421,441,862,37.559399,127.171158
강동구,1016, 해뜨는 주유소옆 리엔파크 109동앞,201912,248,248,496,37.559399,127.171158
강동구,1016, 해뜨는 주유소옆 리엔파크 109동앞,202001,215,226,441,37.559399,127.171158
강동구,1016, 해뜨는 주유소옆 리엔파크 109동앞,202002,190,201,391,37.559399,127.171158
강동구,1016, 해뜨는 주유소옆 리엔파크 109동앞,202003,654,666,1320,37.559399,127.171158
강동구,1016, 해뜨는 주유소옆 리엔파크 109동앞,202004,1094,1100,2194,37.559399,127.171158
강동구,1016, 해뜨는 주유소옆 리엔파크 109동앞,202005,1235,1215,2450,37.559399,127.171158
강동구,1016, 해뜨는 주유소옆 리엔파크 109동앞,202006,893,919,1812,37.559399,127.171158
강동구,1017, 맥도날드(길동),201901,447,449,896,37.535473,127.145172
강동구,1017, 맥도날드(길동),201902,353,340,693,37.535473,127.145172
강동구,1017, 맥도날드(길동),201903,604,670,1274,37.535473,127.145172
강동구,1017, 맥도날드(길동),201904,1044,1086,2130,37.535473,127.145172
강동구,1017, 맥도날드(길동),201905,1833,1914,3747,37.535473,127.145172
강동구,1017, 맥도날드(길동),201906,2050,2136,4186,37.535473,127.145172
강동구,1017, 맥도날드(길동),201907,2149,2168,4317,37.535473,127.145172
강동구,1017, 맥도날드(길동),201908,1876,1993,3869,37.535473,127.145172
강동구,1017, 맥도날드(길동),201909,1818,1908,3726,37.535473,127.145172
강동구,1017, 맥도날드(길동),201910,2147,2221,4368,37.535473,127.145172
강동구,1017, 맥도날드(길동),201911,1349,1323,2672,37.535473,127.145172
강동구,1017, 맥도날드(길동),201912,706,707,1413,37.535473,127.145172
강동구,1017, 맥도날드(길동),202001,741,717,1458,37.535473,127.145172
강동구,1017, 맥도날드(길동),202002,737,714,1451,37.535473,127.145172
강동구,1017, 맥도날드(길동),202003,1456,1404,2860,37.535473,127.145172
강동구,1017, 맥도날드(길동),202004,1947,1951,3898,37.535473,127.145172
강동구,1017, 맥도날드(길동),202005,2379,2402,4781,37.535473,127.145172
강동구,1017, 맥도날드(길동),202006,2570,2675,5245,37.535473,127.145172
강동구,1018, 둔촌 주공 GS 맞은편,201901,196,255,451,37.524681,127.135406
강동구,1018, 둔촌 주공 GS 맞은편,201902,155,207,362,37.524681,127.135406
강동구,1018, 둔촌 주공 GS 맞은편,201903,337,430,767,37.524681,127.135406
강동구,1018, 둔촌 주공 GS 맞은편,201904,547,628,1175,37.524681,127.135406
강동구,1018, 둔촌 주공 GS 맞은편,201905,978,986,1964,37.524681,127.135406
강동구,1018, 둔촌 주공 GS 맞은편,201906,1139,1159,2298,37.524681,127.135406
강동구,1018, 둔촌 주공 GS 맞은편,201907,1052,1037,2089,37.524681,127.135406
강동구,1018, 둔촌 주공 GS 맞은편,201908,1094,1093,2187,37.524681,127.135406
강동구,1018, 둔촌 주공 GS 맞은편,201909,1054,969,2023,37.524681,127.135406
강동구,1018, 둔촌 주공 GS 맞은편,201910,1166,1126,2292,37.524681,127.135406
강동구,1018, 둔촌 주공 GS 맞은편,201911,787,711,1498,37.524681,127.135406
강동구,1018, 둔촌 주공 GS 맞은편,201912,392,403,795,37.524681,127.135406
강동구,1018, 둔촌 주공 GS 맞은편,202001,370,379,749,37.524681,127.135406
강동구,1018, 둔촌 주공 GS 맞은편,202002,362,337,699,37.524681,127.135406
강동구,1018, 둔촌 주공 GS 맞은편,202003,456,447,903,37.524681,127.135406
강동구,1018, 둔촌 주공 GS 맞은편,202004,21,21,42,37.524681,127.135406
강동구,1018, 둔촌 주공 GS 맞은편,202005,42,43,85,37.524681,127.135406
강동구,1018, 둔촌 주공 GS 맞은편,202006,118,132,250,37.524681,127.135406
강동구,1019, 다성이즈빌아파트(호원대 대각선 맞은편),201901,721,864,1585,37.526825,127.130028
강동구,1019, 다성이즈빌아파트(호원대 대각선 맞은편),201902,621,752,1373,37.526825,127.130028
강동구,1019, 다성이즈빌아파트(호원대 대각선 맞은편),201903,1429,1650,3079,37.526825,127.130028
강동구,1019, 다성이즈빌아파트(호원대 대각선 맞은편),201904,2087,2419,4506,37.526825,127.130028
강동구,1019, 다성이즈빌아파트(호원대 대각선 맞은편),201905,3520,3980,7500,37.526825,127.130028
강동구,1019, 다성이즈빌아파트(호원대 대각선 맞은편),201906,3732,4197,7929,37.526825,127.130028
강동구,1019, 다성이즈빌아파트(호원대 대각선 맞은편),201907,3591,3972,7563,37.526825,127.130028
강동구,1019, 다성이즈빌아파트(호원대 대각선 맞은편),201908,3527,3905,7432,37.526825,127.130028
강동구,1019, 다성이즈빌아파트(호원대 대각선 맞은편),201909,3455,3668,7123,37.526825,127.130028
강동구,1019, 다성이즈빌아파트(호원대 대각선 맞은편),201910,4331,4608,8939,37.526825,127.130028
강동구,1019, 다성이즈빌아파트(호원대 대각선 맞은편),201911,2948,3169,6117,37.526825,127.130028
강동구,1019, 다성이즈빌아파트(호원대 대각선 맞은편),201912,1678,1908,3586,37.526825,127.130028
강동구,1019, 다성이즈빌아파트(호원대 대각선 맞은편),202001,1389,1542,2931,37.526825,127.130028
강동구,1019, 다성이즈빌아파트(호원대 대각선 맞은편),202002,1277,1489,2766,37.526825,127.130028
강동구,1019, 다성이즈빌아파트(호원대 대각선 맞은편),202003,2196,2399,4595,37.526825,127.130028
강동구,1019, 다성이즈빌아파트(호원대 대각선 맞은편),202004,2793,3071,5864,37.526825,127.130028
강동구,1019, 다성이즈빌아파트(호원대 대각선 맞은편),202005,3755,3985,7740,37.526825,127.130028
강동구,1019, 다성이즈빌아파트(호원대 대각선 맞은편),202006,3883,4122,8005,37.526825,127.130028
강동구,1020, 강동경찰서,201901,719,834,1553,37.52829,127.126801
강동구,1020, 강동경찰서,201902,652,792,1444,37.52829,127.126801
강동구,1020, 강동경찰서,201903,1309,1392,2701,37.52829,127.126801
강동구,1020, 강동경찰서,201904,1931,2200,4131,37.52829,127.126801
강동구,1020, 강동경찰서,201905,3080,3313,6393,37.52829,127.126801
강동구,1020, 강동경찰서,201906,3334,3488,6822,37.52829,127.126801
강동구,1020, 강동경찰서,201907,3337,3607,6944,37.52829,127.126801
강동구,1020, 강동경찰서,201908,3249,3378,6627,37.52829,127.126801
강동구,1020, 강동경찰서,201909,3160,3311,6471,37.52829,127.126801
강동구,1020, 강동경찰서,201910,3660,3812,7472,37.52829,127.126801
강동구,1020, 강동경찰서,201911,2417,2646,5063,37.52829,127.126801
강동구,1020, 강동경찰서,201912,1386,1553,2939,37.52829,127.126801
강동구,1020, 강동경찰서,202001,1281,1419,2700,37.52829,127.126801
강동구,1020, 강동경찰서,202002,1195,1260,2455,37.52829,127.126801
강동구,1020, 강동경찰서,202003,1863,1942,3805,37.52829,127.126801
강동구,1020, 강동경찰서,202004,2306,2331,4637,37.52829,127.126801
강동구,1020, 강동경찰서,202005,2710,2765,5475,37.52829,127.126801
강동구,1020, 강동경찰서,202006,3230,3340,6570,37.52829,127.126801
강동구,1021, 강일동 리슈빌 빌딩앞,201901,280,313,593,37.564301,127.17395
강동구,1021, 강일동 리슈빌 빌딩앞,201902,254,261,515,37.564301,127.17395
강동구,1021, 강일동 리슈빌 빌딩앞,201903,459,497,956,37.564301,127.17395
강동구,1021, 강일동 리슈빌 빌딩앞,201904,706,848,1554,37.564301,127.17395
강동구,1021, 강일동 리슈빌 빌딩앞,201905,1234,1367,2601,37.564301,127.17395
강동구,1021, 강일동 리슈빌 빌딩앞,201906,1282,1470,2752,37.564301,127.17395
강동구,1021, 강일동 리슈빌 빌딩앞,201907,1166,1284,2450,37.564301,127.17395
강동구,1021, 강일동 리슈빌 빌딩앞,201908,1333,1460,2793,37.564301,127.17395
강동구,1021, 강일동 리슈빌 빌딩앞,201909,1400,1539,2939,37.564301,127.17395
강동구,1021, 강일동 리슈빌 빌딩앞,201910,1634,1689,3323,37.564301,127.17395
강동구,1021, 강일동 리슈빌 빌딩앞,201911,884,935,1819,37.564301,127.17395
강동구,1021, 강일동 리슈빌 빌딩앞,201912,530,553,1083,37.564301,127.17395
강동구,1021, 강일동 리슈빌 빌딩앞,202001,482,498,980,37.564301,127.17395
강동구,1021, 강일동 리슈빌 빌딩앞,202002,484,550,1034,37.564301,127.17395
강동구,1021, 강일동 리슈빌 빌딩앞,202003,1055,1120,2175,37.564301,127.17395
강동구,1021, 강일동 리슈빌 빌딩앞,202004,1569,1591,3160,37.564301,127.17395
강동구,1021, 강일동 리슈빌 빌딩앞,202005,1930,2009,3939,37.564301,127.17395
강동구,1021, 강일동 리슈빌 빌딩앞,202006,1770,1967,3737,37.564301,127.17395
강동구,1022, 길동 사거리(초소앞),201901,314,275,589,37.533764,127.138031
강동구,1022, 길동 사거리(초소앞),201902,270,223,493,37.533764,127.138031
강동구,1022, 길동 사거리(초소앞),201903,566,542,1108,37.533764,127.138031
강동구,1022, 길동 사거리(초소앞),201904,956,904,1860,37.533764,127.138031
강동구,1022, 길동 사거리(초소앞),201905,1710,1630,3340,37.533764,127.138031
강동구,1022, 길동 사거리(초소앞),201906,1807,1764,3571,37.533764,127.138031
강동구,1022, 길동 사거리(초소앞),201907,1813,1742,3555,37.533764,127.138031
강동구,1022, 길동 사거리(초소앞),201908,1877,1866,3743,37.533764,127.138031
강동구,1022, 길동 사거리(초소앞),201909,1845,1787,3632,37.533764,127.138031
강동구,1022, 길동 사거리(초소앞),201910,2275,2149,4424,37.533764,127.138031
강동구,1022, 길동 사거리(초소앞),201911,1459,1325,2784,37.533764,127.138031
강동구,1022, 길동 사거리(초소앞),201912,859,798,1657,37.533764,127.138031
강동구,1022, 길동 사거리(초소앞),202001,742,712,1454,37.533764,127.138031
강동구,1022, 길동 사거리(초소앞),202002,820,717,1537,37.533764,127.138031
강동구,1022, 길동 사거리(초소앞),202003,1261,1164,2425,37.533764,127.138031
강동구,1022, 길동 사거리(초소앞),202004,1705,1551,3256,37.533764,127.138031
강동구,1022, 길동 사거리(초소앞),202005,1890,1856,3746,37.533764,127.138031
강동구,1022, 길동 사거리(초소앞),202006,1997,1920,3917,37.533764,127.138031
강동구,1023, 한국종합기술사옥 앞,201901,290,318,608,37.549999,127.17469
강동구,1023, 한국종합기술사옥 앞,201902,268,276,544,37.549999,127.17469
강동구,1023, 한국종합기술사옥 앞,201903,420,467,887,37.549999,127.17469
강동구,1023, 한국종합기술사옥 앞,201904,865,926,1791,37.549999,127.17469
강동구,1023, 한국종합기술사옥 앞,201905,1300,1408,2708,37.549999,127.17469
강동구,1023, 한국종합기술사옥 앞,201906,1250,1311,2561,37.549999,127.17469
강동구,1023, 한국종합기술사옥 앞,201907,1442,1493,2935,37.549999,127.17469
강동구,1023, 한국종합기술사옥 앞,201908,1286,1352,2638,37.549999,127.17469
강동구,1023, 한국종합기술사옥 앞,201909,1359,1469,2828,37.549999,127.17469
강동구,1023, 한국종합기술사옥 앞,201910,1453,1593,3046,37.549999,127.17469
강동구,1023, 한국종합기술사옥 앞,201911,957,1078,2035,37.549999,127.17469
강동구,1023, 한국종합기술사옥 앞,201912,618,633,1251,37.549999,127.17469
강동구,1023, 한국종합기술사옥 앞,202001,528,575,1103,37.549999,127.17469
강동구,1023, 한국종합기술사옥 앞,202002,532,565,1097,37.549999,127.17469
강동구,1023, 한국종합기술사옥 앞,202003,1088,1120,2208,37.549999,127.17469
강동구,1023, 한국종합기술사옥 앞,202004,1610,1669,3279,37.549999,127.17469
강동구,1023, 한국종합기술사옥 앞,202005,1992,2046,4038,37.549999,127.17469
강동구,1023, 한국종합기술사옥 앞,202006,2150,2410,4560,37.549999,127.17469
강동구,1024, 강동구청 앞,201901,476,540,1016,37.529251,127.123108
강동구,1024, 강동구청 앞,201902,271,365,636,37.529251,127.123108
강동구,1024, 강동구청 앞,201903,606,730,1336,37.529251,127.123108
강동구,1024, 강동구청 앞,201904,969,1068,2037,37.529251,127.123108
강동구,1024, 강동구청 앞,201905,1610,1810,3420,37.529251,127.123108
강동구,1024, 강동구청 앞,201906,2007,2128,4135,37.529251,127.123108
강동구,1024, 강동구청 앞,201907,2176,2331,4507,37.529251,127.123108
강동구,1024, 강동구청 앞,201908,2185,2289,4474,37.529251,127.123108
강동구,1024, 강동구청 앞,201909,2152,2306,4458,37.529251,127.123108
강동구,1024, 강동구청 앞,201910,2505,2746,5251,37.529251,127.123108
강동구,1024, 강동구청 앞,201911,1638,1863,3501,37.529251,127.123108
강동구,1024, 강동구청 앞,201912,922,1071,1993,37.529251,127.123108
강동구,1024, 강동구청 앞,202001,851,943,1794,37.529251,127.123108
강동구,1024, 강동구청 앞,202002,847,941,1788,37.529251,127.123108
강동구,1024, 강동구청 앞,202003,1622,1678,3300,37.529251,127.123108
강동구,1024, 강동구청 앞,202004,2181,2278,4459,37.529251,127.123108
강동구,1024, 강동구청 앞,202005,2560,2664,5224,37.529251,127.123108
강동구,1024, 강동구청 앞,202006,2895,3116,6011,37.529251,127.123108
강동구,1025, 상일초등학교,201901,60,81,141,37.546841,127.172516
강동구,1025, 상일초등학교,201902,73,97,170,37.546841,127.172516
강동구,1025, 상일초등학교,201903,128,140,268,37.546841,127.172516
강동구,1025, 상일초등학교,201904,257,297,554,37.546841,127.172516
강동구,1025, 상일초등학교,201905,508,537,1045,37.546841,127.172516
강동구,1025, 상일초등학교,201906,539,562,1101,37.546841,127.172516
강동구,1025, 상일초등학교,201907,502,519,1021,37.546841,127.172516
강동구,1025, 상일초등학교,201908,446,465,911,37.546841,127.172516
강동구,1025, 상일초등학교,201909,446,502,948,37.546841,127.172516
강동구,1025, 상일초등학교,201910,509,554,1063,37.546841,127.172516
강동구,1025, 상일초등학교,201911,332,343,675,37.546841,127.172516
강동구,1025, 상일초등학교,201912,123,122,245,37.546841,127.172516
강동구,1025, 상일초등학교,202001,120,125,245,37.546841,127.172516
강동구,1025, 상일초등학교,202002,146,157,303,37.546841,127.172516
강동구,1025, 상일초등학교,202003,393,396,789,37.546841,127.172516
강동구,1025, 상일초등학교,202004,689,711,1400,37.546841,127.172516
강동구,1025, 상일초등학교,202005,808,834,1642,37.546841,127.172516
강동구,1025, 상일초등학교,202006,884,899,1783,37.546841,127.172516
강동구,1026, 대명초교 입구 교차로,201901,96,87,183,37.546631,127.155884
강동구,1026, 대명초교 입구 교차로,201902,139,129,268,37.546631,127.155884
강동구,1026, 대명초교 입구 교차로,201903,248,238,486,37.546631,127.155884
강동구,1026, 대명초교 입구 교차로,201904,392,370,762,37.546631,127.155884
강동구,1026, 대명초교 입구 교차로,201905,694,630,1324,37.546631,127.155884
강동구,1026, 대명초교 입구 교차로,201906,654,614,1268,37.546631,127.155884
강동구,1026, 대명초교 입구 교차로,201907,734,626,1360,37.546631,127.155884
강동구,1026, 대명초교 입구 교차로,201908,681,564,1245,37.546631,127.155884
강동구,1026, 대명초교 입구 교차로,201909,663,526,1189,37.546631,127.155884
강동구,1026, 대명초교 입구 교차로,201910,711,617,1328,37.546631,127.155884
강동구,1026, 대명초교 입구 교차로,201911,433,363,796,37.546631,127.155884
강동구,1026, 대명초교 입구 교차로,201912,208,196,404,37.546631,127.155884
강동구,1026, 대명초교 입구 교차로,202001,174,169,343,37.546631,127.155884
강동구,1026, 대명초교 입구 교차로,202002,201,174,375,37.546631,127.155884
강동구,1026, 대명초교 입구 교차로,202003,522,495,1017,37.546631,127.155884
강동구,1026, 대명초교 입구 교차로,202004,786,718,1504,37.546631,127.155884
강동구,1026, 대명초교 입구 교차로,202005,868,835,1703,37.546631,127.155884
강동구,1026, 대명초교 입구 교차로,202006,863,798,1661,37.546631,127.155884
강동구,1027, 프라자 아파트 앞,201901,216,181,397,37.535999,127.147697
강동구,1027, 프라자 아파트 앞,201902,190,163,353,37.535999,127.147697
강동구,1027, 프라자 아파트 앞,201903,333,272,605,37.535999,127.147697
강동구,1027, 프라자 아파트 앞,201904,444,461,905,37.535999,127.147697
강동구,1027, 프라자 아파트 앞,201905,903,941,1844,37.535999,127.147697
강동구,1027, 프라자 아파트 앞,201906,1051,1139,2190,37.535999,127.147697
강동구,1027, 프라자 아파트 앞,201907,968,1043,2011,37.535999,127.147697
강동구,1027, 프라자 아파트 앞,201908,1085,1092,2177,37.535999,127.147697
강동구,1027, 프라자 아파트 앞,201909,1072,1138,2210,37.535999,127.147697
강동구,1027, 프라자 아파트 앞,201910,1283,1291,2574,37.535999,127.147697
강동구,1027, 프라자 아파트 앞,201911,863,842,1705,37.535999,127.147697
강동구,1027, 프라자 아파트 앞,201912,474,457,931,37.535999,127.147697
강동구,1027, 프라자 아파트 앞,202001,404,359,763,37.535999,127.147697
강동구,1027, 프라자 아파트 앞,202002,413,357,770,37.535999,127.147697
강동구,1027, 프라자 아파트 앞,202003,781,706,1487,37.535999,127.147697
강동구,1027, 프라자 아파트 앞,202004,1065,1033,2098,37.535999,127.147697
강동구,1027, 프라자 아파트 앞,202005,1376,1356,2732,37.535999,127.147697
강동구,1027, 프라자 아파트 앞,202006,1513,1524,3037,37.535999,127.147697
강동구,1028, 포레스 주상복합 빌딩,201901,219,256,475,37.5331,127.12278
강동구,1028, 포레스 주상복합 빌딩,201902,309,314,623,37.5331,127.12278
강동구,1028, 포레스 주상복합 빌딩,201903,510,515,1025,37.5331,127.12278
강동구,1028, 포레스 주상복합 빌딩,201904,723,718,1441,37.5331,127.12278
강동구,1028, 포레스 주상복합 빌딩,201905,1201,1203,2404,37.5331,127.12278
강동구,1028, 포레스 주상복합 빌딩,201906,1407,1402,2809,37.5331,127.12278
강동구,1028, 포레스 주상복합 빌딩,201907,1360,1361,2721,37.5331,127.12278
강동구,1028, 포레스 주상복합 빌딩,201908,1320,1320,2640,37.5331,127.12278
강동구,1028, 포레스 주상복합 빌딩,201909,1222,1216,2438,37.5331,127.12278
강동구,1028, 포레스 주상복합 빌딩,201910,1454,1467,2921,37.5331,127.12278
강동구,1028, 포레스 주상복합 빌딩,201911,995,1015,2010,37.5331,127.12278
강동구,1028, 포레스 주상복합 빌딩,201912,581,599,1180,37.5331,127.12278
강동구,1028, 포레스 주상복합 빌딩,202001,515,554,1069,37.5331,127.12278
강동구,1028, 포레스 주상복합 빌딩,202002,441,439,880,37.5331,127.12278
강동구,1028, 포레스 주상복합 빌딩,202003,724,745,1469,37.5331,127.12278
강동구,1028, 포레스 주상복합 빌딩,202004,1071,1058,2129,37.5331,127.12278
강동구,1028, 포레스 주상복합 빌딩,202005,1338,1339,2677,37.5331,127.12278
강동구,1028, 포레스 주상복합 빌딩,202006,1606,1610,3216,37.5331,127.12278
강동구,1029, 롯데 시네마,201901,593,619,1212,37.536541,127.125397
강동구,1029, 롯데 시네마,201902,508,560,1068,37.536541,127.125397
강동구,1029, 롯데 시네마,201903,780,857,1637,37.536541,127.125397
강동구,1029, 롯데 시네마,201904,1216,1241,2457,37.536541,127.125397
강동구,1029, 롯데 시네마,201905,2296,2343,4639,37.536541,127.125397
강동구,1029, 롯데 시네마,201906,2632,2703,5335,37.536541,127.125397
강동구,1029, 롯데 시네마,201907,2218,2301,4519,37.536541,127.125397
강동구,1029, 롯데 시네마,201908,2537,2609,5146,37.536541,127.125397
강동구,1029, 롯데 시네마,201909,2456,2519,4975,37.536541,127.125397
강동구,1029, 롯데 시네마,201910,2970,3032,6002,37.536541,127.125397
강동구,1029, 롯데 시네마,201911,1878,1997,3875,37.536541,127.125397
강동구,1029, 롯데 시네마,201912,1004,1065,2069,37.536541,127.125397
강동구,1029, 롯데 시네마,202001,852,895,1747,37.536541,127.125397
강동구,1029, 롯데 시네마,202002,788,809,1597,37.536541,127.125397
강동구,1029, 롯데 시네마,202003,1616,1638,3254,37.536541,127.125397
강동구,1029, 롯데 시네마,202004,2186,2202,4388,37.536541,127.125397
강동구,1029, 롯데 시네마,202005,2457,2448,4905,37.536541,127.125397
강동구,1029, 롯데 시네마,202006,2679,2703,5382,37.536541,127.125397
강동구,1030, 미호 플랜트 앞,201901,243,255,498,37.527061,127.12207
강동구,1030, 미호 플랜트 앞,201902,263,265,528,37.527061,127.12207
강동구,1030, 미호 플랜트 앞,201903,558,560,1118,37.527061,127.12207
강동구,1030, 미호 플랜트 앞,201904,1069,1012,2081,37.527061,127.12207
강동구,1030, 미호 플랜트 앞,201905,1467,1488,2955,37.527061,127.12207
강동구,1030, 미호 플랜트 앞,201906,1495,1490,2985,37.527061,127.12207
강동구,1030, 미호 플랜트 앞,201907,1390,1365,2755,37.527061,127.12207
강동구,1030, 미호 플랜트 앞,201908,1498,1468,2966,37.527061,127.12207
강동구,1030, 미호 플랜트 앞,201909,1498,1500,2998,37.527061,127.12207
강동구,1030, 미호 플랜트 앞,201910,1708,1718,3426,37.527061,127.12207
강동구,1030, 미호 플랜트 앞,201911,945,939,1884,37.527061,127.12207
강동구,1030, 미호 플랜트 앞,201912,551,560,1111,37.527061,127.12207
강동구,1030, 미호 플랜트 앞,202001,444,426,870,37.527061,127.12207
강동구,1030, 미호 플랜트 앞,202002,502,499,1001,37.527061,127.12207
강동구,1030, 미호 플랜트 앞,202003,1358,1320,2678,37.527061,127.12207
강동구,1030, 미호 플랜트 앞,202004,1602,1591,3193,37.527061,127.12207
강동구,1030, 미호 플랜트 앞,202005,1701,1693,3394,37.527061,127.12207
강동구,1030, 미호 플랜트 앞,202006,1396,1418,2814,37.527061,127.12207
강동구,1031, 암사동 CBIS,201901,64,81,145,37.555851,127.129898
강동구,1031, 암사동 CBIS,201903,20,19,39,37.555851,127.129898
강동구,1031, 암사동 CBIS,201904,186,262,448,37.555851,127.129898
강동구,1031, 암사동 CBIS,201905,407,533,940,37.555851,127.129898
강동구,1031, 암사동 CBIS,201906,526,693,1219,37.555851,127.129898
강동구,1031, 암사동 CBIS,201907,458,582,1040,37.555851,127.129898
강동구,1031, 암사동 CBIS,201908,509,576,1085,37.555851,127.129898
강동구,1031, 암사동 CBIS,201909,563,657,1220,37.555851,127.129898
강동구,1031, 암사동 CBIS,201910,747,814,1561,37.555851,127.129898
강동구,1031, 암사동 CBIS,201911,304,359,663,37.555851,127.129898
강동구,1031, 올림픽로 836(아리수로),201912,209,229,438,37.555851,127.129898
강동구,1031, 올림픽로 836(아리수로),202001,173,195,368,37.555851,127.129898
강동구,1031, 올림픽로 836(아리수로),202002,154,197,351,37.555851,127.129898
강동구,1031, 올림픽로 836(아리수로),202003,510,517,1027,37.555851,127.129898
강동구,1031, 올림픽로 836(아리수로),202004,779,792,1571,37.555851,127.129898
강동구,1031, 올림픽로 836(아리수로),202005,848,855,1703,37.555851,127.129898
강동구,1031, 올림픽로 836(아리수로),202006,852,880,1732,37.555851,127.129898
강동구,1032, 선사고등학교,201901,83,62,145,37.556728,127.136208
강동구,1032, 선사고등학교,201902,88,89,177,37.556728,127.136208
강동구,1032, 선사고등학교,201903,138,157,295,37.556728,127.136208
강동구,1032, 선사고등학교,201904,186,265,451,37.556728,127.136208
강동구,1032, 선사고등학교,201905,359,426,785,37.556728,127.136208
강동구,1032, 선사고등학교,201906,460,505,965,37.556728,127.136208
강동구,1032, 선사고등학교,201907,508,593,1101,37.556728,127.136208
강동구,1032, 선사고등학교,201908,420,516,936,37.556728,127.136208
강동구,1032, 선사고등학교,201909,534,585,1119,37.556728,127.136208
강동구,1032, 선사고등학교,201910,622,639,1261,37.556728,127.136208
강동구,1032, 선사고등학교,201911,353,340,693,37.556728,127.136208
강동구,1032, 선사고등학교,201912,198,177,375,37.556728,127.136208
강동구,1032, 선사고등학교,202001,176,198,374,37.556728,127.136208
강동구,1032, 선사고등학교,202002,177,173,350,37.556728,127.136208
강동구,1032, 선사고등학교,202003,457,420,877,37.556728,127.136208
강동구,1032, 선사고등학교,202004,491,480,971,37.556728,127.136208
강동구,1032, 선사고등학교,202005,733,717,1450,37.556728,127.136208
강동구,1032, 선사고등학교,202006,796,817,1613,37.556728,127.136208
강동구,1033, 고덕동 아남아파트,201901,232,194,426,37.557991,127.144707
강동구,1033, 고덕동 아남아파트,201902,231,201,432,37.557991,127.144707
강동구,1033, 고덕동 아남아파트,201903,355,243,598,37.557991,127.144707
강동구,1033, 고덕동 아남아파트,201904,567,419,986,37.557991,127.144707
강동구,1033, 고덕동 아남아파트,201905,803,672,1475,37.557991,127.144707
강동구,1033, 고덕동 아남아파트,201906,937,833,1770,37.557991,127.144707
강동구,1033, 고덕동 아남아파트,201907,843,750,1593,37.557991,127.144707
강동구,1033, 고덕동 아남아파트,201908,873,764,1637,37.557991,127.144707
강동구,1033, 고덕동 아남아파트,201909,788,720,1508,37.557991,127.144707
강동구,1033, 고덕동 아남아파트,201910,857,767,1624,37.557991,127.144707
강동구,1033, 고덕동 아남아파트,201911,596,458,1054,37.557991,127.144707
강동구,1033, 고덕동 아남아파트,201912,340,252,592,37.557991,127.144707
강동구,1033, 고덕동 아남아파트,202001,363,250,613,37.557991,127.144707
강동구,1033, 고덕동 아남아파트,202002,327,277,604,37.557991,127.144707
강동구,1033, 고덕동 아남아파트,202003,522,477,999,37.557991,127.144707
강동구,1033, 고덕동 아남아파트,202004,997,941,1938,37.557991,127.144707
강동구,1033, 고덕동 아남아파트,202005,1134,1077,2211,37.557991,127.144707
강동구,1033, 고덕동 아남아파트,202006,976,920,1896,37.557991,127.144707
강동구,1034, 고덕동 래미안 힐스테이트,201901,72,104,176,37.561909,127.150749
강동구,1034, 고덕동 래미안 힐스테이트,201902,88,77,165,37.561909,127.150749
강동구,1034, 고덕동 래미안 힐스테이트,201903,182,181,363,37.561909,127.150749
강동구,1034, 고덕동 래미안 힐스테이트,201904,243,234,477,37.561909,127.150749
강동구,1034, 고덕동 래미안 힐스테이트,201905,383,389,772,37.561909,127.150749
강동구,1034, 고덕동 래미안 힐스테이트,201906,375,392,767,37.561909,127.150749
강동구,1034, 고덕동 래미안 힐스테이트,201907,418,377,795,37.561909,127.150749
강동구,1034, 고덕동 래미안 힐스테이트,201908,381,371,752,37.561909,127.150749
강동구,1034, 고덕동 래미안 힐스테이트,201909,461,450,911,37.561909,127.150749
강동구,1034, 고덕동 래미안 힐스테이트,201910,455,435,890,37.561909,127.150749
강동구,1034, 고덕동 래미안 힐스테이트,201911,262,259,521,37.561909,127.150749
강동구,1034, 고덕동 래미안 힐스테이트,201912,196,162,358,37.561909,127.150749
강동구,1034, 고덕동 래미안 힐스테이트,202001,145,116,261,37.561909,127.150749
강동구,1034, 고덕동 래미안 힐스테이트,202002,93,64,157,37.561909,127.150749
강동구,1034, 고덕동 래미안 힐스테이트,202003,415,426,841,37.561909,127.150749
강동구,1034, 고덕동 래미안 힐스테이트,202004,622,610,1232,37.561909,127.150749
강동구,1034, 고덕동 래미안 힐스테이트,202005,637,589,1226,37.561909,127.150749
강동구,1034, 고덕동 래미안 힐스테이트,202006,596,589,1185,37.561909,127.150749
강동구,1035, 고덕역 4번출구,201901,535,344,879,37.555016,127.155273
강동구,1035, 고덕역 4번출구,201902,495,364,859,37.555016,127.155273
강동구,1035, 고덕역 4번출구,201903,783,568,1351,37.555016,127.155273
강동구,1035, 고덕역 4번출구,201904,1169,900,2069,37.555016,127.155273
강동구,1035, 고덕역 4번출구,201905,1804,1398,3202,37.555016,127.155273
강동구,1035, 고덕역 4번출구,201906,1966,1600,3566,37.555016,127.155273
강동구,1035, 고덕역 4번출구,201907,1768,1447,3215,37.555016,127.155273
강동구,1035, 고덕역 4번출구,201908,1743,1382,3125,37.555016,127.155273
강동구,1035, 고덕역 4번출구,201909,1776,1420,3196,37.555016,127.155273
강동구,1035, 고덕역 4번출구,201910,1986,1687,3673,37.555016,127.155273
강동구,1035, 고덕역 4번출구,201911,1490,1100,2590,37.555016,127.155273
강동구,1035, 고덕역 4번출구,201912,957,636,1593,37.555016,127.155273
강동구,1035, 고덕역 4번출구,202001,952,671,1623,37.555016,127.155273
강동구,1035, 고덕역 4번출구,202002,808,572,1380,37.555016,127.155273
강동구,1035, 고덕역 4번출구,202003,1678,1415,3093,37.555016,127.155273
강동구,1035, 고덕역 4번출구,202004,1351,1235,2586,37.555016,127.155273
강동구,1035, 고덕역 4번출구,202005,154,158,312,37.555016,127.155273
강동구,1035, 고덕역 4번출구,202006,145,145,290,37.555016,127.155273
강동구,1036, 고덕동 주양쇼핑,201901,186,147,333,37.551998,127.153297
강동구,1036, 고덕동 주양쇼핑,201902,202,184,386,37.551998,127.153297
강동구,1036, 고덕동 주양쇼핑,201903,290,237,527,37.551998,127.153297
강동구,1036, 고덕동 주양쇼핑,201904,493,425,918,37.551998,127.153297
강동구,1036, 고덕동 주양쇼핑,201905,997,913,1910,37.551998,127.153297
강동구,1036, 고덕동 주양쇼핑,201906,1133,1012,2145,37.551998,127.153297
강동구,1036, 고덕동 주양쇼핑,201907,1049,1023,2072,37.551998,127.153297
강동구,1036, 고덕동 주양쇼핑,201908,904,906,1810,37.551998,127.153297
강동구,1036, 고덕동 주양쇼핑,201909,1090,1007,2097,37.551998,127.153297
강동구,1036, 고덕동 주양쇼핑,201910,1275,1262,2537,37.551998,127.153297
강동구,1036, 고덕동 주양쇼핑,201911,757,708,1465,37.551998,127.153297
강동구,1036, 고덕동 주양쇼핑,201912,353,319,672,37.551998,127.153297
강동구,1036, 고덕동 주양쇼핑,202001,376,367,743,37.551998,127.153297
강동구,1036, 고덕동 주양쇼핑,202002,347,350,697,37.551998,127.153297
강동구,1036, 고덕동 주양쇼핑,202003,762,764,1526,37.551998,127.153297
강동구,1036, 고덕동 주양쇼핑,202004,1469,1468,2937,37.551998,127.153297
강동구,1036, 고덕동 주양쇼핑,202005,2436,2421,4857,37.551998,127.153297
강동구,1036, 고덕동 주양쇼핑,202006,1922,1921,3843,37.551998,127.153297
강동구,1037, 강일 6단지,201901,33,33,66,37.562588,127.177612
강동구,1037, 강일 6단지,201902,36,34,70,37.562588,127.177612
강동구,1037, 강일 6단지,201903,85,92,177,37.562588,127.177612
강동구,1037, 강일 6단지,201904,138,165,303,37.562588,127.177612
강동구,1037, 강일 6단지,201905,217,283,500,37.562588,127.177612
강동구,1037, 강일리버파크 6단지,201906,225,278,503,37.562588,127.177612
강동구,1037, 강일리버파크 6단지,201907,210,231,441,37.562588,127.177612
강동구,1037, 강일리버파크 6단지,201908,194,216,410,37.562588,127.177612
강동구,1037, 강일리버파크 6단지,201909,212,249,461,37.562588,127.177612
강동구,1037, 강일리버파크 6단지,201910,215,225,440,37.562588,127.177612
강동구,1037, 강일리버파크 6단지,201911,116,115,231,37.562588,127.177612
강동구,1037, 강일리버파크 6단지,201912,55,49,104,37.562588,127.177612
강동구,1037, 강일리버파크 6단지,202001,56,52,108,37.562588,127.177612
강동구,1037, 강일리버파크 6단지,202002,42,57,99,37.562588,127.177612
강동구,1037, 강일리버파크 6단지,202003,179,186,365,37.562588,127.177612
강동구,1037, 강일리버파크 6단지,202004,312,320,632,37.562588,127.177612
강동구,1037, 강일리버파크 6단지,202005,327,335,662,37.562588,127.177612
강동구,1037, 강일리버파크 6단지,202006,259,304,563,37.562588,127.177612
강동구,1038, 강일 다솜 어린이 공원,201901,39,40,79,37.568668,127.174797
강동구,1038, 강일 다솜 어린이 공원,201902,47,42,89,37.568668,127.174797
강동구,1038, 강일 다솜 어린이 공원,201903,84,85,169,37.568668,127.174797
강동구,1038, 강일 다솜 어린이 공원,201904,138,146,284,37.568668,127.174797
강동구,1038, 강일 다솜 어린이 공원,201905,195,209,404,37.568668,127.174797
강동구,1038, 강일 다솜 어린이 공원,201906,162,198,360,37.568668,127.174797
강동구,1038, 강일 다솜 어린이 공원,201907,154,178,332,37.568668,127.174797
강동구,1038, 강일 다솜 어린이 공원,201908,167,179,346,37.568668,127.174797
강동구,1038, 강일 다솜 어린이 공원,201909,164,174,338,37.568668,127.174797
강동구,1038, 강일 다솜 어린이 공원,201910,178,208,386,37.568668,127.174797
강동구,1038, 강일 다솜 어린이 공원,201911,111,110,221,37.568668,127.174797
강동구,1038, 강일 다솜 어린이 공원,201912,65,51,116,37.568668,127.174797
강동구,1038, 강일 다솜 어린이 공원,202001,35,42,77,37.568668,127.174797
강동구,1038, 강일 다솜 어린이 공원,202002,65,55,120,37.568668,127.174797
강동구,1038, 강일 다솜 어린이 공원,202003,205,231,436,37.568668,127.174797
강동구,1038, 강일 다솜 어린이 공원,202004,396,393,789,37.568668,127.174797
강동구,1038, 강일 다솜 어린이 공원,202005,444,462,906,37.568668,127.174797
강동구,1038, 강일 다솜 어린이 공원,202006,317,400,717,37.568668,127.174797
강동구,1039, 고덕초등학교,201901,54,53,107,37.561279,127.167801
강동구,1039, 고덕초등학교,201902,64,63,127,37.561279,127.167801
강동구,1039, 고덕초등학교,201903,60,76,136,37.561279,127.167801
강동구,1039, 고덕초등학교,201904,162,148,310,37.561279,127.167801
강동구,1039, 고덕초등학교,201905,160,182,342,37.561279,127.167801
강동구,1039, 고덕초등학교,201906,168,205,373,37.561279,127.167801
강동구,1039, 고덕초등학교,201907,128,200,328,37.561279,127.167801
강동구,1039, 고덕초등학교,201908,158,182,340,37.561279,127.167801
강동구,1039, 고덕초등학교,201909,157,186,343,37.561279,127.167801
강동구,1039, 고덕초등학교,201910,166,209,375,37.561279,127.167801
강동구,1039, 고덕초등학교,201911,65,109,174,37.561279,127.167801
강동구,1039, 고덕초등학교,201912,54,70,124,37.561279,127.167801
강동구,1039, 고덕초등학교,202001,43,55,98,37.561279,127.167801
강동구,1039, 고덕초등학교,202002,64,71,135,37.561279,127.167801
강동구,1039, 고덕초등학교,202003,108,115,223,37.561279,127.167801
강동구,1039, 고덕초등학교,202004,240,247,487,37.561279,127.167801
강동구,1039, 고덕초등학교,202005,316,325,641,37.561279,127.167801
강동구,1039, 고덕초등학교,202006,254,281,535,37.561279,127.167801
강동구,1040, 강일동 에너지 마루,201901,21,26,47,#N/A,#N/A
강동구,1041, 묘곡초등학교,201901,149,147,296,37.559196,127.153297
강동구,1041, 묘곡초등학교,201902,155,168,323,37.559196,127.153297
강동구,1041, 묘곡초등학교,201903,294,290,584,37.559196,127.153297
강동구,1041, 묘곡초등학교,201904,394,425,819,37.559196,127.153297
강동구,1041, 묘곡초등학교,201905,754,865,1619,37.559196,127.153297
강동구,1041, 묘곡초등학교,201906,770,869,1639,37.559196,127.153297
강동구,1041, 묘곡초등학교,201907,765,799,1564,37.559196,127.153297
강동구,1041, 묘곡초등학교,201908,719,752,1471,37.559196,127.153297
강동구,1041, 묘곡초등학교,201909,691,694,1385,37.559196,127.153297
강동구,1041, 묘곡초등학교,201910,741,743,1484,37.559196,127.153297
강동구,1041, 묘곡초등학교,201911,405,414,819,37.559196,127.153297
강동구,1041, 묘곡초등학교,201912,202,205,407,37.559196,127.153297
강동구,1041, 묘곡초등학교,202001,216,218,434,37.559196,127.153297
강동구,1041, 묘곡초등학교,202002,218,229,447,37.559196,127.153297
강동구,1041, 묘곡초등학교,202003,470,478,948,37.559196,127.153297
강동구,1041, 묘곡초등학교,202004,805,821,1626,37.559196,127.153297
강동구,1041, 묘곡초등학교,202005,1102,1079,2181,37.559196,127.153297
강동구,1041, 묘곡초등학교,202006,885,899,1784,37.559196,127.153297
강동구,1042, 강일 2,201901,90,99,189,37.568562,127.177002
강동구,1042, 강일 2,201902,107,113,220,37.568562,127.177002
강동구,1042, 강일 2,201903,251,280,531,37.568562,127.177002
강동구,1042, 강일 2,201904,316,305,621,37.568562,127.177002
강동구,1042, 강일 2,201905,488,596,1084,37.568562,127.177002
강동구,1042, 강일리버파크 2~5단지,201906,533,657,1190,37.568562,127.177002
강동구,1042, 강일리버파크 2~5단지,201907,394,522,916,37.568562,127.177002
강동구,1042, 강일리버파크 2~5단지,201908,438,513,951,37.568562,127.177002
강동구,1042, 강일리버파크 2~5단지,201909,472,529,1001,37.568562,127.177002
강동구,1042, 강일리버파크 2~5단지,201910,581,645,1226,37.568562,127.177002
강동구,1042, 강일리버파크 2~5단지,201911,301,377,678,37.568562,127.177002
강동구,1042, 강일리버파크 2~5단지,201912,159,163,322,37.568562,127.177002
강동구,1042, 강일리버파크 2~5단지,202001,241,246,487,37.568562,127.177002
강동구,1042, 강일리버파크 2~5단지,202002,254,245,499,37.568562,127.177002
강동구,1042, 강일리버파크 2~5단지,202003,527,567,1094,37.568562,127.177002
강동구,1042, 강일리버파크 2~5단지,202004,757,845,1602,37.568562,127.177002
강동구,1042, 강일리버파크 2~5단지,202005,911,960,1871,37.568562,127.177002
강동구,1042, 강일리버파크 2~5단지,202006,841,936,1777,37.568562,127.177002
강동구,1044, 굽은다리역,201901,612,659,1271,37.545399,127.142601
강동구,1044, 굽은다리역,201902,584,607,1191,37.545399,127.142601
강동구,1044, 굽은다리역,201903,1100,1181,2281,37.545399,127.142601
강동구,1044, 굽은다리역,201904,1756,2039,3795,37.545399,127.142601
강동구,1044, 굽은다리역,201905,3459,3857,7316,37.545399,127.142601
강동구,1044, 굽은다리역,201906,4092,4415,8507,37.545399,127.142601
강동구,1044, 굽은다리역,201907,4122,4361,8483,37.545399,127.142601
강동구,1044, 굽은다리역,201908,4061,4193,8254,37.545399,127.142601
강동구,1044, 굽은다리역,201909,3772,4085,7857,37.545399,127.142601
강동구,1044, 굽은다리역,201910,4583,4774,9357,37.545399,127.142601
강동구,1044, 굽은다리역,201911,2712,2860,5572,37.545399,127.142601
강동구,1044, 굽은다리역,201912,1418,1540,2958,37.545399,127.142601
강동구,1044, 굽은다리역,202001,1186,1358,2544,37.545399,127.142601
강동구,1044, 굽은다리역,202002,1264,1398,2662,37.545399,127.142601
강동구,1044, 굽은다리역,202003,2625,2782,5407,37.545399,127.142601
강동구,1044, 굽은다리역,202004,3734,3997,7731,37.545399,127.142601
강동구,1044, 굽은다리역,202005,4802,4938,9740,37.545399,127.142601
강동구,1044, 굽은다리역,202006,5161,5221,10382,37.545399,127.142601
강동구,1047, 건강보험 강동지사kt,201901,358,400,758,37.536381,127.137253
강동구,1047, 건강보험 강동지사kt,201902,293,309,602,37.536381,127.137253
강동구,1047, 건강보험 강동지사kt,201903,531,623,1154,37.536381,127.137253
강동구,1047, 건강보험 강동지사kt,201904,896,987,1883,37.536381,127.137253
강동구,1047, 건강보험 강동지사kt,201905,1713,1878,3591,37.536381,127.137253
강동구,1047, 건강보험 강동지사kt,201906,2156,2302,4458,37.536381,127.137253
강동구,1047, 건강보험 강동지사kt,201907,2126,2185,4311,37.536381,127.137253
강동구,1047, 건강보험 강동지사kt,201908,1998,2124,4122,37.536381,127.137253
강동구,1047, 건강보험 강동지사kt,201909,1782,1919,3701,37.536381,127.137253
강동구,1047, 건강보험 강동지사kt,201910,2244,2382,4626,37.536381,127.137253
강동구,1047, 건강보험 강동지사kt,201911,1276,1412,2688,37.536381,127.137253
강동구,1047, 건강보험 강동지사kt,201912,672,767,1439,37.536381,127.137253
강동구,1047, 건강보험 강동지사kt,202001,607,677,1284,37.536381,127.137253
강동구,1047, 건강보험 강동지사kt,202002,662,711,1373,37.536381,127.137253
강동구,1047, 건강보험 강동지사kt,202003,1168,1264,2432,37.536381,127.137253
강동구,1047, 건강보험 강동지사kt,202004,1822,1918,3740,37.536381,127.137253
강동구,1047, 건강보험 강동지사kt,202005,2319,2384,4703,37.536381,127.137253
강동구,1047, 건강보험 강동지사kt,202006,2488,2581,5069,37.536381,127.137253
강동구,1048, 동부기업(둔촌동),201901,336,340,676,37.531013,127.142365
강동구,1048, 동부기업(둔촌동),201902,339,329,668,37.531013,127.142365
강동구,1048, 동부기업(둔촌동),201903,612,637,1249,37.531013,127.142365
강동구,1048, 동부기업(둔촌동),201904,890,917,1807,37.531013,127.142365
강동구,1048, 동부기업(둔촌동),201905,1578,1751,3329,37.531013,127.142365
강동구,1048, 동부기업(둔촌동),201906,1922,2186,4108,37.531013,127.142365
강동구,1048, 동부기업(둔촌동),201907,1856,2229,4085,37.531013,127.142365
강동구,1048, 동부기업(둔촌동),201908,1755,2059,3814,37.531013,127.142365
강동구,1048, 동부기업(둔촌동),201909,1827,2011,3838,37.531013,127.142365
강동구,1048, 동부기업(둔촌동),201910,2129,2416,4545,37.531013,127.142365
강동구,1048, 동부기업(둔촌동),201911,1255,1333,2588,37.531013,127.142365
강동구,1048, 동부기업(둔촌동),201912,675,686,1361,37.531013,127.142365
강동구,1048, 동부기업(둔촌동),202001,595,657,1252,37.531013,127.142365
강동구,1048, 동부기업(둔촌동),202002,738,800,1538,37.531013,127.142365
강동구,1048, 동부기업(둔촌동),202003,1343,1453,2796,37.531013,127.142365
강동구,1048, 동부기업(둔촌동),202004,1971,2052,4023,37.531013,127.142365
강동구,1048, 동부기업(둔촌동),202005,2244,2382,4626,37.531013,127.142365
강동구,1048, 동부기업(둔촌동),202006,2551,2874,5425,37.531013,127.142365
강동구,1049, 강일동 10단지 아파트,201901,121,141,262,37.56118,127.180267
강동구,1049, 강일동 10단지 아파트,201902,88,79,167,37.56118,127.180267
강동구,1049, 강일동 10단지 아파트,201903,202,196,398,37.56118,127.180267
강동구,1049, 강일동 10단지 아파트,201904,362,380,742,37.56118,127.180267
강동구,1049, 강일동 10단지 아파트,201905,603,705,1308,37.56118,127.180267
강동구,1049, 강일리버파크 10단지,201906,603,666,1269,37.56118,127.180267
강동구,1049, 강일리버파크 10단지,201907,614,689,1303,37.56118,127.180267
강동구,1049, 강일리버파크 10단지,201908,639,751,1390,37.56118,127.180267
강동구,1049, 강일리버파크 10단지,201909,604,717,1321,37.56118,127.180267
강동구,1049, 강일리버파크 10단지,201910,755,853,1608,37.56118,127.180267
강동구,1049, 강일리버파크 10단지,201911,445,490,935,37.56118,127.180267
강동구,1049, 강일리버파크 10단지,201912,301,305,606,37.56118,127.180267
강동구,1049, 강일리버파크 10단지,202001,267,284,551,37.56118,127.180267
강동구,1049, 강일리버파크 10단지,202002,301,319,620,37.56118,127.180267
강동구,1049, 강일리버파크 10단지,202003,571,606,1177,37.56118,127.180267
강동구,1049, 강일리버파크 10단지,202004,892,952,1844,37.56118,127.180267
강동구,1049, 강일리버파크 10단지,202005,1115,1192,2307,37.56118,127.180267
강동구,1049, 강일리버파크 10단지,202006,1109,1337,2446,37.56118,127.180267
강동구,1050, 둔촌역 3번 출입구,201901,700,823,1523,37.526695,127.135529
강동구,1050, 둔촌역 3번 출입구,201902,637,726,1363,37.526695,127.135529
강동구,1050, 둔촌역 3번 출입구,201903,1271,1352,2623,37.526695,127.135529
강동구,1050, 둔촌역 3번 출입구,201904,2073,2196,4269,37.526695,127.135529
강동구,1050, 둔촌역 3번 출입구,201905,3760,3812,7572,37.526695,127.135529
강동구,1050, 둔촌역 3번 출입구,201906,4335,4423,8758,37.526695,127.135529
강동구,1050, 둔촌역 3번 출입구,201907,4372,4533,8905,37.526695,127.135529
강동구,1050, 둔촌역 3번 출입구,201908,4146,4337,8483,37.526695,127.135529
강동구,1050, 둔촌역 3번 출입구,201909,4218,4308,8526,37.526695,127.135529
강동구,1050, 둔촌역 3번 출입구,201910,5000,5078,10078,37.526695,127.135529
강동구,1050, 둔촌역 3번 출입구,201911,3056,3242,6298,37.526695,127.135529
강동구,1050, 둔촌역 3번 출입구,201912,1731,1883,3614,37.526695,127.135529
강동구,1050, 둔촌역 3번 출입구,202001,1459,1694,3153,37.526695,127.135529
강동구,1050, 둔촌역 3번 출입구,202002,1414,1615,3029,37.526695,127.135529
강동구,1050, 둔촌역 3번 출입구,202003,2597,2847,5444,37.526695,127.135529
강동구,1050, 둔촌역 3번 출입구,202004,3944,4081,8025,37.526695,127.135529
강동구,1050, 둔촌역 3번 출입구,202005,5242,5340,10582,37.526695,127.135529
강동구,1050, 둔촌역 3번 출입구,202006,5206,5316,10522,37.526695,127.135529
강동구,1051, 양지시장 (용성약국앞) 입구,201901,273,271,544,37.554829,127.137321
강동구,1051, 양지시장 (용성약국앞) 입구,201902,292,287,579,37.554829,127.137321
강동구,1051, 양지시장 (용성약국앞) 입구,201903,467,476,943,37.554829,127.137321
강동구,1051, 양지시장 (용성약국앞) 입구,201904,720,757,1477,37.554829,127.137321
강동구,1051, 양지시장 (용성약국앞) 입구,201905,1149,1262,2411,37.554829,127.137321
강동구,1051, 양지시장 (용성약국앞) 입구,201906,1346,1411,2757,37.554829,127.137321
강동구,1051, 양지시장 (용성약국앞) 입구,201907,1369,1402,2771,37.554829,127.137321
강동구,1051, 양지시장 (용성약국앞) 입구,201908,1340,1408,2748,37.554829,127.137321
강동구,1051, 양지시장 (용성약국앞) 입구,201909,1337,1346,2683,37.554829,127.137321
강동구,1051, 양지시장 (용성약국앞) 입구,201910,1417,1412,2829,37.554829,127.137321
강동구,1051, 양지시장 (용성약국앞) 입구,201911,919,904,1823,37.554829,127.137321
강동구,1051, 양지시장 (용성약국앞) 입구,201912,567,526,1093,37.554829,127.137321
강동구,1051, 양지시장 (용성약국앞) 입구,202001,566,527,1093,37.554829,127.137321
강동구,1051, 양지시장 (용성약국앞) 입구,202002,468,471,939,37.554829,127.137321
강동구,1051, 양지시장 (용성약국앞) 입구,202003,1028,1024,2052,37.554829,127.137321
강동구,1051, 양지시장 (용성약국앞) 입구,202004,1423,1415,2838,37.554829,127.137321
강동구,1051, 양지시장 (용성약국앞) 입구,202005,1686,1741,3427,37.554829,127.137321
강동구,1051, 양지시장 (용성약국앞) 입구,202006,1810,1852,3662,37.554829,127.137321
강동구,1052, 리싸이클시티,201901,59,21,80,37.556469,127.156822
강동구,1052, 리싸이클시티,201902,60,28,88,37.556469,127.156822
강동구,1052, 리싸이클시티,201903,143,80,223,37.556469,127.156822
강동구,1052, 리싸이클시티,201904,188,132,320,37.556469,127.156822
강동구,1052, 리싸이클시티,201905,267,235,502,37.556469,127.156822
강동구,1052, 리싸이클시티,201906,312,259,571,37.556469,127.156822
강동구,1052, 리싸이클시티,201907,304,284,588,37.556469,127.156822
강동구,1052, 리싸이클시티,201908,261,215,476,37.556469,127.156822
강동구,1052, 리싸이클시티,201909,336,276,612,37.556469,127.156822
강동구,1052, 리싸이클시티,201910,397,365,762,37.556469,127.156822
강동구,1052, 리싸이클시티,201911,290,233,523,37.556469,127.156822
강동구,1052, 리싸이클시티,201912,140,121,261,37.556469,127.156822
강동구,1052, 리싸이클시티,202001,137,116,253,37.556469,127.156822
강동구,1052, 리싸이클시티,202002,98,84,182,37.556469,127.156822
강동구,1052, 리싸이클시티,202003,123,82,205,37.556469,127.156822
강동구,1052, 리싸이클시티,202004,475,343,818,37.556469,127.156822
강동구,1052, 리싸이클시티,202005,902,717,1619,37.556469,127.156822
강동구,1052, 리싸이클시티,202006,479,303,782,37.556469,127.156822
강동구,1053, 동명근린공원 진입로 (아리수로),201901,91,131,222,37.562538,127.164528
강동구,1053, 동명근린공원 진입로 (아리수로),201902,66,90,156,37.562538,127.164528
강동구,1053, 동명근린공원 진입로 (아리수로),201903,92,137,229,37.562538,127.164528
강동구,1053, 동명근린공원 진입로 (아리수로),201904,139,168,307,37.562538,127.164528
강동구,1053, 동명근린공원 진입로 (아리수로),201905,275,354,629,37.562538,127.164528
강동구,1053, 동명근린공원 진입로 (아리수로),201906,269,343,612,37.562538,127.164528
강동구,1053, 동명근린공원 진입로 (아리수로),201907,255,318,573,37.562538,127.164528
강동구,1053, 동명근린공원 진입로 (아리수로),201908,281,347,628,37.562538,127.164528
강동구,1053, 동명근린공원 진입로 (아리수로),201909,274,350,624,37.562538,127.164528
강동구,1053, 동명근린공원 진입로 (아리수로),201910,361,448,809,37.562538,127.164528
강동구,1053, 동명근린공원 진입로 (아리수로),201911,265,291,556,37.562538,127.164528
강동구,1053, 동명근린공원 진입로 (아리수로),201912,187,209,396,37.562538,127.164528
강동구,1053, 동명근린공원 진입로 (아리수로),202001,158,195,353,37.562538,127.164528
강동구,1053, 동명근린공원 진입로 (아리수로),202002,168,173,341,37.562538,127.164528
강동구,1053, 동명근린공원 진입로 (아리수로),202003,272,280,552,37.562538,127.164528
강동구,1053, 동명근린공원 진입로 (아리수로),202004,514,545,1059,37.562538,127.164528
강동구,1053, 동명근린공원 진입로 (아리수로),202005,479,537,1016,37.562538,127.164528
강동구,1053, 동명근린공원 진입로 (아리수로),202006,386,433,819,37.562538,127.164528
강동구,1054, 말우물 어린이 공원,201901,25,27,52,37.560009,127.169579
강동구,1054, 말우물 어린이 공원,201902,40,43,83,37.560009,127.169579
강동구,1054, 말우물 어린이 공원,201903,63,73,136,37.560009,127.169579
강동구,1054, 말우물 어린이 공원,201904,94,122,216,37.560009,127.169579
강동구,1054, 말우물 어린이 공원,201905,167,179,346,37.560009,127.169579
강동구,1054, 말우물 어린이 공원,201906,133,186,319,37.560009,127.169579
강동구,1054, 말우물 어린이 공원,201907,159,219,378,37.560009,127.169579
강동구,1054, 말우물 어린이 공원,201908,150,155,305,37.560009,127.169579
강동구,1054, 말우물 어린이 공원,201909,149,179,328,37.560009,127.169579
강동구,1054, 말우물 어린이 공원,201910,196,250,446,37.560009,127.169579
강동구,1054, 말우물 어린이 공원,201911,95,143,238,37.560009,127.169579
강동구,1054, 말우물 어린이 공원,201912,90,100,190,37.560009,127.169579
강동구,1054, 말우물 어린이 공원,202001,77,101,178,37.560009,127.169579
강동구,1054, 말우물 어린이 공원,202002,104,126,230,37.560009,127.169579
강동구,1054, 말우물 어린이 공원,202003,258,255,513,37.560009,127.169579
강동구,1054, 말우물 어린이 공원,202004,362,374,736,37.560009,127.169579
강동구,1054, 말우물 어린이 공원,202005,585,581,1166,37.560009,127.169579
강동구,1054, 말우물 어린이 공원,202006,372,376,748,37.560009,127.169579
강동구,1056, 강일리엔파크 7~11단지,201901,57,54,111,37.563332,127.179092
강동구,1056, 강일리엔파크 7~11단지,201902,62,63,125,37.563332,127.179092
강동구,1056, 강일리엔파크 7~11단지,201903,118,122,240,37.563332,127.179092
강동구,1056, 강일리엔파크 7~11단지,201904,201,204,405,37.563332,127.179092
강동구,1056, 강일리엔파크 7~11단지,201905,366,399,765,37.563332,127.179092
강동구,1056, 강일리버파크 7~11단지,201906,410,449,859,37.563332,127.179092
강동구,1056, 강일리버파크 7~11단지,201907,360,423,783,37.563332,127.179092
강동구,1056, 강일리버파크 7~11단지,201908,322,366,688,37.563332,127.179092
강동구,1056, 강일리버파크 7~11단지,201909,360,383,743,37.563332,127.179092
강동구,1056, 강일리버파크 7~11단지,201910,405,422,827,37.563332,127.179092
강동구,1056, 강일리버파크 7~11단지,201911,212,212,424,37.563332,127.179092
강동구,1056, 강일리버파크 7~11단지,201912,115,116,231,37.563332,127.179092
강동구,1056, 강일리버파크 7~11단지,202001,106,103,209,37.563332,127.179092
강동구,1056, 강일리버파크 7~11단지,202002,135,124,259,37.563332,127.179092
강동구,1056, 강일리버파크 7~11단지,202003,284,302,586,37.563332,127.179092
강동구,1056, 강일리버파크 7~11단지,202004,427,411,838,37.563332,127.179092
강동구,1056, 강일리버파크 7~11단지,202005,516,526,1042,37.563332,127.179092
강동구,1056, 강일리버파크 7~11단지,202006,500,544,1044,37.563332,127.179092
강동구,1057, 능골근린공원,201901,106,84,190,37.55579,127.173813
강동구,1057, 능골근린공원,201902,100,92,192,37.55579,127.173813
강동구,1057, 능골근린공원,201903,189,143,332,37.55579,127.173813
강동구,1057, 능골근린공원,201904,277,223,500,37.55579,127.173813
강동구,1057, 능골근린공원,201905,408,393,801,37.55579,127.173813
강동구,1057, 능골근린공원,201906,460,419,879,37.55579,127.173813
강동구,1057, 능골근린공원,201907,504,437,941,37.55579,127.173813
강동구,1057, 능골근린공원,201908,438,405,843,37.55579,127.173813
강동구,1057, 능골근린공원,201909,410,384,794,37.55579,127.173813
강동구,1057, 능골근린공원,201910,497,455,952,37.55579,127.173813
강동구,1057, 능골근린공원,201911,338,299,637,37.55579,127.173813
강동구,1057, 능골근린공원,201912,205,202,407,37.55579,127.173813
강동구,1057, 능골근린공원,202001,169,164,333,37.55579,127.173813
강동구,1057, 능골근린공원,202002,206,199,405,37.55579,127.173813
강동구,1057, 능골근린공원,202003,420,405,825,37.55579,127.173813
강동구,1057, 능골근린공원,202004,677,670,1347,37.55579,127.173813
강동구,1057, 능골근린공원,202005,917,890,1807,37.55579,127.173813
강동구,1057, 능골근린공원,202006,870,751,1621,37.55579,127.173813
강동구,1058, 고덕숲 아이파크 1,201901,70,73,143,37.553471,127.165001
강동구,1058, 고덕숲 아이파크 1,201902,62,59,121,37.553471,127.165001
강동구,1058, 고덕숲 아이파크 1,201903,96,113,209,37.553471,127.165001
강동구,1058, 고덕숲 아이파크 1,201904,120,138,258,37.553471,127.165001
강동구,1058, 고덕숲 아이파크 1,201905,185,174,359,37.553471,127.165001
강동구,1058, 고덕숲 아이파크 1,201906,217,190,407,37.553471,127.165001
강동구,1058, 고덕숲 아이파크 1,201907,222,205,427,37.553471,127.165001
강동구,1058, 고덕숲 아이파크 1,201908,253,257,510,37.553471,127.165001
강동구,1058, 고덕숲 아이파크 1,201909,262,264,526,37.553471,127.165001
강동구,1058, 고덕숲 아이파크 1,201910,276,265,541,37.553471,127.165001
강동구,1058, 고덕숲 아이파크 1,201911,181,181,362,37.553471,127.165001
강동구,1058, 고덕숲 아이파크 1,201912,17,24,41,37.553471,127.165001
강동구,1058, 고덕숲 아이파크 1,202003,680,677,1357,37.553471,127.165001
강동구,1058, 고덕숲 아이파크 1,202004,1412,1403,2815,37.553471,127.165001
강동구,1058, 고덕숲 아이파크 1,202005,1773,1786,3559,37.553471,127.165001
강동구,1058, 고덕숲 아이파크 1,202006,1322,1285,2607,37.553471,127.165001
강동구,1059, 레미안 강동팰리스(102동),201901,230,200,430,37.538181,127.131752
강동구,1059, 레미안 강동팰리스(102동),201902,233,197,430,37.538181,127.131752
강동구,1059, 레미안 강동팰리스(102동),201903,558,507,1065,37.538181,127.131752
강동구,1059, 레미안 강동팰리스(102동),201904,967,783,1750,37.538181,127.131752
강동구,1059, 레미안 강동팰리스(102동),201905,1700,1524,3224,37.538181,127.131752
강동구,1059, 래미안 강동팰리스(102동),201906,1833,1628,3461,37.538181,127.131752
강동구,1059, 래미안 강동팰리스(102동),201907,1816,1600,3416,37.538181,127.131752
강동구,1059, 래미안 강동팰리스(102동),201908,1933,1681,3614,37.538181,127.131752
강동구,1059, 래미안 강동팰리스(102동),201909,1740,1532,3272,37.538181,127.131752
강동구,1059, 래미안 강동팰리스(102동),201910,1902,1670,3572,37.538181,127.131752
강동구,1059, 래미안 강동팰리스(102동),201911,1180,965,2145,37.538181,127.131752
강동구,1059, 래미안 강동팰리스(102동),201912,610,528,1138,37.538181,127.131752
강동구,1059, 래미안 강동팰리스(102동),202001,599,459,1058,37.538181,127.131752
강동구,1059, 래미안 강동팰리스(102동),202002,671,588,1259,37.538181,127.131752
강동구,1059, 래미안 강동팰리스(102동),202003,1240,1098,2338,37.538181,127.131752
강동구,1059, 래미안 강동팰리스(102동),202004,1489,1432,2921,37.538181,127.131752
강동구,1059, 래미안 강동팰리스(102동),202005,1968,1862,3830,37.538181,127.131752
강동구,1059, 래미안 강동팰리스(102동),202006,1624,1542,3166,37.538181,127.131752
강동구,1060, 천일초교 사거리,201901,94,91,185,37.544659,127.132637
강동구,1060, 천일초교 사거리,201902,111,112,223,37.544659,127.132637
강동구,1060, 천일초교 사거리,201903,187,185,372,37.544659,127.132637
강동구,1060, 천일초교 사거리,201904,446,416,862,37.544659,127.132637
강동구,1060, 천일초교 사거리,201905,849,785,1634,37.544659,127.132637
강동구,1060, 천일초교 사거리,201906,841,830,1671,37.544659,127.132637
강동구,1060, 천일초교 사거리,201907,894,897,1791,37.544659,127.132637
강동구,1060, 천일초교 사거리,201908,945,922,1867,37.544659,127.132637
강동구,1060, 천일초교 사거리,201909,834,829,1663,37.544659,127.132637
강동구,1060, 천일초교 사거리,201910,1033,1015,2048,37.544659,127.132637
강동구,1060, 천일초교 사거리,201911,719,730,1449,37.544659,127.132637
강동구,1060, 천일초교 사거리,201912,353,355,708,37.544659,127.132637
강동구,1060, 천일초교 사거리,202001,351,357,708,37.544659,127.132637
강동구,1060, 천일초교 사거리,202002,330,314,644,37.544659,127.132637
강동구,1060, 천일초교 사거리,202003,630,612,1242,37.544659,127.132637
강동구,1060, 천일초교 사거리,202004,920,920,1840,37.544659,127.132637
강동구,1060, 천일초교 사거리,202005,1005,1000,2005,37.544659,127.132637
강동구,1060, 천일초교 사거리,202006,1065,1063,2128,37.544659,127.132637
강동구,1061, 천호초교 입구 사거리(일주빌딩),201901,210,204,414,37.546928,127.134621
강동구,1061, 천호초교 입구 사거리(일주빌딩),201902,235,213,448,37.546928,127.134621
강동구,1061, 천호초교 입구 사거리(일주빌딩),201903,392,388,780,37.546928,127.134621
강동구,1061, 천호초교 입구 사거리(일주빌딩),201904,589,578,1167,37.546928,127.134621
강동구,1061, 천호초교 입구 사거리(일주빌딩),201905,946,942,1888,37.546928,127.134621
강동구,1061, 천호초교 입구 사거리(일주빌딩),201906,1129,1094,2223,37.546928,127.134621
강동구,1061, 천호초교 입구 사거리(일주빌딩),201907,1103,1096,2199,37.546928,127.134621
강동구,1061, 천호초교 입구 사거리(일주빌딩),201908,1176,1158,2334,37.546928,127.134621
강동구,1061, 천호초교 입구 사거리(일주빌딩),201909,1035,1014,2049,37.546928,127.134621
강동구,1061, 천호초교 입구 사거리(일주빌딩),201910,1294,1283,2577,37.546928,127.134621
강동구,1061, 천호초교 입구 사거리(일주빌딩),201911,768,782,1550,37.546928,127.134621
강동구,1061, 천호초교 입구 사거리(일주빌딩),201912,432,429,861,37.546928,127.134621
강동구,1061, 천호초교 입구 사거리(일주빌딩),202001,419,404,823,37.546928,127.134621
강동구,1061, 천호초교 입구 사거리(일주빌딩),202002,356,344,700,37.546928,127.134621
강동구,1061, 천호초교 입구 사거리(일주빌딩),202003,672,641,1313,37.546928,127.134621
강동구,1061, 천호초교 입구 사거리(일주빌딩),202004,1062,1026,2088,37.546928,127.134621
강동구,1061, 천호초교 입구 사거리(일주빌딩),202005,1290,1315,2605,37.546928,127.134621
강동구,1061, 천호초교 입구 사거리(일주빌딩),202006,1304,1308,2612,37.546928,127.134621
강동구,1062, 고덕숲 아이파크 2,201901,101,88,189,37.551079,127.162621
강동구,1062, 고덕숲 아이파크 2,201902,98,80,178,37.551079,127.162621
강동구,1062, 고덕숲 아이파크 2,201903,144,109,253,37.551079,127.162621
강동구,1062, 고덕숲 아이파크 2,201904,189,145,334,37.551079,127.162621
강동구,1062, 고덕숲 아이파크 2,201905,220,185,405,37.551079,127.162621
강동구,1062, 고덕숲 아이파크 2,201906,238,222,460,37.551079,127.162621
강동구,1062, 고덕숲 아이파크 2,201907,281,191,472,37.551079,127.162621
강동구,1062, 고덕숲 아이파크 2,201908,299,236,535,37.551079,127.162621
강동구,1062, 고덕숲 아이파크 2,201909,293,251,544,37.551079,127.162621
강동구,1062, 고덕숲 아이파크 2,201910,352,287,639,37.551079,127.162621
강동구,1062, 고덕숲 아이파크 2,201911,248,221,469,37.551079,127.162621
강동구,1062, 고덕숲 아이파크 2,201912,165,162,327,37.551079,127.162621
강동구,1062, 고덕숲 아이파크 2,202001,171,179,350,37.551079,127.162621
강동구,1062, 고덕숲 아이파크 2,202002,149,123,272,37.551079,127.162621
강동구,1062, 고덕숲 아이파크 2,202003,243,228,471,37.551079,127.162621
강동구,1062, 고덕숲 아이파크 2,202004,334,323,657,37.551079,127.162621
강동구,1062, 고덕숲 아이파크 2,202005,457,395,852,37.551079,127.162621
강동구,1062, 고덕숲 아이파크 2,202006,522,427,949,37.551079,127.162621
강동구,1063,강동롯데캐슬퍼스트 아파트(관리동),202003,2,2,4,37.556664,127.142738
강동구,1063,강동롯데캐슬퍼스트 아파트(관리동),202005,60,58,118,37.556664,127.142738
강동구,1063,강동롯데캐슬퍼스트 아파트(관리동),202006,519,521,1040,37.556664,127.142738
강동구,1064,중앙보훈병원역 1번출구,202003,1,1,2,37.527794,127.147644
강동구,1064,중앙보훈병원역 1번출구,202005,38,36,74,37.527794,127.147644
강동구,1064,중앙보훈병원역 1번출구,202006,310,306,616,37.527794,127.147644
강동구,1065,보훈병원 정문옆(중앙대영약국),202003,1,1,2,37.531208,127.149269
강동구,1065,보훈병원 정문옆(중앙대영약국),202005,27,26,53,37.531208,127.149269
강동구,1065,보훈병원 정문옆(중앙대영약국),202006,260,263,523,37.531208,127.149269
강동구,1066,생태공원앞 교차로(조명탑),202003,1,1,2,37.537766,127.152016
강동구,1066,생태공원앞 교차로(조명탑),202005,11,9,20,37.537766,127.152016
강동구,1066,생태공원앞 교차로(조명탑),202006,98,83,181,37.537766,127.152016
강동구,1067,한영중고앞사거리,202003,1,1,2,37.549053,127.156403
강동구,1067,한영중고앞사거리,202005,59,42,101,37.549053,127.156403
강동구,1067,한영중고앞사거리,202006,283,276,559,37.549053,127.156403
강동구,1068,명일파출소,202003,1,1,2,37.55365,127.156227
강동구,1068,명일파출소,202004,25,24,49,37.55365,127.156227
강동구,1068,명일파출소,202005,110,101,211,37.55365,127.156227
강동구,1068,명일파출소,202006,913,899,1812,37.55365,127.156227
강동구,1069,강동경희대학교병원 입구,202003,1,1,2,37.553055,127.156883
강동구,1069,강동경희대학교병원 입구,202005,30,28,58,37.553055,127.156883
강동구,1069,강동경희대학교병원 입구,202006,348,348,696,37.553055,127.156883
강동구,1070,(시립)고덕평생학습관,202003,1,1,2,37.555702,127.157921
강동구,1070,(시립)고덕평생학습관,202004,1,1,2,37.555702,127.157921
강동구,1070,(시립)고덕평생학습관,202005,3,3,6,37.555702,127.157921
강동구,1071,명일근린공원공동체텃밭,202003,1,1,2,37.555687,127.159912
강동구,1071,명일근린공원공동체텃밭,202006,227,221,448,37.555687,127.159912
강동구,1073,SSTS 몰 앞,202003,1,1,2,37.541145,127.141052
강동구,1073,SSTS 몰 앞,202004,3,3,6,37.541145,127.141052
강동구,1073,SSTS 몰 앞,202005,96,97,193,37.541145,127.141052
강동구,1073,SSTS 몰 앞,202006,812,810,1622,37.541145,127.141052
강동구,1074,대명초교입구 사거리,202003,1,1,2,37.546837,127.149162
강동구,1074,대명초교입구 사거리,202005,60,59,119,37.546837,127.149162
강동구,1074,대명초교입구 사거리,202006,785,796,1581,37.546837,127.149162
강동구,1075,천동초교 삼거리,202003,1,1,2,37.541363,127.137184
강동구,1075,천동초교 삼거리,202004,7,6,13,37.541363,127.137184
강동구,1075,천동초교 삼거리,202005,79,76,155,37.541363,127.137184
강동구,1075,천동초교 삼거리,202006,797,807,1604,37.541363,127.137184
강동구,1076,전자랜드 길동점,202003,1,1,2,37.539894,127.141037
강동구,1076,전자랜드 길동점,202005,123,120,243,37.539894,127.141037
강동구,1076,전자랜드 길동점,202006,1371,1399,2770,37.539894,127.141037
강동구,1077,강동역 1번출구 앞,202003,1,1,2,37.536205,127.132561
강동구,1077,강동역 1번출구 앞,202005,100,101,201,37.536205,127.132561
강동구,1077,강동역 1번출구 앞,202006,1216,1216,2432,37.536205,127.132561
강동구,1078,둔촌사거리,202003,1,1,2,37.521976,127.133621
강동구,1078,둔촌사거리,202004,2,2,4,37.521976,127.133621
강동구,1078,둔촌사거리,202005,184,170,354,37.521976,127.133621
강동구,1078,둔촌사거리,202006,1557,1572,3129,37.521976,127.133621
강동구,1079,강일동입구교차로,202003,1,1,2,37.561844,127.170845
강동구,1079,강일동입구교차로,202005,36,32,68,37.561844,127.170845
강동구,1079,강일동입구교차로,202006,364,306,670,37.561844,127.170845
강동구,1080,엘웨딩,202003,1,1,2,37.536831,127.128418
강동구,1080,엘웨딩,202005,35,34,69,37.536831,127.128418
강동구,1080,엘웨딩,202006,582,582,1164,37.536831,127.128418
강동구,1081,트레빌빌딩,202003,1,1,2,37.536999,127.129532
강동구,1081,트레빌빌딩,202004,1,0,1,37.536999,127.129532
강동구,1081,트레빌빌딩,202005,61,61,122,37.536999,127.129532
강동구,1081,트레빌빌딩,202006,512,504,1016,37.536999,127.129532
강동구,1082,중앙보훈병원역3번출구,202006,1,1,2,37.52956,127.14901
강동구,1083,광문고교사거리(아이파크),202003,1,1,2,37.560368,127.156593
강동구,1083,광문고교사거리(아이파크),202004,1,1,2,37.560368,127.156593
강동구,1083,광문고교사거리(아이파크),202005,24,23,47,37.560368,127.156593
강동구,1083,광문고교사거리(아이파크),202006,458,407,865,37.560368,127.156593
강동구,1084, 윤선생빌딩(JYP사옥),202006,1379,1467,2846,37.52393,127.129128
강동구,1085,래미안 솔베뉴(고덕로),202006,267,260,527,37.554569,127.145874
강동구,1086,래미안 솔베뉴(구천면로),202003,1,1,2,37.550598,127.145454
강동구,1086,래미안 솔베뉴(구천면로),202006,349,346,695,37.550598,127.145454
강동구,1087,레미안 솔베뉴(양재대로),202003,1,1,2,#N/A,#N/A
강동구,1087,레미안 솔베뉴(양재대로),202004,2,2,4,#N/A,#N/A
강동구,1087,레미안 솔베뉴(양재대로),202005,70,72,142,#N/A,#N/A
강동구,1087,레미안 솔베뉴(양재대로),202006,112,109,221,#N/A,#N/A
강동구,1088,풍납사거리(강동),202003,1,1,2,37.528122,127.119522
강동구,1088,풍납사거리(강동),202005,72,69,141,37.528122,127.119522
강동구,1088,풍납사거리(강동),202006,882,866,1748,37.528122,127.119522
강동구,1089,고덕 래미안힐스테이트(201동),202003,1,1,2,37.5606,127.146698
강동구,1089,고덕 래미안힐스테이트(201동),202005,28,27,55,37.5606,127.146698
강동구,1089,고덕 래미안힐스테이트(201동),202006,251,210,461,37.5606,127.146698
강동구,1090,상일동역 2번출구 앞,202003,1,1,2,37.556789,127.166145
강동구,1090,상일동역 2번출구 앞,202005,183,189,372,37.556789,127.166145
강동구,1090,상일동역 2번출구 앞,202006,1795,1802,3597,37.556789,127.166145
강서구,1101, 개화동상사마을종점 버스정류장,201901,46,48,94,37.581612,126.798599
강서구,1101, 개화동상사마을종점 버스정류장,201902,29,27,56,37.581612,126.798599
강서구,1101, 개화동상사마을종점 버스정류장,201903,37,64,101,37.581612,126.798599
강서구,1101, 개화동상사마을종점 버스정류장,201904,87,116,203,37.581612,126.798599
강서구,1101, 개화동상사마을종점 버스정류장,201905,143,168,311,37.581612,126.798599
강서구,1101, 개화동상사마을종점 버스정류장,201906,139,246,385,37.581612,126.798599
강서구,1101, 개화동상사마을종점 버스정류장,201907,126,222,348,37.581612,126.798599
강서구,1101, 개화동상사마을종점 버스정류장,201908,166,244,410,37.581612,126.798599
강서구,1101, 개화동상사마을종점 버스정류장,201909,184,241,425,37.581612,126.798599
강서구,1101, 개화동상사마을종점 버스정류장,201910,241,283,524,37.581612,126.798599
강서구,1101, 개화동상사마을종점 버스정류장,201911,176,195,371,37.581612,126.798599
강서구,1101, 개화동상사마을종점 버스정류장,201912,88,108,196,37.581612,126.798599
강서구,1101, 개화동상사마을종점 버스정류장,202001,108,131,239,37.581612,126.798599
강서구,1101, 개화동상사마을종점 버스정류장,202002,106,125,231,37.581612,126.798599
강서구,1101, 개화동상사마을종점 버스정류장,202003,176,170,346,37.581612,126.798599
강서구,1101, 개화동상사마을종점 버스정류장,202004,202,234,436,37.581612,126.798599
강서구,1101, 개화동상사마을종점 버스정류장,202005,256,305,561,37.581612,126.798599
강서구,1101, 개화동상사마을종점 버스정류장,202006,270,316,586,37.581612,126.798599
강서구,1102, 방화사거리 마을버스 버스정류장,201901,266,247,513,37.573643,126.811806
강서구,1102, 방화사거리 마을버스 버스정류장,201902,290,283,573,37.573643,126.811806
강서구,1102, 방화사거리 마을버스 버스정류장,201903,452,422,874,37.573643,126.811806
강서구,1102, 방화사거리 마을버스 버스정류장,201904,695,654,1349,37.573643,126.811806
강서구,1102, 방화사거리 마을버스 버스정류장,201905,1154,1163,2317,37.573643,126.811806
강서구,1102, 방화사거리 마을버스 버스정류장,201906,1388,1395,2783,37.573643,126.811806
강서구,1102, 방화사거리 마을버스 버스정류장,201907,1361,1402,2763,37.573643,126.811806
강서구,1102, 방화사거리 마을버스 버스정류장,201908,1291,1378,2669,37.573643,126.811806
강서구,1102, 방화사거리 마을버스 버스정류장,201909,1223,1309,2532,37.573643,126.811806
강서구,1102, 방화사거리 마을버스 버스정류장,201910,1630,1682,3312,37.573643,126.811806
강서구,1102, 방화사거리 마을버스 버스정류장,201911,965,950,1915,37.573643,126.811806
강서구,1102, 방화사거리 마을버스 버스정류장,201912,521,495,1016,37.573643,126.811806
강서구,1102, 방화사거리 마을버스 버스정류장,202001,525,486,1011,37.573643,126.811806
강서구,1102, 방화사거리 마을버스 버스정류장,202002,509,455,964,37.573643,126.811806
강서구,1102, 방화사거리 마을버스 버스정류장,202003,1009,984,1993,37.573643,126.811806
강서구,1102, 방화사거리 마을버스 버스정류장,202004,1481,1446,2927,37.573643,126.811806
강서구,1102, 방화사거리 마을버스 버스정류장,202005,2005,2117,4122,37.573643,126.811806
강서구,1102, 방화사거리 마을버스 버스정류장,202006,2204,2338,4542,37.573643,126.811806
강서구,1103, 방화역 4번출구앞,201901,206,216,422,37.577221,126.812195
강서구,1103, 방화역 4번출구앞,201902,217,257,474,37.577221,126.812195
강서구,1103, 방화역 4번출구앞,201903,418,426,844,37.577221,126.812195
강서구,1103, 방화역 4번출구앞,201904,705,768,1473,37.577221,126.812195
강서구,1103, 방화역 4번출구앞,201905,1237,1293,2530,37.577221,126.812195
강서구,1103, 방화역 4번출구앞,201906,1446,1506,2952,37.577221,126.812195
강서구,1103, 방화역 4번출구앞,201907,1428,1514,2942,37.577221,126.812195
강서구,1103, 방화역 4번출구앞,201908,1423,1523,2946,37.577221,126.812195
강서구,1103, 방화역 4번출구앞,201909,1482,1570,3052,37.577221,126.812195
강서구,1103, 방화역 4번출구앞,201910,1772,1854,3626,37.577221,126.812195
강서구,1103, 방화역 4번출구앞,201911,914,910,1824,37.577221,126.812195
강서구,1103, 방화역 4번출구앞,201912,542,498,1040,37.577221,126.812195
강서구,1103, 방화역 4번출구앞,202001,525,494,1019,37.577221,126.812195
강서구,1103, 방화역 4번출구앞,202002,556,513,1069,37.577221,126.812195
강서구,1103, 방화역 4번출구앞,202003,1132,1120,2252,37.577221,126.812195
강서구,1103, 방화역 4번출구앞,202004,1689,1752,3441,37.577221,126.812195
강서구,1103, 방화역 4번출구앞,202005,2267,2398,4665,37.577221,126.812195
강서구,1103, 방화역 4번출구앞,202006,2419,2555,4974,37.577221,126.812195
강서구,1105, 방화근린공원,201901,34,34,68,37.581623,126.812653
강서구,1105, 방화근린공원,201902,39,33,72,37.581623,126.812653
강서구,1105, 방화근린공원,201903,74,62,136,37.581623,126.812653
강서구,1105, 방화근린공원,201904,277,260,537,37.581623,126.812653
강서구,1105, 방화근린공원,201905,313,304,617,37.581623,126.812653
강서구,1105, 방화근린공원,201906,320,304,624,37.581623,126.812653
강서구,1105, 방화근린공원,201907,249,245,494,37.581623,126.812653
강서구,1105, 방화근린공원,201908,288,297,585,37.581623,126.812653
강서구,1105, 방화근린공원,201909,288,294,582,37.581623,126.812653
강서구,1105, 방화근린공원,201910,404,414,818,37.581623,126.812653
강서구,1105, 방화근린공원,201911,160,141,301,37.581623,126.812653
강서구,1105, 방화근린공원,201912,65,54,119,37.581623,126.812653
강서구,1105, 방화근린공원,202001,67,41,108,37.581623,126.812653
강서구,1105, 방화근린공원,202002,108,81,189,37.581623,126.812653
강서구,1105, 방화근린공원,202003,415,325,740,37.581623,126.812653
강서구,1105, 방화근린공원,202004,619,544,1163,37.581623,126.812653
강서구,1105, 방화근린공원,202005,665,616,1281,37.581623,126.812653
강서구,1105, 방화근린공원,202006,526,511,1037,37.581623,126.812653
강서구,1106, 신방화사거리,201901,242,269,511,37.573032,126.816452
강서구,1106, 신방화사거리,201902,305,304,609,37.573032,126.816452
강서구,1106, 신방화사거리,201903,478,456,934,37.573032,126.816452
강서구,1106, 신방화사거리,201904,762,803,1565,37.573032,126.816452
강서구,1106, 신방화사거리,201905,1451,1554,3005,37.573032,126.816452
강서구,1106, 신방화사거리,201906,1732,1826,3558,37.573032,126.816452
강서구,1106, 신방화사거리,201907,1706,1846,3552,37.573032,126.816452
강서구,1106, 신방화사거리,201908,1798,2003,3801,37.573032,126.816452
강서구,1106, 신방화사거리,201909,1750,1911,3661,37.573032,126.816452
강서구,1106, 신방화사거리,201910,2007,2161,4168,37.573032,126.816452
강서구,1106, 신방화사거리,201911,1127,1169,2296,37.573032,126.816452
강서구,1106, 신방화사거리,201912,594,648,1242,37.573032,126.816452
강서구,1106, 신방화사거리,202001,543,547,1090,37.573032,126.816452
강서구,1106, 신방화사거리,202002,593,621,1214,37.573032,126.816452
강서구,1106, 신방화사거리,202003,1254,1269,2523,37.573032,126.816452
강서구,1106, 신방화사거리,202004,1808,1906,3714,37.573032,126.816452
강서구,1106, 신방화사거리,202005,2493,2663,5156,37.573032,126.816452
강서구,1106, 신방화사거리,202006,2683,2894,5577,37.573032,126.816452
강서구,1108, 공항시장역 1번출구,201901,123,133,256,37.56356,126.81015
강서구,1108, 공항시장역 1번출구,201902,118,106,224,37.56356,126.81015
강서구,1108, 공항시장역 1번출구,201903,227,233,460,37.56356,126.81015
강서구,1108, 공항시장역 1번출구,201904,334,339,673,37.56356,126.81015
강서구,1108, 공항시장역 1번출구,201905,624,671,1295,37.56356,126.81015
강서구,1108, 공항시장역 2번출구 뒤,201906,918,953,1871,37.56356,126.81015
강서구,1108, 공항시장역 2번출구 뒤,201907,925,971,1896,37.56356,126.81015
강서구,1108, 공항시장역 2번출구 뒤,201908,831,847,1678,37.56356,126.81015
강서구,1108, 공항시장역 2번출구 뒤,201909,824,826,1650,37.56356,126.81015
강서구,1108, 공항시장역 2번출구 뒤,201910,1049,1051,2100,37.56356,126.81015
강서구,1108, 공항시장역 2번출구 뒤,201911,567,577,1144,37.56356,126.81015
강서구,1108, 공항시장역 2번출구 뒤,201912,323,337,660,37.56356,126.81015
강서구,1108, 공항시장역 2번출구 뒤,202001,272,283,555,37.56356,126.81015
강서구,1108, 공항시장역 2번출구 뒤,202002,254,259,513,37.56356,126.81015
강서구,1108, 공항시장역 2번출구 뒤,202003,558,544,1102,37.56356,126.81015
강서구,1108, 공항시장역 2번출구 뒤,202004,877,891,1768,37.56356,126.81015
강서구,1108, 공항시장역 2번출구 뒤,202005,1310,1334,2644,37.56356,126.81015
강서구,1108, 공항시장역 2번출구 뒤,202006,1431,1421,2852,37.56356,126.81015
강서구,1109, 공항시장역 4번출구,201901,110,104,214,37.563347,126.810486
강서구,1109, 공항시장역 4번출구,201902,84,82,166,37.563347,126.810486
강서구,1109, 공항시장역 4번출구,201903,184,169,353,37.563347,126.810486
강서구,1109, 공항시장역 4번출구,201904,305,296,601,37.563347,126.810486
강서구,1109, 공항시장역 4번출구,201905,593,604,1197,37.563347,126.810486
강서구,1109, 공항시장역 4번출구,201906,678,687,1365,37.563347,126.810486
강서구,1109, 공항시장역 4번출구,201907,656,655,1311,37.563347,126.810486
강서구,1109, 공항시장역 4번출구,201908,534,538,1072,37.563347,126.810486
강서구,1109, 공항시장역 4번출구,201909,554,571,1125,37.563347,126.810486
강서구,1109, 공항시장역 4번출구,201910,655,654,1309,37.563347,126.810486
강서구,1109, 공항시장역 4번출구,201911,373,413,786,37.563347,126.810486
강서구,1109, 공항시장역 4번출구,201912,189,202,391,37.563347,126.810486
강서구,1109, 공항시장역 4번출구,202001,206,229,435,37.563347,126.810486
강서구,1109, 공항시장역 4번출구,202002,247,246,493,37.563347,126.810486
강서구,1109, 공항시장역 4번출구,202003,439,442,881,37.563347,126.810486
강서구,1109, 공항시장역 4번출구,202004,622,618,1240,37.563347,126.810486
강서구,1109, 공항시장역 4번출구,202005,888,888,1776,37.563347,126.810486
강서구,1109, 공항시장역 4번출구,202006,1025,1024,2049,37.563347,126.810486
강서구,1110, 공항중학교앞,201901,122,121,243,37.562683,126.816238
강서구,1110, 공항중학교앞,201902,93,99,192,37.562683,126.816238
강서구,1110, 공항중학교앞,201903,236,198,434,37.562683,126.816238
강서구,1110, 공항중학교앞,201904,420,368,788,37.562683,126.816238
강서구,1110, 공항중학교앞,201905,637,607,1244,37.562683,126.816238
강서구,1110, 공항중학교앞,201906,708,684,1392,37.562683,126.816238
강서구,1110, 공항중학교앞,201907,783,758,1541,37.562683,126.816238
강서구,1110, 공항중학교앞,201908,747,780,1527,37.562683,126.816238
강서구,1110, 공항중학교앞,201909,728,728,1456,37.562683,126.816238
강서구,1110, 공항중학교앞,201910,925,926,1851,37.562683,126.816238
강서구,1110, 공항중학교앞,201911,632,614,1246,37.562683,126.816238
강서구,1110, 공항중학교앞,201912,331,313,644,37.562683,126.816238
강서구,1110, 공항중학교앞,202001,271,228,499,37.562683,126.816238
강서구,1110, 공항중학교앞,202002,311,281,592,37.562683,126.816238
강서구,1110, 공항중학교앞,202003,533,496,1029,37.562683,126.816238
강서구,1110, 공항중학교앞,202004,652,664,1316,37.562683,126.816238
강서구,1110, 공항중학교앞,202005,948,954,1902,37.562683,126.816238
강서구,1110, 공항중학교앞,202006,1273,1267,2540,37.562683,126.816238
강서구,1111, 마곡엠밸리6_7단지 마곡중학교,201901,174,195,369,37.566982,126.8218
강서구,1111, 마곡엠밸리6_7단지 마곡중학교,201902,154,174,328,37.566982,126.8218
강서구,1111, 마곡엠밸리6_7단지 마곡중학교,201903,291,311,602,37.566982,126.8218
강서구,1111, 마곡엠밸리6_7단지 마곡중학교,201904,525,485,1010,37.566982,126.8218
강서구,1111, 마곡엠밸리6_7단지 마곡중학교,201905,967,910,1877,37.566982,126.8218
강서구,1111, 마곡엠밸리6_7단지 마곡중학교,201906,1165,1103,2268,37.566982,126.8218
강서구,1111, 마곡엠밸리6_7단지 마곡중학교,201907,1305,1258,2563,37.566982,126.8218
강서구,1111, 마곡엠밸리6_7단지 마곡중학교,201908,1107,1091,2198,37.566982,126.8218
강서구,1111, 마곡엠밸리6_7단지 마곡중학교,201909,1148,1141,2289,37.566982,126.8218
강서구,1111, 마곡엠밸리6_7단지 마곡중학교,201910,1309,1292,2601,37.566982,126.8218
강서구,1111, 마곡엠밸리6_7단지 마곡중학교,201911,838,768,1606,37.566982,126.8218
강서구,1111, 마곡엠밸리6_7단지 마곡중학교,201912,501,520,1021,37.566982,126.8218
강서구,1111, 마곡엠밸리6_7단지 마곡중학교,202001,455,433,888,37.566982,126.8218
강서구,1111, 마곡엠밸리6_7단지 마곡중학교,202002,460,436,896,37.566982,126.8218
강서구,1111, 마곡엠밸리6_7단지 마곡중학교,202003,803,783,1586,37.566982,126.8218
강서구,1111, 마곡엠밸리6_7단지 마곡중학교,202004,1197,1081,2278,37.566982,126.8218
강서구,1111, 마곡엠밸리6_7단지 마곡중학교,202005,1484,1374,2858,37.566982,126.8218
강서구,1111, 마곡엠밸리6_7단지 마곡중학교,202006,1606,1579,3185,37.566982,126.8218
강서구,1112, 마곡엠밸리4단지 정문,201901,777,837,1614,37.568577,126.824776
강서구,1112, 마곡엠밸리4단지 정문,201902,680,713,1393,37.568577,126.824776
강서구,1112, 마곡엠밸리4단지 정문,201903,1211,1339,2550,37.568577,126.824776
강서구,1112, 마곡엠밸리4단지 정문,201904,2028,2116,4144,37.568577,126.824776
강서구,1112, 마곡엠밸리4단지 정문,201905,3426,3464,6890,37.568577,126.824776
강서구,1112, 마곡엠밸리4단지 정문,201906,4038,4100,8138,37.568577,126.824776
강서구,1112, 마곡엠밸리4단지 정문,201907,3816,3875,7691,37.568577,126.824776
강서구,1112, 마곡엠밸리4단지 정문,201908,3782,3822,7604,37.568577,126.824776
강서구,1112, 마곡엠밸리4단지 정문,201909,3711,3728,7439,37.568577,126.824776
강서구,1112, 마곡엠밸리4단지 정문,201910,4741,4769,9510,37.568577,126.824776
강서구,1112, 마곡엠밸리4단지 정문,201911,3002,3014,6016,37.568577,126.824776
강서구,1112, 마곡엠밸리4단지 정문,201912,1854,1816,3670,37.568577,126.824776
강서구,1112, 마곡엠밸리4단지 정문,202001,1724,1768,3492,37.568577,126.824776
강서구,1112, 마곡엠밸리4단지 정문,202002,1610,1667,3277,37.568577,126.824776
강서구,1112, 마곡엠밸리4단지 정문,202003,2674,2705,5379,37.568577,126.824776
강서구,1112, 마곡엠밸리4단지 정문,202004,3818,3822,7640,37.568577,126.824776
강서구,1112, 마곡엠밸리4단지 정문,202005,4889,4940,9829,37.568577,126.824776
강서구,1112, 마곡엠밸리4단지 정문,202006,5362,5409,10771,37.568577,126.824776
강서구,1113, 서남환경공원 버스정류장,201901,307,298,605,37.573093,126.822899
강서구,1113, 서남환경공원 버스정류장,201902,290,302,592,37.573093,126.822899
강서구,1113, 서남환경공원 버스정류장,201903,593,533,1126,37.573093,126.822899
강서구,1113, 서남환경공원 버스정류장,201904,806,768,1574,37.573093,126.822899
강서구,1113, 서남환경공원 버스정류장,201905,1177,1166,2343,37.573093,126.822899
강서구,1113, 서남환경공원 버스정류장,201906,1499,1537,3036,37.573093,126.822899
강서구,1113, 서남환경공원 버스정류장,201907,1465,1526,2991,37.573093,126.822899
강서구,1113, 서남환경공원 버스정류장,201908,1477,1493,2970,37.573093,126.822899
강서구,1113, 서남환경공원 버스정류장,201909,1437,1452,2889,37.573093,126.822899
강서구,1113, 서남환경공원 버스정류장,201910,1633,1624,3257,37.573093,126.822899
강서구,1113, 서남환경공원 버스정류장,201911,952,949,1901,37.573093,126.822899
강서구,1113, 서남환경공원 버스정류장,201912,703,690,1393,37.573093,126.822899
강서구,1113, 서남환경공원 버스정류장,202001,656,597,1253,37.573093,126.822899
강서구,1113, 서남환경공원 버스정류장,202002,673,644,1317,37.573093,126.822899
강서구,1113, 서남환경공원 버스정류장,202003,1221,1195,2416,37.573093,126.822899
강서구,1113, 서남환경공원 버스정류장,202004,1758,1722,3480,37.573093,126.822899
강서구,1113, 서남환경공원 버스정류장,202005,2148,2132,4280,37.573093,126.822899
강서구,1113, 서남환경공원 버스정류장,202006,2204,2185,4389,37.573093,126.822899
강서구,1114, 서남물재생센터 버스정류장,201901,49,55,104,37.572781,126.826279
강서구,1114, 서남물재생센터 버스정류장,201902,53,44,97,37.572781,126.826279
강서구,1114, 서남물재생센터 버스정류장,201903,82,80,162,37.572781,126.826279
강서구,1114, 서남물재생센터 버스정류장,201904,193,177,370,37.572781,126.826279
강서구,1114, 서남물재생센터 버스정류장,201905,201,164,365,37.572781,126.826279
강서구,1114, 서남물재생센터 버스정류장,201906,243,180,423,37.572781,126.826279
강서구,1114, 서남물재생센터 버스정류장,201907,334,275,609,37.572781,126.826279
강서구,1114, 서남물재생센터 버스정류장,201908,287,241,528,37.572781,126.826279
강서구,1114, 서남물재생센터 버스정류장,201909,216,206,422,37.572781,126.826279
강서구,1114, 서남물재생센터 버스정류장,201910,249,237,486,37.572781,126.826279
강서구,1114, 서남물재생센터 버스정류장,201911,165,154,319,37.572781,126.826279
강서구,1114, 서남물재생센터 버스정류장,201912,79,67,146,37.572781,126.826279
강서구,1114, 서남물재생센터 버스정류장,202001,82,66,148,37.572781,126.826279
강서구,1114, 서남물재생센터 버스정류장,202002,56,71,127,37.572781,126.826279
강서구,1114, 서남물재생센터 버스정류장,202003,132,123,255,37.572781,126.826279
강서구,1114, 서남물재생센터 버스정류장,202004,16,16,32,37.572781,126.826279
강서구,1115, 등촌역 1번출구옆,201901,41,41,82,37.551666,126.86409
강서구,1115, 등촌역 1번출구옆,201902,168,172,340,37.551666,126.86409
강서구,1115, 등촌역 1번출구옆,201903,389,405,794,37.551666,126.86409
강서구,1115, 등촌역 1번출구옆,201904,655,635,1290,37.551666,126.86409
강서구,1115, 등촌역 1번출구옆,201905,1278,1243,2521,37.551666,126.86409
강서구,1115, 등촌역 1번출구옆,201906,1386,1370,2756,37.551666,126.86409
강서구,1115, 등촌역 1번출구옆,201907,1291,1298,2589,37.551666,126.86409
강서구,1115, 등촌역 1번출구옆,201908,1302,1343,2645,37.551666,126.86409
강서구,1115, 등촌역 1번출구옆,201909,1332,1331,2663,37.551666,126.86409
강서구,1115, 등촌역 1번출구옆,201910,1456,1468,2924,37.551666,126.86409
강서구,1115, 등촌역 1번출구옆,201911,842,841,1683,37.551666,126.86409
강서구,1115, 등촌역 1번출구옆,201912,385,385,770,37.551666,126.86409
강서구,1115, 등촌역 1번출구옆,202001,439,376,815,37.551666,126.86409
강서구,1115, 등촌역 1번출구옆,202002,371,350,721,37.551666,126.86409
강서구,1115, 등촌역 1번출구옆,202003,965,932,1897,37.551666,126.86409
강서구,1115, 등촌역 1번출구옆,202004,1366,1341,2707,37.551666,126.86409
강서구,1115, 등촌역 1번출구옆,202005,1708,1685,3393,37.551666,126.86409
강서구,1115, 등촌역 1번출구옆,202006,1878,1870,3748,37.551666,126.86409
강서구,1117, 스타벅스앞,201901,480,502,982,37.558197,126.844261
강서구,1117, 스타벅스앞,201902,402,432,834,37.558197,126.844261
강서구,1117, 스타벅스앞,201903,766,809,1575,37.558197,126.844261
강서구,1117, 스타벅스앞,201904,1220,1210,2430,37.558197,126.844261
강서구,1117, 스타벅스앞,201905,2035,2033,4068,37.558197,126.844261
강서구,1117, 스타벅스앞,201906,2558,2567,5125,37.558197,126.844261
강서구,1117, 스타벅스앞,201907,2712,2736,5448,37.558197,126.844261
강서구,1117, 스타벅스앞,201908,2483,2540,5023,37.558197,126.844261
강서구,1117, 스타벅스앞,201909,2255,2362,4617,37.558197,126.844261
강서구,1117, 스타벅스앞,201910,2880,2891,5771,37.558197,126.844261
강서구,1117, 스타벅스앞,201911,2010,2015,4025,37.558197,126.844261
강서구,1117, 스타벅스앞,201912,1204,1237,2441,37.558197,126.844261
강서구,1117, 스타벅스앞,202001,1096,1143,2239,37.558197,126.844261
강서구,1117, 스타벅스앞,202002,1069,1095,2164,37.558197,126.844261
강서구,1117, 스타벅스앞,202003,1506,1502,3008,37.558197,126.844261
강서구,1117, 스타벅스앞,202004,2505,2493,4998,37.558197,126.844261
강서구,1117, 스타벅스앞,202005,3318,3324,6642,37.558197,126.844261
강서구,1117, 스타벅스앞,202006,3510,3685,7195,37.558197,126.844261
강서구,1118, 증미역 3번출구뒤(등촌두산위브센티움오피스텔),201901,493,710,1203,37.557461,126.861458
강서구,1118, 증미역 3번출구뒤(등촌두산위브센티움오피스텔),201902,425,544,969,37.557461,126.861458
강서구,1118, 증미역 3번출구뒤(등촌두산위브센티움오피스텔),201903,863,1164,2027,37.557461,126.861458
강서구,1118, 증미역 3번출구뒤(등촌두산위브센티움오피스텔),201904,1454,1873,3327,37.557461,126.861458
강서구,1118, 증미역 3번출구뒤(등촌두산위브센티움오피스텔),201905,2921,3365,6286,37.557461,126.861458
강서구,1118, 증미역 3번출구뒤(등촌두산위브센티움오피스텔),201906,3447,3812,7259,37.557461,126.861458
강서구,1118, 증미역 3번출구뒤(등촌두산위브센티움오피스텔),201907,3349,3623,6972,37.557461,126.861458
강서구,1118, 증미역 3번출구뒤(등촌두산위브센티움오피스텔),201908,3348,3636,6984,37.557461,126.861458
강서구,1118, 증미역 3번출구뒤(등촌두산위브센티움오피스텔),201909,3258,3590,6848,37.557461,126.861458
강서구,1118, 증미역 3번출구뒤(등촌두산위브센티움오피스텔),201910,3777,4060,7837,37.557461,126.861458
강서구,1118, 증미역 3번출구뒤(등촌두산위브센티움오피스텔),201911,2289,2538,4827,37.557461,126.861458
강서구,1118, 증미역 3번출구뒤(등촌두산위브센티움오피스텔),201912,1269,1372,2641,37.557461,126.861458
강서구,1118, 증미역 3번출구뒤(등촌두산위브센티움오피스텔),202001,1114,1249,2363,37.557461,126.861458
강서구,1118, 증미역 3번출구뒤(등촌두산위브센티움오피스텔),202002,1148,1360,2508,37.557461,126.861458
강서구,1118, 증미역 3번출구뒤(등촌두산위브센티움오피스텔),202003,2138,2374,4512,37.557461,126.861458
강서구,1118, 증미역 3번출구뒤(등촌두산위브센티움오피스텔),202004,3446,3615,7061,37.557461,126.861458
강서구,1118, 증미역 3번출구뒤(등촌두산위브센티움오피스텔),202005,4157,4520,8677,37.557461,126.861458
강서구,1118, 증미역 3번출구뒤(등촌두산위브센티움오피스텔),202006,4572,4969,9541,37.557461,126.861458
강서구,1119, 염창동 한마음아파트앞(염창동 빛나는 음악학원앞),201901,294,310,604,37.554253,126.867561
강서구,1119, 염창동 한마음아파트앞(염창동 빛나는 음악학원앞),201902,287,314,601,37.554253,126.867561
강서구,1119, 염창동 한마음아파트앞(염창동 빛나는 음악학원앞),201903,563,616,1179,37.554253,126.867561
강서구,1119, 염창동 한마음아파트앞(염창동 빛나는 음악학원앞),201904,1088,1261,2349,37.554253,126.867561
강서구,1119, 염창동 한마음아파트앞(염창동 빛나는 음악학원앞),201905,1902,2195,4097,37.554253,126.867561
강서구,1119, 염창동 한마음아파트앞(염창동 빛나는 음악학원앞),201906,2275,2599,4874,37.554253,126.867561
강서구,1119, 염창동 한마음아파트앞(염창동 빛나는 음악학원앞),201907,2133,2430,4563,37.554253,126.867561
강서구,1119, 염창동 한마음아파트앞(염창동 빛나는 음악학원앞),201908,2041,2331,4372,37.554253,126.867561
강서구,1119, 염창동 한마음아파트앞(염창동 빛나는 음악학원앞),201909,2153,2290,4443,37.554253,126.867561
강서구,1119, 염창동 한마음아파트앞(염창동 빛나는 음악학원앞),201910,2536,2684,5220,37.554253,126.867561
강서구,1119, 염창동 한마음아파트앞(염창동 빛나는 음악학원앞),201911,1433,1512,2945,37.554253,126.867561
강서구,1119, 염창동 한마음아파트앞(염창동 빛나는 음악학원앞),201912,705,775,1480,37.554253,126.867561
강서구,1119, 염창동 한마음아파트앞(염창동 빛나는 음악학원앞),202001,558,577,1135,37.554253,126.867561
강서구,1119, 염창동 한마음아파트앞(염창동 빛나는 음악학원앞),202002,611,657,1268,37.554253,126.867561
강서구,1119, 염창동 한마음아파트앞(염창동 빛나는 음악학원앞),202003,1755,1901,3656,37.554253,126.867561
강서구,1119, 염창동 한마음아파트앞(염창동 빛나는 음악학원앞),202004,2655,2979,5634,37.554253,126.867561
강서구,1119, 염창동 한마음아파트앞(염창동 빛나는 음악학원앞),202005,3159,3562,6721,37.554253,126.867561
강서구,1119, 염창동 한마음아파트앞(염창동 빛나는 음악학원앞),202006,3139,3703,6842,37.554253,126.867561
강서구,1120, 대림경동아파트앞,201901,351,387,738,37.565189,126.853996
강서구,1120, 대림경동아파트앞,201902,262,289,551,37.565189,126.853996
강서구,1120, 대림경동아파트앞,201903,551,636,1187,37.565189,126.853996
강서구,1120, 대림경동아파트앞,201904,929,1073,2002,37.565189,126.853996
강서구,1120, 대림경동아파트앞,201905,1666,1855,3521,37.565189,126.853996
강서구,1120, 대림경동아파트앞,201906,1953,2120,4073,37.565189,126.853996
강서구,1120, 대림경동아파트앞,201907,1730,1880,3610,37.565189,126.853996
강서구,1120, 대림경동아파트앞,201908,1925,2029,3954,37.565189,126.853996
강서구,1120, 대림경동아파트앞,201909,1758,1827,3585,37.565189,126.853996
강서구,1120, 대림경동아파트앞,201910,2077,2113,4190,37.565189,126.853996
강서구,1120, 대림경동아파트앞,201911,1233,1260,2493,37.565189,126.853996
강서구,1120, 대림경동아파트앞,201912,666,652,1318,37.565189,126.853996
강서구,1120, 대림경동아파트앞,202001,688,705,1393,37.565189,126.853996
강서구,1120, 대림경동아파트앞,202002,779,777,1556,37.565189,126.853996
강서구,1120, 대림경동아파트앞,202003,1563,1566,3129,37.565189,126.853996
강서구,1120, 대림경동아파트앞,202004,2372,2406,4778,37.565189,126.853996
강서구,1120, 대림경동아파트앞,202005,2878,2940,5818,37.565189,126.853996
강서구,1120, 대림경동아파트앞,202006,2852,2903,5755,37.565189,126.853996
강서구,1121, 가양레포츠센터앞,201901,250,251,501,37.559479,126.86438
강서구,1121, 가양레포츠센터앞,201902,205,208,413,37.559479,126.86438
강서구,1121, 가양레포츠센터앞,201903,522,490,1012,37.559479,126.86438
강서구,1121, 가양레포츠센터앞,201904,824,900,1724,37.559479,126.86438
강서구,1121, 가양레포츠센터앞,201905,1555,1637,3192,37.559479,126.86438
강서구,1121, 가양레포츠센터앞,201906,1887,1944,3831,37.559479,126.86438
강서구,1121, 가양레포츠센터앞,201907,1595,1726,3321,37.559479,126.86438
강서구,1121, 가양레포츠센터앞,201908,1581,1675,3256,37.559479,126.86438
강서구,1121, 가양레포츠센터앞,201909,1504,1636,3140,37.559479,126.86438
강서구,1121, 가양레포츠센터앞,201910,1862,1951,3813,37.559479,126.86438
강서구,1121, 가양레포츠센터앞,201911,935,1062,1997,37.559479,126.86438
강서구,1121, 가양레포츠센터앞,201912,581,624,1205,37.559479,126.86438
강서구,1121, 가양레포츠센터앞,202001,522,573,1095,37.559479,126.86438
강서구,1121, 가양레포츠센터앞,202002,542,584,1126,37.559479,126.86438
강서구,1121, 가양레포츠센터앞,202003,1141,1219,2360,37.559479,126.86438
강서구,1121, 가양레포츠센터앞,202004,1781,1800,3581,37.559479,126.86438
강서구,1121, 가양레포츠센터앞,202005,2129,2182,4311,37.559479,126.86438
강서구,1121, 가양레포츠센터앞,202006,2348,2559,4907,37.559479,126.86438
강서구,1122, 황금내근린공원,201901,206,244,450,37.561932,126.863869
강서구,1122, 황금내근린공원,201902,245,279,524,37.561932,126.863869
강서구,1122, 황금내근린공원,201903,643,647,1290,37.561932,126.863869
강서구,1122, 황금내근린공원,201904,1547,1669,3216,37.561932,126.863869
강서구,1122, 황금내근린공원,201905,2413,2715,5128,37.561932,126.863869
강서구,1122, 황금내근린공원,201906,2433,2796,5229,37.561932,126.863869
강서구,1122, 황금내근린공원,201907,2137,2333,4470,37.561932,126.863869
강서구,1122, 황금내근린공원,201908,2479,2698,5177,37.561932,126.863869
강서구,1122, 황금내근린공원,201909,2677,2805,5482,37.561932,126.863869
강서구,1122, 황금내근린공원,201910,2564,2711,5275,37.561932,126.863869
강서구,1122, 황금내근린공원,201911,800,857,1657,37.561932,126.863869
강서구,1122, 황금내근린공원,201912,162,180,342,37.561932,126.863869
강서구,1122, 황금내근린공원,202001,114,155,269,37.561932,126.863869
강서구,1122, 황금내근린공원,202002,508,555,1063,37.561932,126.863869
강서구,1122, 황금내근린공원,202003,2589,2786,5375,37.561932,126.863869
강서구,1122, 황금내근린공원,202004,3978,4261,8239,37.561932,126.863869
강서구,1122, 황금내근린공원,202005,4727,5036,9763,37.561932,126.863869
강서구,1122, 황금내근린공원,202006,4006,4259,8265,37.561932,126.863869
강서구,1124, 발산역 6번출구옆(다이소앞),201901,516,530,1046,37.557968,126.838287
강서구,1124, 발산역 6번출구옆(다이소앞),201902,453,512,965,37.557968,126.838287
강서구,1124, 발산역 6번출구옆(다이소앞),201903,1171,1246,2417,37.557968,126.838287
강서구,1124, 발산역 6번출구옆(다이소앞),201904,1556,1577,3133,37.557968,126.838287
강서구,1124, 발산역 6번출구옆(다이소앞),201905,2934,2918,5852,37.557968,126.838287
강서구,1124, 발산역 6번출구옆(다이소앞),201906,3220,3252,6472,37.557968,126.838287
강서구,1124, 발산역 6번출구옆(다이소앞),201907,2914,2944,5858,37.557968,126.838287
강서구,1124, 발산역 6번출구옆(다이소앞),201908,2924,2953,5877,37.557968,126.838287
강서구,1124, 발산역 6번출구옆(다이소앞),201909,2730,2759,5489,37.557968,126.838287
강서구,1124, 발산역 6번출구옆(다이소앞),201910,3628,3663,7291,37.557968,126.838287
강서구,1124, 발산역 6번출구옆(다이소앞),201911,2421,2450,4871,37.557968,126.838287
강서구,1124, 발산역 6번출구옆(다이소앞),201912,1426,1449,2875,37.557968,126.838287
강서구,1124, 발산역 6번출구옆(다이소앞),202001,1264,1256,2520,37.557968,126.838287
강서구,1124, 발산역 6번출구옆(다이소앞),202002,1221,1237,2458,37.557968,126.838287
강서구,1124, 발산역 6번출구옆(다이소앞),202003,2100,2129,4229,37.557968,126.838287
강서구,1124, 발산역 6번출구옆(다이소앞),202004,3500,3503,7003,37.557968,126.838287
강서구,1124, 발산역 6번출구옆(다이소앞),202005,4431,4483,8914,37.557968,126.838287
강서구,1124, 발산역 6번출구옆(다이소앞),202006,5132,5147,10279,37.557968,126.838287
강서구,1125, 명덕고교입구(영종빌딩),201901,340,341,681,37.552914,126.836571
강서구,1125, 명덕고교입구(영종빌딩),201902,249,261,510,37.552914,126.836571
강서구,1125, 명덕고교입구(영종빌딩),201903,657,640,1297,37.552914,126.836571
강서구,1125, 명덕고교입구(영종빌딩),201904,941,910,1851,37.552914,126.836571
강서구,1125, 명덕고교입구(영종빌딩),201905,1775,1737,3512,37.552914,126.836571
강서구,1125, 명덕고교입구(영종빌딩),201906,2067,2064,4131,37.552914,126.836571
강서구,1125, 명덕고교입구(영종빌딩),201907,1980,1983,3963,37.552914,126.836571
강서구,1125, 명덕고교입구(영종빌딩),201908,2076,2109,4185,37.552914,126.836571
강서구,1125, 명덕고교입구(영종빌딩),201909,2026,2043,4069,37.552914,126.836571
강서구,1125, 명덕고교입구(영종빌딩),201910,2772,2789,5561,37.552914,126.836571
강서구,1125, 명덕고교입구(영종빌딩),201911,1755,1779,3534,37.552914,126.836571
강서구,1125, 명덕고교입구(영종빌딩),201912,968,960,1928,37.552914,126.836571
강서구,1125, 명덕고교입구(영종빌딩),202001,834,833,1667,37.552914,126.836571
강서구,1125, 명덕고교입구(영종빌딩),202002,827,822,1649,37.552914,126.836571
강서구,1125, 명덕고교입구(영종빌딩),202003,1503,1507,3010,37.552914,126.836571
강서구,1125, 명덕고교입구(영종빌딩),202004,2540,2526,5066,37.552914,126.836571
강서구,1125, 명덕고교입구(영종빌딩),202005,3009,3001,6010,37.552914,126.836571
강서구,1125, 명덕고교입구(영종빌딩),202006,3617,3656,7273,37.552914,126.836571
강서구,1126, 우장산역 1번출구옆(우장산아이파크105동앞),201901,348,260,608,37.548908,126.836563
강서구,1126, 우장산역 1번출구옆(우장산아이파크105동앞),201902,283,207,490,37.548908,126.836563
강서구,1126, 우장산역 1번출구옆(우장산아이파크105동앞),201903,544,348,892,37.548908,126.836563
강서구,1126, 우장산역 1번출구옆(우장산아이파크105동앞),201904,678,490,1168,37.548908,126.836563
강서구,1126, 우장산역 1번출구옆(우장산아이파크105동앞),201905,1088,916,2004,37.548908,126.836563
강서구,1126, 우장산역 1번출구옆(우장산아이파크105동앞),201906,1500,1096,2596,37.548908,126.836563
강서구,1126, 우장산역 1번출구옆(우장산아이파크105동앞),201907,1542,1050,2592,37.548908,126.836563
강서구,1126, 우장산역 1번출구옆(우장산아이파크105동앞),201908,1935,1481,3416,37.548908,126.836563
강서구,1126, 우장산역 1번출구옆(우장산아이파크105동앞),201909,1705,1351,3056,37.548908,126.836563
강서구,1126, 우장산역 1번출구옆(우장산아이파크105동앞),201910,1871,1583,3454,37.548908,126.836563
강서구,1126, 우장산역 1번출구옆(우장산아이파크105동앞),201911,1069,751,1820,37.548908,126.836563
강서구,1126, 우장산역 1번출구옆(우장산아이파크105동앞),201912,687,419,1106,37.548908,126.836563
강서구,1126, 우장산역 1번출구옆(우장산아이파크105동앞),202001,565,394,959,37.548908,126.836563
강서구,1126, 우장산역 1번출구옆(우장산아이파크105동앞),202002,555,390,945,37.548908,126.836563
강서구,1126, 우장산역 1번출구옆(우장산아이파크105동앞),202003,878,669,1547,37.548908,126.836563
강서구,1126, 우장산역 1번출구옆(우장산아이파크105동앞),202004,1348,1122,2470,37.548908,126.836563
강서구,1126, 우장산역 1번출구옆(우장산아이파크105동앞),202005,1543,1268,2811,37.548908,126.836563
강서구,1126, 우장산역 1번출구옆(우장산아이파크105동앞),202006,1977,1487,3464,37.548908,126.836563
강서구,1127, 화곡역(에이스정형외과앞) 버스정류장,201901,303,334,637,37.540981,126.838547
강서구,1127, 화곡역(에이스정형외과앞) 버스정류장,201902,293,308,601,37.540981,126.838547
강서구,1127, 화곡역(에이스정형외과앞) 버스정류장,201903,493,506,999,37.540981,126.838547
강서구,1127, 화곡역(에이스정형외과앞) 버스정류장,201904,914,940,1854,37.540981,126.838547
강서구,1127, 화곡역(에이스정형외과앞) 버스정류장,201905,1436,1444,2880,37.540981,126.838547
강서구,1127, 화곡역(에이스정형외과앞) 버스정류장,201906,1677,1633,3310,37.540981,126.838547
강서구,1127, 화곡역(에이스정형외과앞) 버스정류장,201907,1674,1672,3346,37.540981,126.838547
강서구,1127, 화곡역(에이스정형외과앞) 버스정류장,201908,1451,1464,2915,37.540981,126.838547
강서구,1127, 화곡역(에이스정형외과앞) 버스정류장,201909,1403,1443,2846,37.540981,126.838547
강서구,1127, 화곡역(에이스정형외과앞) 버스정류장,201910,1692,1696,3388,37.540981,126.838547
강서구,1127, 화곡역(에이스정형외과앞) 버스정류장,201911,975,989,1964,37.540981,126.838547
강서구,1127, 화곡역(에이스정형외과앞) 버스정류장,201912,595,553,1148,37.540981,126.838547
강서구,1127, 화곡역(에이스정형외과앞) 버스정류장,202001,489,484,973,37.540981,126.838547
강서구,1127, 화곡역(에이스정형외과앞) 버스정류장,202002,530,513,1043,37.540981,126.838547
강서구,1127, 화곡역(에이스정형외과앞) 버스정류장,202003,1014,965,1979,37.540981,126.838547
강서구,1127, 화곡역(에이스정형외과앞) 버스정류장,202004,1508,1401,2909,37.540981,126.838547
강서구,1127, 화곡역(에이스정형외과앞) 버스정류장,202005,1866,1748,3614,37.540981,126.838547
강서구,1127, 화곡역(에이스정형외과앞) 버스정류장,202006,2080,1983,4063,37.540981,126.838547
강서구,1128, 화곡역 6번출구,201901,226,194,420,37.541412,126.840225
강서구,1128, 화곡역 6번출구,201902,216,196,412,37.541412,126.840225
강서구,1128, 화곡역 6번출구,201903,372,375,747,37.541412,126.840225
강서구,1128, 화곡역 6번출구,201904,564,549,1113,37.541412,126.840225
강서구,1128, 화곡역 6번출구,201905,978,908,1886,37.541412,126.840225
강서구,1128, 화곡역 6번출구,201906,1143,1100,2243,37.541412,126.840225
강서구,1128, 화곡역 6번출구,201907,956,938,1894,37.541412,126.840225
강서구,1128, 화곡역 6번출구,201908,992,1004,1996,37.541412,126.840225
강서구,1128, 화곡역 6번출구,201909,966,981,1947,37.541412,126.840225
강서구,1128, 화곡역 6번출구,201910,1119,1120,2239,37.541412,126.840225
강서구,1128, 화곡역 6번출구,201911,771,756,1527,37.541412,126.840225
강서구,1128, 화곡역 6번출구,201912,407,407,814,37.541412,126.840225
강서구,1128, 화곡역 6번출구,202001,532,464,996,37.541412,126.840225
강서구,1128, 화곡역 6번출구,202002,491,444,935,37.541412,126.840225
강서구,1128, 화곡역 6번출구,202003,796,766,1562,37.541412,126.840225
강서구,1128, 화곡역 6번출구,202004,1332,1293,2625,37.541412,126.840225
강서구,1128, 화곡역 6번출구,202005,1526,1476,3002,37.541412,126.840225
강서구,1128, 화곡역 6번출구,202006,1829,1748,3577,37.541412,126.840225
강서구,1129, 화곡역 1번 출구 앞,201901,291,259,550,37.542099,126.840218
강서구,1129, 화곡역 1번 출구 앞,201902,214,218,432,37.542099,126.840218
강서구,1129, 화곡역 1번 출구 앞,201903,501,500,1001,37.542099,126.840218
강서구,1129, 화곡역 1번 출구 앞,201904,824,814,1638,37.542099,126.840218
강서구,1129, 화곡역 1번 출구 앞,201905,1380,1348,2728,37.542099,126.840218
강서구,1129, 화곡역 1번 출구 앞,201906,1605,1560,3165,37.542099,126.840218
강서구,1129, 화곡역 1번 출구 앞,201907,1456,1467,2923,37.542099,126.840218
강서구,1129, 화곡역 1번 출구 앞,201908,1376,1390,2766,37.542099,126.840218
강서구,1129, 화곡역 1번 출구 앞,201909,1560,1560,3120,37.542099,126.840218
강서구,1129, 화곡역 1번 출구 앞,201910,1804,1805,3609,37.542099,126.840218
강서구,1129, 화곡역 1번 출구 앞,201911,1095,1078,2173,37.542099,126.840218
강서구,1129, 화곡역 1번 출구 앞,201912,544,551,1095,37.542099,126.840218
강서구,1129, 화곡역 1번 출구 앞,202001,379,375,754,37.542099,126.840218
강서구,1129, 화곡역 1번 출구 앞,202002,504,503,1007,37.542099,126.840218
강서구,1129, 화곡역 1번 출구 앞,202003,1016,989,2005,37.542099,126.840218
강서구,1129, 화곡역 1번 출구 앞,202004,1723,1695,3418,37.542099,126.840218
강서구,1129, 화곡역 1번 출구 앞,202005,2099,2043,4142,37.542099,126.840218
강서구,1129, 화곡역 1번 출구 앞,202006,2390,2358,4748,37.542099,126.840218
강서구,1130, 화곡본동시장 버스정류장,201901,134,94,228,37.542751,126.842621
강서구,1130, 화곡본동시장 버스정류장,201902,136,116,252,37.542751,126.842621
강서구,1130, 화곡본동시장 버스정류장,201903,279,224,503,37.542751,126.842621
강서구,1130, 화곡본동시장 버스정류장,201904,457,402,859,37.542751,126.842621
강서구,1130, 화곡본동시장 버스정류장,201905,730,691,1421,37.542751,126.842621
강서구,1130, 화곡본동시장 버스정류장,201906,720,695,1415,37.542751,126.842621
강서구,1130, 화곡본동시장 버스정류장,201907,624,622,1246,37.542751,126.842621
강서구,1130, 화곡본동시장 버스정류장,201908,550,569,1119,37.542751,126.842621
강서구,1130, 화곡본동시장 버스정류장,201909,612,622,1234,37.542751,126.842621
강서구,1130, 화곡본동시장 버스정류장,201910,654,661,1315,37.542751,126.842621
강서구,1130, 화곡본동시장 버스정류장,201911,367,360,727,37.542751,126.842621
강서구,1130, 화곡본동시장 버스정류장,201912,172,157,329,37.542751,126.842621
강서구,1130, 화곡본동시장 버스정류장,202001,229,187,416,37.542751,126.842621
강서구,1130, 화곡본동시장 버스정류장,202002,225,208,433,37.542751,126.842621
강서구,1130, 화곡본동시장 버스정류장,202003,360,337,697,37.542751,126.842621
강서구,1130, 화곡본동시장 버스정류장,202004,665,660,1325,37.542751,126.842621
강서구,1130, 화곡본동시장 버스정류장,202005,925,882,1807,37.542751,126.842621
강서구,1130, 화곡본동시장 버스정류장,202006,996,916,1912,37.542751,126.842621
강서구,1131, 꿈돌이공원 앞,201901,421,427,848,37.546444,126.845459
강서구,1131, 꿈돌이공원 앞,201902,335,346,681,37.546444,126.845459
강서구,1131, 꿈돌이공원 앞,201903,748,745,1493,37.546444,126.845459
강서구,1131, 꿈돌이공원 앞,201904,1099,1129,2228,37.546444,126.845459
강서구,1131, 꿈돌이공원 앞,201905,1832,1893,3725,37.546444,126.845459
강서구,1131, 꿈돌이공원 앞,201906,2168,2277,4445,37.546444,126.845459
강서구,1131, 꿈돌이공원 앞,201907,2007,2089,4096,37.546444,126.845459
강서구,1131, 꿈돌이공원 앞,201908,2026,2071,4097,37.546444,126.845459
강서구,1131, 꿈돌이공원 앞,201909,1948,2117,4065,37.546444,126.845459
강서구,1131, 꿈돌이공원 앞,201910,2193,2277,4470,37.546444,126.845459
강서구,1131, 꿈돌이공원 앞,201911,1395,1424,2819,37.546444,126.845459
강서구,1131, 꿈돌이공원 앞,201912,755,759,1514,37.546444,126.845459
강서구,1131, 꿈돌이공원 앞,202001,681,680,1361,37.546444,126.845459
강서구,1131, 꿈돌이공원 앞,202002,738,739,1477,37.546444,126.845459
강서구,1131, 꿈돌이공원 앞,202003,1261,1309,2570,37.546444,126.845459
강서구,1131, 꿈돌이공원 앞,202004,1924,2021,3945,37.546444,126.845459
강서구,1131, 꿈돌이공원 앞,202005,2675,2771,5446,37.546444,126.845459
강서구,1131, 꿈돌이공원 앞,202006,2586,3146,5732,37.546444,126.845459
강서구,1132, 등촌역 7번출구,201901,278,307,585,37.551109,126.863708
강서구,1132, 등촌역 7번출구,201902,253,336,589,37.551109,126.863708
강서구,1132, 등촌역 7번출구,201903,485,609,1094,37.551109,126.863708
강서구,1132, 등촌역 7번출구,201904,817,943,1760,37.551109,126.863708
강서구,1132, 등촌역 7번출구,201905,1557,1555,3112,37.551109,126.863708
강서구,1132, 등촌역 7번출구,201906,1667,1737,3404,37.551109,126.863708
강서구,1132, 등촌역 7번출구,201907,1665,1713,3378,37.551109,126.863708
강서구,1132, 등촌역 7번출구,201908,1626,1717,3343,37.551109,126.863708
강서구,1132, 등촌역 7번출구,201909,1728,1743,3471,37.551109,126.863708
강서구,1132, 등촌역 7번출구,201910,2032,2041,4073,37.551109,126.863708
강서구,1132, 등촌역 7번출구,201911,1083,1107,2190,37.551109,126.863708
강서구,1132, 등촌역 7번출구,201912,615,595,1210,37.551109,126.863708
강서구,1132, 등촌역 7번출구,202001,510,500,1010,37.551109,126.863708
강서구,1132, 등촌역 7번출구,202002,589,607,1196,37.551109,126.863708
강서구,1132, 등촌역 7번출구,202003,973,971,1944,37.551109,126.863708
강서구,1132, 등촌역 7번출구,202004,1759,1691,3450,37.551109,126.863708
강서구,1132, 등촌역 7번출구,202005,2248,2199,4447,37.551109,126.863708
강서구,1132, 등촌역 7번출구,202006,2247,2306,4553,37.551109,126.863708
강서구,1135, 강서구의회,201901,297,271,568,37.546532,126.862549
강서구,1135, 강서구의회,201902,264,207,471,37.546532,126.862549
강서구,1135, 강서구의회,201903,479,398,877,37.546532,126.862549
강서구,1135, 강서구의회,201904,793,716,1509,37.546532,126.862549
강서구,1135, 강서구의회,201905,1361,1285,2646,37.546532,126.862549
강서구,1135, 강서구의회,201906,1656,1698,3354,37.546532,126.862549
강서구,1135, 강서구의회,201907,1507,1543,3050,37.546532,126.862549
강서구,1135, 강서구의회,201908,1600,1594,3194,37.546532,126.862549
강서구,1135, 강서구의회,201909,1522,1533,3055,37.546532,126.862549
강서구,1135, 강서구의회,201910,1739,1730,3469,37.546532,126.862549
강서구,1135, 강서구의회,201911,1088,1025,2113,37.546532,126.862549
강서구,1135, 강서구의회,201912,580,552,1132,37.546532,126.862549
강서구,1135, 강서구의회,202001,546,511,1057,37.546532,126.862549
강서구,1135, 강서구의회,202002,567,530,1097,37.546532,126.862549
강서구,1135, 강서구의회,202003,988,936,1924,37.546532,126.862549
강서구,1135, 강서구의회,202004,1017,1009,2026,37.546532,126.862549
강서구,1135, 강서구의회,202005,564,565,1129,37.546532,126.862549
강서구,1135, 강서구의회,202006,1886,1894,3780,37.546532,126.862549
강서구,1136, 등촌2파출소,201901,136,50,186,37.544788,126.862
강서구,1136, 등촌2파출소,201902,145,58,203,37.544788,126.862
강서구,1136, 등촌2파출소,201903,279,131,410,37.544788,126.862
강서구,1136, 등촌2파출소,201904,476,254,730,37.544788,126.862
강서구,1136, 등촌2파출소,201905,666,453,1119,37.544788,126.862
강서구,1136, 등촌2파출소,201906,796,534,1330,37.544788,126.862
강서구,1136, 등촌2파출소,201907,661,477,1138,37.544788,126.862
강서구,1136, 등촌2파출소,201908,588,419,1007,37.544788,126.862
강서구,1136, 등촌2파출소,201909,630,472,1102,37.544788,126.862
강서구,1136, 등촌2파출소,201910,689,564,1253,37.544788,126.862
강서구,1136, 등촌2파출소,201911,536,333,869,37.544788,126.862
강서구,1136, 등촌2파출소,201912,384,238,622,37.544788,126.862
강서구,1136, 등촌2파출소,202001,298,164,462,37.544788,126.862
강서구,1136, 등촌2파출소,202002,299,154,453,37.544788,126.862
강서구,1136, 등촌2파출소,202003,539,255,794,37.544788,126.862
강서구,1136, 등촌2파출소,202004,1139,824,1963,37.544788,126.862
강서구,1136, 등촌2파출소,202005,1663,1395,3058,37.544788,126.862
강서구,1136, 등촌2파출소,202006,1208,803,2011,37.544788,126.862
강서구,1137, 등촌2동주민센터,201901,94,61,155,37.541431,126.86322
강서구,1137, 등촌2동주민센터,201902,69,58,127,37.541431,126.86322
강서구,1137, 등촌2동주민센터,201903,156,86,242,37.541431,126.86322
강서구,1137, 등촌2동주민센터,201904,267,151,418,37.541431,126.86322
강서구,1137, 등촌2동주민센터,201905,328,263,591,37.541431,126.86322
강서구,1137, 등촌2동주민센터,201906,489,310,799,37.541431,126.86322
강서구,1137, 등촌2동주민센터,201907,448,305,753,37.541431,126.86322
강서구,1137, 등촌2동주민센터,201908,416,252,668,37.541431,126.86322
강서구,1137, 등촌2동주민센터,201909,445,312,757,37.541431,126.86322
강서구,1137, 등촌2동주민센터,201910,402,310,712,37.541431,126.86322
강서구,1137, 등촌2동주민센터,201911,380,244,624,37.541431,126.86322
강서구,1137, 등촌2동주민센터,201912,188,96,284,37.541431,126.86322
강서구,1137, 등촌2동주민센터,202001,260,110,370,37.541431,126.86322
강서구,1137, 등촌2동주민센터,202002,170,84,254,37.541431,126.86322
강서구,1137, 등촌2동주민센터,202003,375,195,570,37.541431,126.86322
강서구,1137, 등촌2동주민센터,202004,553,334,887,37.541431,126.86322
강서구,1137, 등촌2동주민센터,202005,592,360,952,37.541431,126.86322
강서구,1137, 등촌2동주민센터,202006,637,433,1070,37.541431,126.86322
강서구,1139, 용문사 버스정류장,201901,248,243,491,37.536991,126.863365
강서구,1139, 용문사 버스정류장,201902,217,195,412,37.536991,126.863365
강서구,1139, 용문사 버스정류장,201903,408,367,775,37.536991,126.863365
강서구,1139, 용문사 버스정류장,201904,644,651,1295,37.536991,126.863365
강서구,1139, 용문사 버스정류장,201905,1139,1177,2316,37.536991,126.863365
강서구,1139, 용문사 버스정류장,201906,1326,1433,2759,37.536991,126.863365
강서구,1139, 용문사 버스정류장,201907,1328,1429,2757,37.536991,126.863365
강서구,1139, 용문사 버스정류장,201908,1255,1302,2557,37.536991,126.863365
강서구,1139, 용문사 버스정류장,201909,1129,1182,2311,37.536991,126.863365
강서구,1139, 용문사 버스정류장,201910,1369,1409,2778,37.536991,126.863365
강서구,1139, 용문사 버스정류장,201911,581,581,1162,37.536991,126.863365
강서구,1139, 용문사 버스정류장,201912,514,538,1052,37.536991,126.863365
강서구,1139, 용문사 버스정류장,202001,457,462,919,37.536991,126.863365
강서구,1139, 용문사 버스정류장,202002,476,520,996,37.536991,126.863365
강서구,1139, 용문사 버스정류장,202003,829,865,1694,37.536991,126.863365
강서구,1139, 용문사 버스정류장,202004,1286,1321,2607,37.536991,126.863365
강서구,1139, 용문사 버스정류장,202005,1646,1685,3331,37.536991,126.863365
강서구,1139, 용문사 버스정류장,202006,1725,1837,3562,37.536991,126.863365
강서구,1140, 목동사거리 버스정류장,201901,360,418,778,37.531399,126.863609
강서구,1140, 목동사거리 버스정류장,201902,314,343,657,37.531399,126.863609
강서구,1140, 목동사거리 버스정류장,201903,541,620,1161,37.531399,126.863609
강서구,1140, 목동사거리 버스정류장,201904,788,810,1598,37.531399,126.863609
강서구,1140, 목동사거리 버스정류장,201905,1286,1367,2653,37.531399,126.863609
강서구,1140, 목동사거리 버스정류장,201906,1562,1611,3173,37.531399,126.863609
강서구,1140, 목동사거리 버스정류장,201907,1415,1470,2885,37.531399,126.863609
강서구,1140, 목동사거리 버스정류장,201908,1418,1483,2901,37.531399,126.863609
강서구,1140, 목동사거리 버스정류장,201909,1379,1442,2821,37.531399,126.863609
강서구,1140, 목동사거리 버스정류장,201910,1737,1800,3537,37.531399,126.863609
강서구,1140, 목동사거리 버스정류장,201911,960,1016,1976,37.531399,126.863609
강서구,1140, 목동사거리 버스정류장,201912,600,631,1231,37.531399,126.863609
강서구,1140, 목동사거리 버스정류장,202001,559,588,1147,37.531399,126.863609
강서구,1140, 목동사거리 버스정류장,202002,565,586,1151,37.531399,126.863609
강서구,1140, 목동사거리 버스정류장,202003,1081,1111,2192,37.531399,126.863609
강서구,1140, 목동사거리 버스정류장,202004,1586,1640,3226,37.531399,126.863609
강서구,1140, 목동사거리 버스정류장,202005,1927,1920,3847,37.531399,126.863609
강서구,1140, 목동사거리 버스정류장,202006,1926,2041,3967,37.531399,126.863609
강서구,1141, 곰달래 문화복지센터 1-1,201901,277,342,619,37.52906,126.84848
강서구,1141, 곰달래 문화복지센터 1-1,201902,252,332,584,37.52906,126.84848
강서구,1141, 곰달래 문화복지센터 1-1,201903,498,644,1142,37.52906,126.84848
강서구,1141, 곰달래 문화복지센터 1-1,201904,791,1171,1962,37.52906,126.84848
강서구,1141, 곰달래 문화복지센터 1-1,201905,1358,2082,3440,37.52906,126.84848
강서구,1141, 곰달래 문화복지센터 1-1,201906,1518,2356,3874,37.52906,126.84848
강서구,1141, 곰달래 문화복지센터 1-1,201907,1390,2113,3503,37.52906,126.84848
강서구,1141, 곰달래 문화복지센터 1-1,201908,1327,2015,3342,37.52906,126.84848
강서구,1141, 곰달래 문화복지센터 1-1,201909,1497,2104,3601,37.52906,126.84848
강서구,1141, 곰달래 문화복지센터 1-1,201910,1689,2395,4084,37.52906,126.84848
강서구,1141, 곰달래 문화복지센터 1-1,201911,1026,1429,2455,37.52906,126.84848
강서구,1141, 곰달래 문화복지센터 1-1,201912,510,743,1253,37.52906,126.84848
강서구,1141, 곰달래 문화복지센터 1-1,202001,511,716,1227,37.52906,126.84848
강서구,1141, 곰달래 문화복지센터 1-1,202002,491,696,1187,37.52906,126.84848
강서구,1141, 곰달래 문화복지센터 1-1,202003,971,1327,2298,37.52906,126.84848
강서구,1141, 곰달래 문화복지센터 1-1,202004,1936,2439,4375,37.52906,126.84848
강서구,1141, 곰달래 문화복지센터 1-1,202005,2250,2760,5010,37.52906,126.84848
강서구,1141, 곰달래 문화복지센터 1-1,202006,2150,2862,5012,37.52906,126.84848
강서구,1145, 곰달래 문화복지센터 1-2,201901,224,239,463,37.528919,126.848083
강서구,1145, 곰달래 문화복지센터 1-2,201902,189,209,398,37.528919,126.848083
강서구,1145, 곰달래 문화복지센터 1-2,201903,361,412,773,37.528919,126.848083
강서구,1145, 곰달래 문화복지센터 1-2,201904,554,616,1170,37.528919,126.848083
강서구,1145, 곰달래 문화복지센터 1-2,201905,807,1040,1847,37.528919,126.848083
강서구,1145, 곰달래 문화복지센터 1-2,201906,1018,1123,2141,37.528919,126.848083
강서구,1145, 곰달래 문화복지센터 1-2,201907,968,1155,2123,37.528919,126.848083
강서구,1145, 곰달래 문화복지센터 1-2,201908,881,1068,1949,37.528919,126.848083
강서구,1145, 곰달래 문화복지센터 1-2,201909,835,958,1793,37.528919,126.848083
강서구,1145, 곰달래 문화복지센터 1-2,201910,1013,1144,2157,37.528919,126.848083
강서구,1145, 곰달래 문화복지센터 1-2,201911,666,780,1446,37.528919,126.848083
강서구,1145, 곰달래 문화복지센터 1-2,201912,423,545,968,37.528919,126.848083
강서구,1145, 곰달래 문화복지센터 1-2,202001,375,453,828,37.528919,126.848083
강서구,1145, 곰달래 문화복지센터 1-2,202002,347,417,764,37.528919,126.848083
강서구,1145, 곰달래 문화복지센터 1-2,202003,619,681,1300,37.528919,126.848083
강서구,1145, 곰달래 문화복지센터 1-2,202004,1134,1247,2381,37.528919,126.848083
강서구,1145, 곰달래 문화복지센터 1-2,202005,1434,1520,2954,37.528919,126.848083
강서구,1145, 곰달래 문화복지센터 1-2,202006,1296,1478,2774,37.528919,126.848083
강서구,1146, 곰달래사거리,201901,218,313,531,37.530338,126.838257
강서구,1146, 곰달래사거리,201902,178,233,411,37.530338,126.838257
강서구,1146, 곰달래사거리,201903,347,493,840,37.530338,126.838257
강서구,1146, 곰달래사거리,201904,610,783,1393,37.530338,126.838257
강서구,1146, 곰달래사거리,201905,990,1347,2337,37.530338,126.838257
강서구,1146, 곰달래사거리,201906,1073,1618,2691,37.530338,126.838257
강서구,1146, 곰달래사거리,201907,1094,1527,2621,37.530338,126.838257
강서구,1146, 곰달래사거리,201908,973,1366,2339,37.530338,126.838257
강서구,1146, 곰달래사거리,201909,1060,1398,2458,37.530338,126.838257
강서구,1146, 곰달래사거리,201910,1315,1733,3048,37.530338,126.838257
강서구,1146, 곰달래사거리,201911,885,1220,2105,37.530338,126.838257
강서구,1146, 곰달래사거리,201912,570,785,1355,37.530338,126.838257
강서구,1146, 곰달래사거리,202001,451,588,1039,37.530338,126.838257
강서구,1146, 곰달래사거리,202002,432,584,1016,37.530338,126.838257
강서구,1146, 곰달래사거리,202003,810,1025,1835,37.530338,126.838257
강서구,1146, 곰달래사거리,202004,1313,1631,2944,37.530338,126.838257
강서구,1146, 곰달래사거리,202005,1602,2030,3632,37.530338,126.838257
강서구,1146, 곰달래사거리,202006,1644,2317,3961,37.530338,126.838257
강서구,1148, 볏골공원,201901,186,171,357,37.54147,126.84478
강서구,1148, 볏골공원,201902,168,158,326,37.54147,126.84478
강서구,1148, 볏골공원,201903,324,313,637,37.54147,126.84478
강서구,1148, 볏골공원,201904,515,503,1018,37.54147,126.84478
강서구,1148, 볏골공원,201905,752,791,1543,37.54147,126.84478
강서구,1148, 볏골공원,201906,904,905,1809,37.54147,126.84478
강서구,1148, 볏골공원,201907,818,868,1686,37.54147,126.84478
강서구,1148, 볏골공원,201908,785,801,1586,37.54147,126.84478
강서구,1148, 볏골공원,201909,795,848,1643,37.54147,126.84478
강서구,1148, 볏골공원,201910,931,936,1867,37.54147,126.84478
강서구,1148, 볏골공원,201911,597,602,1199,37.54147,126.84478
강서구,1148, 볏골공원,201912,332,337,669,37.54147,126.84478
강서구,1148, 볏골공원,202001,294,290,584,37.54147,126.84478
강서구,1148, 볏골공원,202002,269,261,530,37.54147,126.84478
강서구,1148, 볏골공원,202003,647,635,1282,37.54147,126.84478
강서구,1148, 볏골공원,202004,961,991,1952,37.54147,126.84478
강서구,1148, 볏골공원,202005,1197,1184,2381,37.54147,126.84478
강서구,1148, 볏골공원,202006,1348,1392,2740,37.54147,126.84478
강서구,1149, 신방화역환승주차장,201901,535,529,1064,37.567284,126.818275
강서구,1149, 신방화역환승주차장,201902,554,578,1132,37.567284,126.818275
강서구,1149, 신방화역환승주차장,201903,886,951,1837,37.567284,126.818275
강서구,1149, 신방화역환승주차장,201904,1423,1458,2881,37.567284,126.818275
강서구,1149, 신방화역환승주차장,201905,2595,2628,5223,37.567284,126.818275
강서구,1149, 신방화역환승주차장,201906,3245,3244,6489,37.567284,126.818275
강서구,1149, 신방화역환승주차장,201907,3124,3116,6240,37.567284,126.818275
강서구,1149, 신방화역환승주차장,201908,3221,3195,6416,37.567284,126.818275
강서구,1149, 신방화역환승주차장,201909,3334,3395,6729,37.567284,126.818275
강서구,1149, 신방화역환승주차장,201910,4136,4107,8243,37.567284,126.818275
강서구,1149, 신방화역환승주차장,201911,2400,2395,4795,37.567284,126.818275
강서구,1149, 신방화역환승주차장,201912,1462,1465,2927,37.567284,126.818275
강서구,1149, 신방화역환승주차장,202001,1382,1382,2764,37.567284,126.818275
강서구,1149, 신방화역환승주차장,202002,1293,1304,2597,37.567284,126.818275
강서구,1149, 신방화역환승주차장,202003,2213,2206,4419,37.567284,126.818275
강서구,1149, 신방화역환승주차장,202004,3268,3282,6550,37.567284,126.818275
강서구,1149, 신방화역환승주차장,202005,4295,4307,8602,37.567284,126.818275
강서구,1149, 신방화역환승주차장,202006,5013,5026,10039,37.567284,126.818275
강서구,1150, 송정역 1번출구,201901,340,365,705,37.56155,126.810478
강서구,1150, 송정역 1번출구,201902,383,419,802,37.56155,126.810478
강서구,1150, 송정역 1번출구,201903,645,677,1322,37.56155,126.810478
강서구,1150, 송정역 1번출구,201904,1118,1211,2329,37.56155,126.810478
강서구,1150, 송정역 1번출구,201905,2222,2248,4470,37.56155,126.810478
강서구,1150, 송정역 1번출구,201906,2848,2931,5779,37.56155,126.810478
강서구,1150, 송정역 1번출구,201907,2767,2786,5553,37.56155,126.810478
강서구,1150, 송정역 1번출구,201908,2433,2451,4884,37.56155,126.810478
강서구,1150, 송정역 1번출구,201909,2413,2426,4839,37.56155,126.810478
강서구,1150, 송정역 1번출구,201910,2978,2974,5952,37.56155,126.810478
강서구,1150, 송정역 1번출구,201911,1784,1804,3588,37.56155,126.810478
강서구,1150, 송정역 1번출구,201912,971,1016,1987,37.56155,126.810478
강서구,1150, 송정역 1번출구,202001,878,923,1801,37.56155,126.810478
강서구,1150, 송정역 1번출구,202002,886,884,1770,37.56155,126.810478
강서구,1150, 송정역 1번출구,202003,1669,1693,3362,37.56155,126.810478
강서구,1150, 송정역 1번출구,202004,2561,2586,5147,37.56155,126.810478
강서구,1150, 송정역 1번출구,202005,3710,3736,7446,37.56155,126.810478
강서구,1150, 송정역 1번출구,202006,4111,4234,8345,37.56155,126.810478
강서구,1151, 마곡역1번출구,201901,323,305,628,37.560234,126.823471
강서구,1151, 마곡역1번출구,201902,273,278,551,37.560234,126.823471
강서구,1151, 마곡역1번출구,201903,498,473,971,37.560234,126.823471
강서구,1151, 마곡역1번출구,201904,759,553,1312,37.560234,126.823471
강서구,1151, 마곡역1번출구,201905,1157,915,2072,37.560234,126.823471
강서구,1151, 마곡역1번출구,201906,1415,1122,2537,37.560234,126.823471
강서구,1151, 마곡역1번출구,201907,1404,1075,2479,37.560234,126.823471
강서구,1151, 마곡역1번출구,201908,1298,945,2243,37.560234,126.823471
강서구,1151, 마곡역1번출구,201909,1390,894,2284,37.560234,126.823471
강서구,1151, 마곡역1번출구,201910,1666,1242,2908,37.560234,126.823471
강서구,1151, 마곡역1번출구,201911,1252,905,2157,37.560234,126.823471
강서구,1151, 마곡역1번출구,201912,849,570,1419,37.560234,126.823471
강서구,1151, 마곡역1번출구,202001,728,459,1187,37.560234,126.823471
강서구,1151, 마곡역1번출구,202002,650,453,1103,37.560234,126.823471
강서구,1151, 마곡역1번출구,202003,939,722,1661,37.560234,126.823471
강서구,1151, 마곡역1번출구,202004,1223,920,2143,37.560234,126.823471
강서구,1151, 마곡역1번출구,202005,1684,1250,2934,37.560234,126.823471
강서구,1151, 마곡역1번출구,202006,1876,1508,3384,37.560234,126.823471
강서구,1152, 마곡역교차로,201901,383,477,860,37.558666,126.826614
강서구,1152, 마곡역교차로,201902,376,406,782,37.558666,126.826614
강서구,1152, 마곡역교차로,201903,745,832,1577,37.558666,126.826614
강서구,1152, 마곡역교차로,201904,1022,1022,2044,37.558666,126.826614
강서구,1152, 마곡역교차로,201905,1560,1550,3110,37.558666,126.826614
강서구,1152, 마곡역교차로,201906,1733,1712,3445,37.558666,126.826614
강서구,1152, 마곡역교차로,201907,1792,1766,3558,37.558666,126.826614
강서구,1152, 마곡역교차로,201908,1738,1716,3454,37.558666,126.826614
강서구,1152, 마곡역교차로,201909,1610,1586,3196,37.558666,126.826614
강서구,1152, 마곡역교차로,201910,2113,2107,4220,37.558666,126.826614
강서구,1152, 마곡역교차로,201911,1616,1657,3273,37.558666,126.826614
강서구,1152, 마곡역교차로,201912,724,756,1480,37.558666,126.826614
강서구,1152, 마곡역교차로,202001,1016,1014,2030,37.558666,126.826614
강서구,1152, 마곡역교차로,202002,960,983,1943,37.558666,126.826614
강서구,1152, 마곡역교차로,202003,1362,1378,2740,37.558666,126.826614
강서구,1152, 마곡역교차로,202004,2017,1998,4015,37.558666,126.826614
강서구,1152, 마곡역교차로,202005,2699,2745,5444,37.558666,126.826614
강서구,1152, 마곡역교차로,202006,3762,3968,7730,37.558666,126.826614
강서구,1153," 발산역 1번, 9번 인근 대여소",201901,827,877,1704,37.55891,126.838097
강서구,1153," 발산역 1번, 9번 인근 대여소",201902,835,874,1709,37.55891,126.838097
강서구,1153," 발산역 1번, 9번 인근 대여소",201903,1647,1661,3308,37.55891,126.838097
강서구,1153," 발산역 1번, 9번 인근 대여소",201904,2406,2445,4851,37.55891,126.838097
강서구,1153," 발산역 1번, 9번 인근 대여소",201905,4380,4449,8829,37.55891,126.838097
강서구,1153," 발산역 1번, 9번 인근 대여소",201906,5591,5654,11245,37.55891,126.838097
강서구,1153," 발산역 1번, 9번 인근 대여소",201907,5058,5034,10092,37.55891,126.838097
강서구,1153," 발산역 1번, 9번 인근 대여소",201908,4856,4875,9731,37.55891,126.838097
강서구,1153," 발산역 1번, 9번 인근 대여소",201909,4866,4929,9795,37.55891,126.838097
강서구,1153," 발산역 1번, 9번 인근 대여소",201910,5885,5926,11811,37.55891,126.838097
강서구,1153," 발산역 1번, 9번 인근 대여소",201911,3970,4077,8047,37.55891,126.838097
강서구,1153," 발산역 1번, 9번 인근 대여소",201912,2319,2466,4785,37.55891,126.838097
강서구,1153," 발산역 1번, 9번 인근 대여소",202001,2152,2306,4458,37.55891,126.838097
강서구,1153," 발산역 1번, 9번 인근 대여소",202002,1959,1993,3952,37.55891,126.838097
강서구,1153," 발산역 1번, 9번 인근 대여소",202003,3227,3279,6506,37.55891,126.838097
강서구,1153," 발산역 1번, 9번 인근 대여소",202004,4794,4820,9614,37.55891,126.838097
강서구,1153," 발산역 1번, 9번 인근 대여소",202005,6299,6381,12680,37.55891,126.838097
강서구,1153," 발산역 1번, 9번 인근 대여소",202006,7183,6941,14124,37.55891,126.838097
강서구,1155, 기쁜우리복지관,201901,291,287,578,37.56926,126.848419
강서구,1155, 기쁜우리복지관,201902,326,325,651,37.56926,126.848419
강서구,1155, 기쁜우리복지관,201903,559,586,1145,37.56926,126.848419
강서구,1155, 기쁜우리복지관,201904,1081,1231,2312,37.56926,126.848419
강서구,1155, 기쁜우리복지관,201905,1895,2291,4186,37.56926,126.848419
강서구,1155, 기쁜우리복지관,201906,2357,2632,4989,37.56926,126.848419
강서구,1155, 기쁜우리복지관,201907,1997,2273,4270,37.56926,126.848419
강서구,1155, 기쁜우리복지관,201908,2153,2403,4556,37.56926,126.848419
강서구,1155, 기쁜우리복지관,201909,2041,2162,4203,37.56926,126.848419
강서구,1155, 기쁜우리복지관,201910,2146,2273,4419,37.56926,126.848419
강서구,1155, 기쁜우리복지관,201911,1098,1144,2242,37.56926,126.848419
강서구,1155, 기쁜우리복지관,201912,678,702,1380,37.56926,126.848419
강서구,1155, 기쁜우리복지관,202001,634,716,1350,37.56926,126.848419
강서구,1155, 기쁜우리복지관,202002,627,665,1292,37.56926,126.848419
강서구,1155, 기쁜우리복지관,202003,1498,1571,3069,37.56926,126.848419
강서구,1155, 기쁜우리복지관,202004,2565,2669,5234,37.56926,126.848419
강서구,1155, 기쁜우리복지관,202005,2965,3059,6024,37.56926,126.848419
강서구,1155, 기쁜우리복지관,202006,2795,2930,5725,37.56926,126.848419
강서구,1157, 강서구청,201901,277,349,626,37.550659,126.84977
강서구,1157, 강서구청,201902,267,353,620,37.550659,126.84977
강서구,1157, 강서구청,201903,567,721,1288,37.550659,126.84977
강서구,1157, 강서구청,201904,1006,1230,2236,37.550659,126.84977
강서구,1157, 강서구청,201905,1820,2179,3999,37.550659,126.84977
강서구,1157, 강서구청,201906,1926,2362,4288,37.550659,126.84977
강서구,1157, 강서구청,201907,1898,2251,4149,37.550659,126.84977
강서구,1157, 강서구청,201908,1880,2273,4153,37.550659,126.84977
강서구,1157, 강서구청,201909,1617,1926,3543,37.550659,126.84977
강서구,1157, 강서구청,201910,2131,2509,4640,37.550659,126.84977
강서구,1157, 강서구청,201911,1388,1687,3075,37.550659,126.84977
강서구,1157, 강서구청,201912,781,967,1748,37.550659,126.84977
강서구,1157, 강서구청,202001,674,822,1496,37.550659,126.84977
강서구,1157, 강서구청,202002,707,905,1612,37.550659,126.84977
강서구,1157, 강서구청,202003,1286,1495,2781,37.550659,126.84977
강서구,1157, 강서구청,202004,2003,2257,4260,37.550659,126.84977
강서구,1157, 강서구청,202005,2688,3121,5809,37.550659,126.84977
강서구,1157, 강서구청,202006,3254,3824,7078,37.550659,126.84977
강서구,1158, 가양역 8번출구,201901,823,802,1625,37.561035,126.854813
강서구,1158, 가양역 8번출구,201902,812,772,1584,37.561035,126.854813
강서구,1158, 가양역 8번출구,201903,1604,1651,3255,37.561035,126.854813
강서구,1158, 가양역 8번출구,201904,2836,2772,5608,37.561035,126.854813
강서구,1158, 가양역 8번출구,201905,5012,4993,10005,37.561035,126.854813
강서구,1158, 가양역 8번출구,201906,5599,5615,11214,37.561035,126.854813
강서구,1158, 가양역 8번출구,201907,5176,5100,10276,37.561035,126.854813
강서구,1158, 가양역 8번출구,201908,4899,4845,9744,37.561035,126.854813
강서구,1158, 가양역 8번출구,201909,4837,4842,9679,37.561035,126.854813
강서구,1158, 가양역 8번출구,201910,5573,5540,11113,37.561035,126.854813
강서구,1158, 가양역 8번출구,201911,3401,3428,6829,37.561035,126.854813
강서구,1158, 가양역 8번출구,201912,1791,1833,3624,37.561035,126.854813
강서구,1158, 가양역 8번출구,202001,1566,1576,3142,37.561035,126.854813
강서구,1158, 가양역 8번출구,202002,1575,1589,3164,37.561035,126.854813
강서구,1158, 가양역 8번출구,202003,3138,3067,6205,37.561035,126.854813
강서구,1158, 가양역 8번출구,202004,4870,4861,9731,37.561035,126.854813
강서구,1158, 가양역 8번출구,202005,6072,6100,12172,37.561035,126.854813
강서구,1158, 가양역 8번출구,202006,6773,6789,13562,37.561035,126.854813
강서구,1159, 서서울모터리움앞,201901,257,296,553,37.565853,126.846596
강서구,1159, 서서울모터리움앞,201902,262,259,521,37.565853,126.846596
강서구,1159, 서서울모터리움앞,201903,507,481,988,37.565853,126.846596
강서구,1159, 서서울모터리움앞,201904,878,884,1762,37.565853,126.846596
강서구,1159, 서서울모터리움앞,201905,1392,1436,2828,37.565853,126.846596
강서구,1159, 서서울모터리움앞,201906,1745,1763,3508,37.565853,126.846596
강서구,1159, 서서울모터리움앞,201907,1584,1616,3200,37.565853,126.846596
강서구,1159, 서서울모터리움앞,201908,1533,1542,3075,37.565853,126.846596
강서구,1159, 서서울모터리움앞,201909,1502,1561,3063,37.565853,126.846596
강서구,1159, 서서울모터리움앞,201910,1782,1794,3576,37.565853,126.846596
강서구,1159, 서서울모터리움앞,201911,1105,1197,2302,37.565853,126.846596
강서구,1159, 서서울모터리움앞,201912,601,649,1250,37.565853,126.846596
강서구,1159, 서서울모터리움앞,202001,607,606,1213,37.565853,126.846596
강서구,1159, 서서울모터리움앞,202002,618,640,1258,37.565853,126.846596
강서구,1159, 서서울모터리움앞,202003,1182,1159,2341,37.565853,126.846596
강서구,1159, 서서울모터리움앞,202004,1791,1775,3566,37.565853,126.846596
강서구,1159, 서서울모터리움앞,202005,2355,2280,4635,37.565853,126.846596
강서구,1159, 서서울모터리움앞,202006,2747,2718,5465,37.565853,126.846596
강서구,1160, 양천향교역 7번출구앞,201901,722,712,1434,37.56768,126.840897
강서구,1160, 양천향교역 7번출구앞,201902,722,725,1447,37.56768,126.840897
강서구,1160, 양천향교역 7번출구앞,201903,1535,1576,3111,37.56768,126.840897
강서구,1160, 양천향교역 7번출구앞,201904,3049,2965,6014,37.56768,126.840897
강서구,1160, 양천향교역 7번출구앞,201905,5430,5451,10881,37.56768,126.840897
강서구,1160, 양천향교역 7번출구앞,201906,6310,6220,12530,37.56768,126.840897
강서구,1160, 양천향교역 7번출구앞,201907,5539,5344,10883,37.56768,126.840897
강서구,1160, 양천향교역 7번출구앞,201908,5536,5476,11012,37.56768,126.840897
강서구,1160, 양천향교역 7번출구앞,201909,5516,5510,11026,37.56768,126.840897
강서구,1160, 양천향교역 7번출구앞,201910,5869,5769,11638,37.56768,126.840897
강서구,1160, 양천향교역 7번출구앞,201911,3337,3300,6637,37.56768,126.840897
강서구,1160, 양천향교역 7번출구앞,201912,1853,1760,3613,37.56768,126.840897
강서구,1160, 양천향교역 7번출구앞,202001,1894,1773,3667,37.56768,126.840897
강서구,1160, 양천향교역 7번출구앞,202002,1899,1811,3710,37.56768,126.840897
강서구,1160, 양천향교역 7번출구앞,202003,3347,3287,6634,37.56768,126.840897
강서구,1160, 양천향교역 7번출구앞,202004,5169,5094,10263,37.56768,126.840897
강서구,1160, 양천향교역 7번출구앞,202005,6918,6863,13781,37.56768,126.840897
강서구,1160, 양천향교역 7번출구앞,202006,7875,7607,15482,37.56768,126.840897
강서구,1161, 강서면허시험장앞,201901,103,78,181,37.549694,126.819664
강서구,1161, 강서면허시험장앞,201902,96,89,185,37.549694,126.819664
강서구,1161, 강서면허시험장앞,201903,211,201,412,37.549694,126.819664
강서구,1161, 강서면허시험장앞,201904,229,231,460,37.549694,126.819664
강서구,1161, 강서면허시험장앞,201905,334,320,654,37.549694,126.819664
강서구,1161, 강서면허시험장앞,201906,389,368,757,37.549694,126.819664
강서구,1161, 강서면허시험장앞,201907,361,355,716,37.549694,126.819664
강서구,1161, 강서면허시험장앞,201908,398,349,747,37.549694,126.819664
강서구,1161, 강서면허시험장앞,201909,347,348,695,37.549694,126.819664
강서구,1161, 강서면허시험장앞,201910,468,434,902,37.549694,126.819664
강서구,1161, 강서면허시험장앞,201911,308,289,597,37.549694,126.819664
강서구,1161, 강서면허시험장앞,201912,223,201,424,37.549694,126.819664
강서구,1161, 강서면허시험장앞,202001,155,141,296,37.549694,126.819664
강서구,1161, 강서면허시험장앞,202002,183,168,351,37.549694,126.819664
강서구,1161, 강서면허시험장앞,202003,244,225,469,37.549694,126.819664
강서구,1161, 강서면허시험장앞,202004,355,274,629,37.549694,126.819664
강서구,1161, 강서면허시험장앞,202005,542,482,1024,37.549694,126.819664
강서구,1161, 강서면허시험장앞,202006,524,479,1003,37.549694,126.819664
강서구,1162, 공항초등학교건너편,201901,384,357,741,37.562679,126.820473
강서구,1162, 공항초등학교건너편,201902,336,297,633,37.562679,126.820473
강서구,1162, 공항초등학교건너편,201903,616,533,1149,37.562679,126.820473
강서구,1162, 공항초등학교건너편,201904,751,671,1422,37.562679,126.820473
강서구,1162, 공항초등학교건너편,201905,1046,1002,2048,37.562679,126.820473
강서구,1162, 공항초등학교건너편,201906,1209,1182,2391,37.562679,126.820473
강서구,1162, 공항초등학교건너편,201907,1410,1370,2780,37.562679,126.820473
강서구,1162, 공항초등학교건너편,201908,1352,1332,2684,37.562679,126.820473
강서구,1162, 공항초등학교건너편,201909,1226,1222,2448,37.562679,126.820473
강서구,1162, 공항초등학교건너편,201910,1437,1445,2882,37.562679,126.820473
강서구,1162, 공항초등학교건너편,201911,1140,1094,2234,37.562679,126.820473
강서구,1162, 공항초등학교건너편,201912,785,774,1559,37.562679,126.820473
강서구,1162, 공항초등학교건너편,202001,775,771,1546,37.562679,126.820473
강서구,1162, 공항초등학교건너편,202002,683,664,1347,37.562679,126.820473
강서구,1162, 공항초등학교건너편,202003,791,739,1530,37.562679,126.820473
강서구,1162, 공항초등학교건너편,202004,1169,1136,2305,37.562679,126.820473
강서구,1162, 공항초등학교건너편,202005,1584,1542,3126,37.562679,126.820473
강서구,1162, 공항초등학교건너편,202006,1909,1897,3806,37.562679,126.820473
강서구,1163, 방화동강서기동대앞,201901,247,221,468,37.570499,126.820084
강서구,1163, 방화동강서기동대앞,201902,225,206,431,37.570499,126.820084
강서구,1163, 방화동강서기동대앞,201903,308,312,620,37.570499,126.820084
강서구,1163, 방화동강서기동대앞,201904,450,456,906,37.570499,126.820084
강서구,1163, 방화동강서기동대앞,201905,782,793,1575,37.570499,126.820084
강서구,1163, 방화동강서기동대앞,201906,1052,1109,2161,37.570499,126.820084
강서구,1163, 방화동강서기동대앞,201907,1083,1105,2188,37.570499,126.820084
강서구,1163, 방화동강서기동대앞,201908,1042,1047,2089,37.570499,126.820084
강서구,1163, 방화동강서기동대앞,201909,1156,1152,2308,37.570499,126.820084
강서구,1163, 방화동강서기동대앞,201910,1262,1291,2553,37.570499,126.820084
강서구,1163, 방화동강서기동대앞,201911,867,905,1772,37.570499,126.820084
강서구,1163, 방화동강서기동대앞,201912,611,664,1275,37.570499,126.820084
강서구,1163, 방화동강서기동대앞,202001,563,638,1201,37.570499,126.820084
강서구,1163, 방화동강서기동대앞,202002,586,616,1202,37.570499,126.820084
강서구,1163, 방화동강서기동대앞,202003,735,760,1495,37.570499,126.820084
강서구,1163, 방화동강서기동대앞,202004,918,931,1849,37.570499,126.820084
강서구,1163, 방화동강서기동대앞,202005,1173,1175,2348,37.570499,126.820084
강서구,1163, 방화동강서기동대앞,202006,1414,1466,2880,37.570499,126.820084
강서구,1165, 마곡중학교 후문,201901,164,130,294,37.568447,126.821648
강서구,1165, 마곡중학교 후문,201902,125,98,223,37.568447,126.821648
강서구,1165, 마곡중학교 후문,201903,293,228,521,37.568447,126.821648
강서구,1165, 마곡중학교 후문,201904,359,250,609,37.568447,126.821648
강서구,1165, 마곡중학교 후문,201905,632,439,1071,37.568447,126.821648
강서구,1165, 마곡중학교 후문,201906,791,526,1317,37.568447,126.821648
강서구,1165, 마곡중학교 후문,201907,825,507,1332,37.568447,126.821648
강서구,1165, 마곡중학교 후문,201908,697,470,1167,37.568447,126.821648
강서구,1165, 마곡중학교 후문,201909,861,578,1439,37.568447,126.821648
강서구,1165, 마곡중학교 후문,201910,904,563,1467,37.568447,126.821648
강서구,1165, 마곡중학교 후문,201911,619,347,966,37.568447,126.821648
강서구,1165, 마곡중학교 후문,201912,453,274,727,37.568447,126.821648
강서구,1165, 마곡중학교 후문,202001,398,262,660,37.568447,126.821648
강서구,1165, 마곡중학교 후문,202002,391,263,654,37.568447,126.821648
강서구,1165, 마곡중학교 후문,202003,546,322,868,37.568447,126.821648
강서구,1165, 마곡중학교 후문,202004,847,496,1343,37.568447,126.821648
강서구,1165, 마곡중학교 후문,202005,994,635,1629,37.568447,126.821648
강서구,1165, 마곡중학교 후문,202006,1039,752,1791,37.568447,126.821648
강서구,1166, 강서구립등빛도서관,201901,587,629,1216,37.562569,126.842461
강서구,1166, 강서구립등빛도서관,201902,531,560,1091,37.562569,126.842461
강서구,1166, 강서구립등빛도서관,201903,1047,1062,2109,37.562569,126.842461
강서구,1166, 강서구립등빛도서관,201904,1712,1755,3467,37.562569,126.842461
강서구,1166, 강서구립등빛도서관,201905,2789,2858,5647,37.562569,126.842461
강서구,1166, 강서구립등빛도서관,201906,3260,3280,6540,37.562569,126.842461
강서구,1166, 강서구립등빛도서관,201907,3304,3327,6631,37.562569,126.842461
강서구,1166, 강서구립등빛도서관,201908,2999,3025,6024,37.562569,126.842461
강서구,1166, 강서구립등빛도서관,201909,2891,2858,5749,37.562569,126.842461
강서구,1166, 강서구립등빛도서관,201910,3416,3413,6829,37.562569,126.842461
강서구,1166, 강서구립등빛도서관,201911,2310,2365,4675,37.562569,126.842461
강서구,1166, 강서구립등빛도서관,201912,1348,1375,2723,37.562569,126.842461
강서구,1166, 강서구립등빛도서관,202001,1268,1324,2592,37.562569,126.842461
강서구,1166, 강서구립등빛도서관,202002,1092,1114,2206,37.562569,126.842461
강서구,1166, 강서구립등빛도서관,202003,1572,1577,3149,37.562569,126.842461
강서구,1166, 강서구립등빛도서관,202004,2460,2462,4922,37.562569,126.842461
강서구,1166, 강서구립등빛도서관,202005,3104,3096,6200,37.562569,126.842461
강서구,1166, 강서구립등빛도서관,202006,3648,3647,7295,37.562569,126.842461
강서구,1167, 마곡수명산파크3단지 교차로,201901,694,656,1350,37.553467,126.825928
강서구,1167, 마곡수명산파크3단지 교차로,201902,545,541,1086,37.553467,126.825928
강서구,1167, 마곡수명산파크3단지 교차로,201903,1146,1160,2306,37.553467,126.825928
강서구,1167, 마곡수명산파크3단지 교차로,201904,1526,1609,3135,37.553467,126.825928
강서구,1167, 마곡수명산파크3단지 교차로,201905,2398,2457,4855,37.553467,126.825928
강서구,1167, 마곡수명산파크3단지 교차로,201906,2982,3051,6033,37.553467,126.825928
강서구,1167, 마곡수명산파크3단지 교차로,201907,3010,3107,6117,37.553467,126.825928
강서구,1167, 마곡수명산파크3단지 교차로,201908,2720,2823,5543,37.553467,126.825928
강서구,1167, 마곡수명산파크3단지 교차로,201909,2639,2787,5426,37.553467,126.825928
강서구,1167, 마곡수명산파크3단지 교차로,201910,3336,3315,6651,37.553467,126.825928
강서구,1167, 마곡수명산파크3단지 교차로,201911,2192,2266,4458,37.553467,126.825928
강서구,1167, 마곡수명산파크3단지 교차로,201912,1423,1324,2747,37.553467,126.825928
강서구,1167, 마곡수명산파크3단지 교차로,202001,1220,1170,2390,37.553467,126.825928
강서구,1167, 마곡수명산파크3단지 교차로,202002,1037,1041,2078,37.553467,126.825928
강서구,1167, 마곡수명산파크3단지 교차로,202003,1719,1702,3421,37.553467,126.825928
강서구,1167, 마곡수명산파크3단지 교차로,202004,2631,2587,5218,37.553467,126.825928
강서구,1167, 마곡수명산파크3단지 교차로,202005,3268,3213,6481,37.553467,126.825928
강서구,1167, 마곡수명산파크3단지 교차로,202006,3493,3474,6967,37.553467,126.825928
강서구,1168, 마곡엠밸리10단지 앞,201901,260,251,511,37.560226,126.819069
강서구,1168, 마곡엠밸리10단지 앞,201902,273,264,537,37.560226,126.819069
강서구,1168, 마곡엠밸리10단지 앞,201903,522,475,997,37.560226,126.819069
강서구,1168, 마곡엠밸리10단지 앞,201904,710,695,1405,37.560226,126.819069
강서구,1168, 마곡엠밸리10단지 앞,201905,1110,1103,2213,37.560226,126.819069
강서구,1168, 마곡엠밸리10단지 앞,201906,1402,1376,2778,37.560226,126.819069
강서구,1168, 마곡엠밸리10단지 앞,201907,1555,1580,3135,37.560226,126.819069
강서구,1168, 마곡엠밸리10단지 앞,201908,1489,1481,2970,37.560226,126.819069
강서구,1168, 마곡엠밸리10단지 앞,201909,1377,1377,2754,37.560226,126.819069
강서구,1168, 마곡엠밸리10단지 앞,201910,1713,1718,3431,37.560226,126.819069
강서구,1168, 마곡엠밸리10단지 앞,201911,1197,1187,2384,37.560226,126.819069
강서구,1168, 마곡엠밸리10단지 앞,201912,767,774,1541,37.560226,126.819069
강서구,1168, 마곡엠밸리10단지 앞,202001,684,644,1328,37.560226,126.819069
강서구,1168, 마곡엠밸리10단지 앞,202002,669,693,1362,37.560226,126.819069
강서구,1168, 마곡엠밸리10단지 앞,202003,977,969,1946,37.560226,126.819069
강서구,1168, 마곡엠밸리10단지 앞,202004,1281,1301,2582,37.560226,126.819069
강서구,1168, 마곡엠밸리10단지 앞,202005,1500,1479,2979,37.560226,126.819069
강서구,1168, 마곡엠밸리10단지 앞,202006,1409,1417,2826,37.560226,126.819069
강서구,1169, 염창역 1번 출구,201901,227,225,452,37.547199,126.874489
강서구,1169, 염창역 1번 출구,201902,205,194,399,37.547199,126.874489
강서구,1169, 염창역 1번 출구,201903,422,393,815,37.547199,126.874489
강서구,1169, 염창역 1번 출구,201904,901,874,1775,37.547199,126.874489
강서구,1169, 염창역 1번 출구,201905,1565,1658,3223,37.547199,126.874489
강서구,1169, 염창역 1번 출구,201906,2002,2059,4061,37.547199,126.874489
강서구,1169, 염창역 1번 출구,201907,1791,1871,3662,37.547199,126.874489
강서구,1169, 염창역 1번 출구,201908,1763,1806,3569,37.547199,126.874489
강서구,1169, 염창역 1번 출구,201909,1716,1735,3451,37.547199,126.874489
강서구,1169, 염창역 1번 출구,201910,2005,2009,4014,37.547199,126.874489
강서구,1169, 염창역 1번 출구,201911,1085,1082,2167,37.547199,126.874489
강서구,1169, 염창역 1번 출구,201912,566,565,1131,37.547199,126.874489
강서구,1169, 염창역 1번 출구,202001,582,561,1143,37.547199,126.874489
강서구,1169, 염창역 1번 출구,202002,532,553,1085,37.547199,126.874489
강서구,1169, 염창역 1번 출구,202003,1336,1362,2698,37.547199,126.874489
강서구,1169, 염창역 1번 출구,202004,2117,2111,4228,37.547199,126.874489
강서구,1169, 염창역 1번 출구,202005,2581,2606,5187,37.547199,126.874489
강서구,1169, 염창역 1번 출구,202006,2403,2472,4875,37.547199,126.874489
강서구,1170, 강서구보건소 (삼성디지털 프라자),201901,93,61,154,37.549179,126.868797
강서구,1170, 강서구보건소 (삼성디지털 프라자),201902,135,75,210,37.549179,126.868797
강서구,1170, 강서구보건소 (삼성디지털 프라자),201903,323,209,532,37.549179,126.868797
강서구,1170, 강서구보건소 (삼성디지털 프라자),201904,470,381,851,37.549179,126.868797
강서구,1170, 강서구보건소 (삼성디지털 프라자),201905,948,810,1758,37.549179,126.868797
강서구,1170, 강서구보건소 (삼성디지털 프라자),201906,1162,921,2083,37.549179,126.868797
강서구,1170, 강서구보건소 (삼성디지털 프라자),201907,1185,1024,2209,37.549179,126.868797
강서구,1170, 강서구보건소 (삼성디지털 프라자),201908,1160,1000,2160,37.549179,126.868797
강서구,1170, 강서구보건소 (삼성디지털 프라자),201909,1097,1000,2097,37.549179,126.868797
강서구,1170, 강서구보건소 (삼성디지털 프라자),201910,1249,1084,2333,37.549179,126.868797
강서구,1170, 강서구보건소 (삼성디지털 프라자),201911,803,619,1422,37.549179,126.868797
강서구,1170, 강서구보건소 (삼성디지털 프라자),201912,467,341,808,37.549179,126.868797
강서구,1170, 강서구보건소 (삼성디지털 프라자),202001,396,277,673,37.549179,126.868797
강서구,1170, 강서구보건소 (삼성디지털 프라자),202002,412,320,732,37.549179,126.868797
강서구,1170, 강서구보건소 (삼성디지털 프라자),202003,916,722,1638,37.549179,126.868797
강서구,1170, 강서구보건소 (삼성디지털 프라자),202004,1445,1028,2473,37.549179,126.868797
강서구,1170, 강서구보건소 (삼성디지털 프라자),202005,1847,1442,3289,37.549179,126.868797
강서구,1170, 강서구보건소 (삼성디지털 프라자),202006,1778,1423,3201,37.549179,126.868797
강서구,1171, 염창동 새마을금고 건너편 (모닝글로리),201901,220,252,472,37.550049,126.873161
강서구,1171, 염창동 새마을금고 건너편 (모닝글로리),201902,210,249,459,37.550049,126.873161
강서구,1171, 염창동 새마을금고 건너편 (모닝글로리),201903,404,463,867,37.550049,126.873161
강서구,1171, 염창동 새마을금고 건너편 (모닝글로리),201904,717,867,1584,37.550049,126.873161
강서구,1171, 염창동 새마을금고 건너편 (모닝글로리),201905,1300,1440,2740,37.550049,126.873161
강서구,1171, 염창동 새마을금고 건너편 (모닝글로리),201906,1641,1893,3534,37.550049,126.873161
강서구,1171, 염창동 새마을금고 건너편 (모닝글로리),201907,1572,1872,3444,37.550049,126.873161
강서구,1171, 염창동 새마을금고 건너편 (모닝글로리),201908,1595,1876,3471,37.550049,126.873161
강서구,1171, 염창동 새마을금고 건너편 (모닝글로리),201909,1693,1902,3595,37.550049,126.873161
강서구,1171, 염창동 새마을금고 건너편 (모닝글로리),201910,2021,2167,4188,37.550049,126.873161
강서구,1171, 염창동 새마을금고 건너편 (모닝글로리),201911,1090,1198,2288,37.550049,126.873161
강서구,1171, 염창동 새마을금고 건너편 (모닝글로리),201912,626,638,1264,37.550049,126.873161
강서구,1171, 염창동 새마을금고 건너편 (모닝글로리),202001,534,533,1067,37.550049,126.873161
강서구,1171, 염창동 새마을금고 건너편 (모닝글로리),202002,479,525,1004,37.550049,126.873161
강서구,1171, 염창동 새마을금고 건너편 (모닝글로리),202003,1402,1497,2899,37.550049,126.873161
강서구,1171, 염창동 새마을금고 건너편 (모닝글로리),202004,2074,2365,4439,37.550049,126.873161
강서구,1171, 염창동 새마을금고 건너편 (모닝글로리),202005,2451,2694,5145,37.550049,126.873161
강서구,1171, 염창동 새마을금고 건너편 (모닝글로리),202006,2333,2866,5199,37.550049,126.873161
강서구,1172, 가양3동 주민센터,201901,142,166,308,37.561249,126.86058
강서구,1172, 가양3동 주민센터,201902,169,213,382,37.561249,126.86058
강서구,1172, 가양3동 주민센터,201903,372,398,770,37.561249,126.86058
강서구,1172, 가양3동 주민센터,201904,607,716,1323,37.561249,126.86058
강서구,1172, 가양3동 주민센터,201905,1123,1210,2333,37.561249,126.86058
강서구,1172, 가양3동 주민센터,201906,1326,1387,2713,37.561249,126.86058
강서구,1172, 가양3동 주민센터,201907,1216,1303,2519,37.561249,126.86058
강서구,1172, 가양3동 주민센터,201908,1292,1425,2717,37.561249,126.86058
강서구,1172, 가양3동 주민센터,201909,1287,1376,2663,37.561249,126.86058
강서구,1172, 가양3동 주민센터,201910,1446,1673,3119,37.561249,126.86058
강서구,1172, 가양3동 주민센터,201911,919,1092,2011,37.561249,126.86058
강서구,1172, 가양3동 주민센터,201912,610,721,1331,37.561249,126.86058
강서구,1172, 가양3동 주민센터,202001,521,631,1152,37.561249,126.86058
강서구,1172, 가양3동 주민센터,202002,493,644,1137,37.561249,126.86058
강서구,1172, 가양3동 주민센터,202003,952,1083,2035,37.561249,126.86058
강서구,1172, 가양3동 주민센터,202004,1342,1468,2810,37.561249,126.86058
강서구,1172, 가양3동 주민센터,202005,1682,1845,3527,37.561249,126.86058
강서구,1172, 가양3동 주민센터,202006,1796,2034,3830,37.561249,126.86058
강서구,1173, 강서구청사거리(SH타워),201901,338,346,684,37.556259,126.853317
강서구,1173, 강서구청사거리(SH타워),201902,345,345,690,37.556259,126.853317
강서구,1173, 강서구청사거리(SH타워),201903,831,870,1701,37.556259,126.853317
강서구,1173, 강서구청사거리(SH타워),201904,1479,1553,3032,37.556259,126.853317
강서구,1173, 강서구청사거리(SH타워),201905,2795,2726,5521,37.556259,126.853317
강서구,1173, 강서구청사거리(SH타워),201906,3005,2892,5897,37.556259,126.853317
강서구,1173, 강서구청사거리(SH타워),201907,2771,2761,5532,37.556259,126.853317
강서구,1173, 강서구청사거리(SH타워),201908,2961,3013,5974,37.556259,126.853317
강서구,1173, 강서구청사거리(SH타워),201909,2839,2845,5684,37.556259,126.853317
강서구,1173, 강서구청사거리(SH타워),201910,3581,3600,7181,37.556259,126.853317
강서구,1173, 강서구청사거리(SH타워),201911,2222,2227,4449,37.556259,126.853317
강서구,1173, 강서구청사거리(SH타워),201912,1180,1202,2382,37.556259,126.853317
강서구,1173, 강서구청사거리(SH타워),202001,990,980,1970,37.556259,126.853317
강서구,1173, 강서구청사거리(SH타워),202002,1045,1018,2063,37.556259,126.853317
강서구,1173, 강서구청사거리(SH타워),202003,2166,2163,4329,37.556259,126.853317
강서구,1173, 강서구청사거리(SH타워),202004,3401,3356,6757,37.556259,126.853317
강서구,1173, 강서구청사거리(SH타워),202005,4259,4162,8421,37.556259,126.853317
강서구,1173, 강서구청사거리(SH타워),202006,4711,4619,9330,37.556259,126.853317
강서구,1174, 강서구청사거리(부민병원),201901,196,203,399,37.556599,126.851471
강서구,1174, 강서구청사거리(부민병원),201902,161,167,328,37.556599,126.851471
강서구,1174, 강서구청사거리(부민병원),201903,359,387,746,37.556599,126.851471
강서구,1174, 강서구청사거리(부민병원),201904,631,592,1223,37.556599,126.851471
강서구,1174, 강서구청사거리(부민병원),201905,1001,995,1996,37.556599,126.851471
강서구,1174, 강서구청사거리(부민병원),201906,1066,1051,2117,37.556599,126.851471
강서구,1174, 강서구청사거리(부민병원),201907,1081,1088,2169,37.556599,126.851471
강서구,1174, 강서구청사거리(부민병원),201908,975,989,1964,37.556599,126.851471
강서구,1174, 강서구청사거리(부민병원),201909,989,992,1981,37.556599,126.851471
강서구,1174, 강서구청사거리(부민병원),201910,1133,1135,2268,37.556599,126.851471
강서구,1174, 강서구청사거리(부민병원),201911,781,784,1565,37.556599,126.851471
강서구,1174, 강서구청사거리(부민병원),201912,486,480,966,37.556599,126.851471
강서구,1174, 강서구청사거리(부민병원),202001,396,387,783,37.556599,126.851471
강서구,1174, 강서구청사거리(부민병원),202002,401,388,789,37.556599,126.851471
강서구,1174, 강서구청사거리(부민병원),202003,602,583,1185,37.556599,126.851471
강서구,1174, 강서구청사거리(부민병원),202004,964,961,1925,37.556599,126.851471
강서구,1174, 강서구청사거리(부민병원),202005,1129,1129,2258,37.556599,126.851471
강서구,1174, 강서구청사거리(부민병원),202006,1477,1431,2908,37.556599,126.851471
강서구,1175, 대한항공 인력개발센터,201901,200,159,359,37.554379,126.857536
강서구,1175, 대한항공 인력개발센터,201902,171,178,349,37.554379,126.857536
강서구,1175, 대한항공 인력개발센터,201903,339,337,676,37.554379,126.857536
강서구,1175, 대한항공 인력개발센터,201904,496,439,935,37.554379,126.857536
강서구,1175, 대한항공 인력개발센터,201905,855,771,1626,37.554379,126.857536
강서구,1175, 대한항공 인력개발센터,201906,994,785,1779,37.554379,126.857536
강서구,1175, 대한항공 인력개발센터,201907,818,684,1502,37.554379,126.857536
강서구,1175, 대한항공 인력개발센터,201908,887,741,1628,37.554379,126.857536
강서구,1175, 대한항공 인력개발센터,201909,877,720,1597,37.554379,126.857536
강서구,1175, 대한항공 인력개발센터,201910,1086,940,2026,37.554379,126.857536
강서구,1175, 대한항공 인력개발센터,201911,726,548,1274,37.554379,126.857536
강서구,1175, 대한항공 인력개발센터,201912,394,326,720,37.554379,126.857536
강서구,1175, 대한항공 인력개발센터,202001,402,330,732,37.554379,126.857536
강서구,1175, 대한항공 인력개발센터,202002,417,322,739,37.554379,126.857536
강서구,1175, 대한항공 인력개발센터,202003,878,649,1527,37.554379,126.857536
강서구,1175, 대한항공 인력개발센터,202004,1268,959,2227,37.554379,126.857536
강서구,1175, 대한항공 인력개발센터,202005,1416,1126,2542,37.554379,126.857536
강서구,1175, 대한항공 인력개발센터,202006,1710,1286,2996,37.554379,126.857536
강서구,1177, 수명중?고교,201901,165,165,330,37.55011,126.823677
강서구,1177, 수명중?고교,201902,155,190,345,37.55011,126.823677
강서구,1177, 수명중?고교,201903,375,408,783,37.55011,126.823677
강서구,1177, 수명중?고교,201904,551,576,1127,37.55011,126.823677
강서구,1177, 수명중?고교,201905,983,1065,2048,37.55011,126.823677
강서구,1177, 수명중?고교,201906,1145,1222,2367,37.55011,126.823677
강서구,1177, 수명중?고교,201907,1177,1297,2474,37.55011,126.823677
강서구,1177, 수명중?고교,201908,1163,1294,2457,37.55011,126.823677
강서구,1177, 수명중?고교,201909,1303,1339,2642,37.55011,126.823677
강서구,1177, 수명중?고교,201910,1561,1626,3187,37.55011,126.823677
강서구,1177, 수명중?고교,201911,1130,1219,2349,37.55011,126.823677
강서구,1177, 수명중?고교,201912,585,646,1231,37.55011,126.823677
강서구,1177, 수명중?고교,202001,599,631,1230,37.55011,126.823677
강서구,1177, 수명중?고교,202002,611,651,1262,37.55011,126.823677
강서구,1177, 수명중?고교,202003,919,936,1855,37.55011,126.823677
강서구,1177, 수명중?고교,202004,1350,1412,2762,37.55011,126.823677
강서구,1177, 수명중?고교,202005,1773,1803,3576,37.55011,126.823677
강서구,1177, 수명중?고교,202006,1922,2046,3968,37.55011,126.823677
강서구,1178, 개화산역 2번 출구,201901,149,130,279,37.572472,126.806168
강서구,1178, 개화산역 2번 출구,201902,130,113,243,37.572472,126.806168
강서구,1178, 개화산역 2번 출구,201903,249,266,515,37.572472,126.806168
강서구,1178, 개화산역 2번 출구,201904,487,547,1034,37.572472,126.806168
강서구,1178, 개화산역 2번 출구,201905,829,884,1713,37.572472,126.806168
강서구,1178, 개화산역 2번 출구,201906,1136,1163,2299,37.572472,126.806168
강서구,1178, 개화산역 2번 출구,201907,979,1054,2033,37.572472,126.806168
강서구,1178, 개화산역 2번 출구,201908,962,987,1949,37.572472,126.806168
강서구,1178, 개화산역 2번 출구,201909,830,902,1732,37.572472,126.806168
강서구,1178, 개화산역 2번 출구,201910,1025,1080,2105,37.572472,126.806168
강서구,1178, 개화산역 2번 출구,201911,591,593,1184,37.572472,126.806168
강서구,1178, 개화산역 2번 출구,201912,275,249,524,37.572472,126.806168
강서구,1178, 개화산역 2번 출구,202001,280,291,571,37.572472,126.806168
강서구,1178, 개화산역 2번 출구,202002,267,320,587,37.572472,126.806168
강서구,1178, 개화산역 2번 출구,202003,548,535,1083,37.572472,126.806168
강서구,1178, 개화산역 2번 출구,202004,844,820,1664,37.572472,126.806168
강서구,1178, 개화산역 2번 출구,202005,1060,1093,2153,37.572472,126.806168
강서구,1178, 개화산역 2번 출구,202006,1219,1260,2479,37.572472,126.806168
강서구,1180, 마곡엠밸리 15단지(1502동) 건너편,201901,133,138,271,37.557468,126.82972
강서구,1180, 마곡엠밸리 15단지(1502동) 건너편,201902,138,133,271,37.557468,126.82972
강서구,1180, 마곡엠밸리 15단지(1502동) 건너편,201903,294,269,563,37.557468,126.82972
강서구,1180, 마곡엠밸리 15단지(1502동) 건너편,201904,422,383,805,37.557468,126.82972
강서구,1180, 마곡엠밸리 15단지(1502동) 건너편,201905,769,703,1472,37.557468,126.82972
강서구,1180, 마곡엠밸리 15단지(1502동) 건너편,201906,1205,1072,2277,37.557468,126.82972
강서구,1180, 마곡엠밸리 15단지(1502동) 건너편,201907,1181,1043,2224,37.557468,126.82972
강서구,1180, 마곡엠밸리 15단지(1502동) 건너편,201908,1232,1100,2332,37.557468,126.82972
강서구,1180, 마곡엠밸리 15단지(1502동) 건너편,201909,1129,974,2103,37.557468,126.82972
강서구,1180, 마곡엠밸리 15단지(1502동) 건너편,201910,1460,1381,2841,37.557468,126.82972
강서구,1180, 마곡엠밸리 15단지(1502동) 건너편,201911,878,783,1661,37.557468,126.82972
강서구,1180, 마곡엠밸리 15단지(1502동) 건너편,201912,646,631,1277,37.557468,126.82972
강서구,1180, 마곡엠밸리 15단지(1502동) 건너편,202001,592,574,1166,37.557468,126.82972
강서구,1180, 마곡엠밸리 15단지(1502동) 건너편,202002,620,569,1189,37.557468,126.82972
강서구,1180, 마곡엠밸리 15단지(1502동) 건너편,202003,1180,1133,2313,37.557468,126.82972
강서구,1180, 마곡엠밸리 15단지(1502동) 건너편,202004,1683,1586,3269,37.557468,126.82972
강서구,1180, 마곡엠밸리 15단지(1502동) 건너편,202005,2010,1909,3919,37.557468,126.82972
강서구,1180, 마곡엠밸리 15단지(1502동) 건너편,202006,2222,2153,4375,37.557468,126.82972
강서구,1181, 농수산식품공사 (강서지사),201901,58,62,120,37.551044,126.818497
강서구,1181, 농수산식품공사 (강서지사),201902,35,50,85,37.551044,126.818497
강서구,1181, 농수산식품공사 (강서지사),201903,83,84,167,37.551044,126.818497
강서구,1181, 농수산식품공사 (강서지사),201904,130,130,260,37.551044,126.818497
강서구,1181, 농수산식품공사 (강서지사),201905,177,181,358,37.551044,126.818497
강서구,1181, 농수산식품공사 (강서지사),201906,273,266,539,37.551044,126.818497
강서구,1181, 농수산식품공사 (강서지사),201907,267,294,561,37.551044,126.818497
강서구,1181, 농수산식품공사 (강서지사),201908,287,288,575,37.551044,126.818497
강서구,1181, 농수산식품공사 (강서지사),201909,325,334,659,37.551044,126.818497
강서구,1181, 농수산식품공사 (강서지사),201910,413,419,832,37.551044,126.818497
강서구,1181, 농수산식품공사 (강서지사),201911,360,372,732,37.551044,126.818497
강서구,1181, 농수산식품공사 (강서지사),201912,212,241,453,37.551044,126.818497
강서구,1181, 농수산식품공사 (강서지사),202001,204,229,433,37.551044,126.818497
강서구,1181, 농수산식품공사 (강서지사),202002,201,207,408,37.551044,126.818497
강서구,1181, 농수산식품공사 (강서지사),202003,244,248,492,37.551044,126.818497
강서구,1181, 농수산식품공사 (강서지사),202004,254,251,505,37.551044,126.818497
강서구,1181, 농수산식품공사 (강서지사),202005,354,356,710,37.551044,126.818497
강서구,1181, 농수산식품공사 (강서지사),202006,326,330,656,37.551044,126.818497
강서구,1182, KBS 스포츠월드,201901,227,216,443,37.556877,126.848808
강서구,1182, KBS 스포츠월드,201902,268,238,506,37.556877,126.848808
강서구,1182, KBS 스포츠월드,201903,726,654,1380,37.556877,126.848808
강서구,1182, KBS 스포츠월드,201904,1102,1035,2137,37.556877,126.848808
강서구,1182, KBS 스포츠월드,201905,1795,1726,3521,37.556877,126.848808
강서구,1182, KBS 스포츠월드,201906,2154,2064,4218,37.556877,126.848808
강서구,1182, KBS 스포츠월드,201907,2367,2315,4682,37.556877,126.848808
강서구,1182, KBS 스포츠월드,201908,2336,2313,4649,37.556877,126.848808
강서구,1182, KBS 스포츠월드,201909,2101,2105,4206,37.556877,126.848808
강서구,1182, KBS 스포츠월드,201910,2467,2467,4934,37.556877,126.848808
강서구,1182, KBS 스포츠월드,201911,1797,1788,3585,37.556877,126.848808
강서구,1182, KBS 스포츠월드,201912,1016,1007,2023,37.556877,126.848808
강서구,1182, KBS 스포츠월드,202001,998,970,1968,37.556877,126.848808
강서구,1182, KBS 스포츠월드,202002,948,927,1875,37.556877,126.848808
강서구,1182, KBS 스포츠월드,202003,1290,1277,2567,37.556877,126.848808
강서구,1182, KBS 스포츠월드,202004,1836,1809,3645,37.556877,126.848808
강서구,1182, KBS 스포츠월드,202005,2657,2666,5323,37.556877,126.848808
강서구,1182, KBS 스포츠월드,202006,3694,3699,7393,37.556877,126.848808
강서구,1183, KC 대학교,201901,98,73,171,37.548321,126.853401
강서구,1183, KC 대학교,201902,90,76,166,37.548321,126.853401
강서구,1183, KC 대학교,201903,135,105,240,37.548321,126.853401
강서구,1183, KC 대학교,201904,176,128,304,37.548321,126.853401
강서구,1183, KC 대학교,201905,359,340,699,37.548321,126.853401
강서구,1183, KC 대학교,201906,321,299,620,37.548321,126.853401
강서구,1183, KC 대학교,201907,172,161,333,37.548321,126.853401
강서구,1183, KC 대학교,201908,218,195,413,37.548321,126.853401
강서구,1183, KC 대학교,201909,333,364,697,37.548321,126.853401
강서구,1183, KC 대학교,201910,364,361,725,37.548321,126.853401
강서구,1183, KC 대학교,201911,244,253,497,37.548321,126.853401
강서구,1183, KC 대학교,201912,94,88,182,37.548321,126.853401
강서구,1183, KC 대학교,202001,117,92,209,37.548321,126.853401
강서구,1183, KC 대학교,202002,82,83,165,37.548321,126.853401
강서구,1183, KC 대학교,202003,191,159,350,37.548321,126.853401
강서구,1183, KC 대학교,202004,332,306,638,37.548321,126.853401
강서구,1183, KC 대학교,202005,350,302,652,37.548321,126.853401
강서구,1183, KC 대학교,202006,456,357,813,37.548321,126.853401
강서구,1184, 마곡13단지,201901,238,265,503,37.55645,126.815979
강서구,1184, 마곡13단지,201902,262,285,547,37.55645,126.815979
강서구,1184, 마곡13단지,201903,413,431,844,37.55645,126.815979
강서구,1184, 마곡13단지,201904,612,634,1246,37.55645,126.815979
강서구,1184, 마곡13단지,201905,1110,1167,2277,37.55645,126.815979
강서구,1184, 마곡13단지,201906,1421,1618,3039,37.55645,126.815979
강서구,1184, 마곡13단지,201907,1353,1580,2933,37.55645,126.815979
강서구,1184, 마곡13단지,201908,1390,1586,2976,37.55645,126.815979
강서구,1184, 마곡13단지,201909,1550,1682,3232,37.55645,126.815979
강서구,1184, 마곡13단지,201910,1989,2154,4143,37.55645,126.815979
강서구,1184, 마곡13단지,201911,1368,1511,2879,37.55645,126.815979
강서구,1184, 마곡13단지,201912,916,1003,1919,37.55645,126.815979
강서구,1184, 마곡13단지,202001,811,937,1748,37.55645,126.815979
강서구,1184, 마곡13단지,202002,784,812,1596,37.55645,126.815979
강서구,1184, 마곡13단지,202003,1133,1256,2389,37.55645,126.815979
강서구,1184, 마곡13단지,202004,1577,1667,3244,37.55645,126.815979
강서구,1184, 마곡13단지,202005,2118,2242,4360,37.55645,126.815979
강서구,1184, 마곡13단지,202006,2529,2817,5346,37.55645,126.815979
강서구,1185, 등촌9단지,201901,292,305,597,37.562901,126.849472
강서구,1185, 등촌9단지,201902,230,232,462,37.562901,126.849472
강서구,1185, 등촌9단지,201903,404,429,833,37.562901,126.849472
강서구,1185, 등촌9단지,201904,672,707,1379,37.562901,126.849472
강서구,1185, 등촌9단지,201905,1253,1353,2606,37.562901,126.849472
강서구,1185, 등촌9단지,201906,1552,1627,3179,37.562901,126.849472
강서구,1185, 등촌9단지,201907,1440,1498,2938,37.562901,126.849472
강서구,1185, 등촌9단지,201908,1514,1513,3027,37.562901,126.849472
강서구,1185, 등촌9단지,201909,1426,1474,2900,37.562901,126.849472
강서구,1185, 등촌9단지,201910,1741,1729,3470,37.562901,126.849472
강서구,1185, 등촌9단지,201911,1074,1086,2160,37.562901,126.849472
강서구,1185, 등촌9단지,201912,553,544,1097,37.562901,126.849472
강서구,1185, 등촌9단지,202001,537,533,1070,37.562901,126.849472
강서구,1185, 등촌9단지,202002,494,491,985,37.562901,126.849472
강서구,1185, 등촌9단지,202003,969,974,1943,37.562901,126.849472
강서구,1185, 등촌9단지,202004,1581,1600,3181,37.562901,126.849472
강서구,1185, 등촌9단지,202005,1963,1994,3957,37.562901,126.849472
강서구,1185, 등촌9단지,202006,2349,2404,4753,37.562901,126.849472
강서구,1186, 송정중학교,201901,82,113,195,37.554729,126.816093
강서구,1186, 송정중학교,201902,78,114,192,37.554729,126.816093
강서구,1186, 송정중학교,201903,148,205,353,37.554729,126.816093
강서구,1186, 송정중학교,201904,254,305,559,37.554729,126.816093
강서구,1186, 송정중학교,201905,440,475,915,37.554729,126.816093
강서구,1186, 송정중학교,201906,574,657,1231,37.554729,126.816093
강서구,1186, 송정중학교,201907,622,688,1310,37.554729,126.816093
강서구,1186, 송정중학교,201908,597,670,1267,37.554729,126.816093
강서구,1186, 송정중학교,201909,547,606,1153,37.554729,126.816093
강서구,1186, 송정중학교,201910,736,857,1593,37.554729,126.816093
강서구,1186, 송정중학교,201911,662,717,1379,37.554729,126.816093
강서구,1186, 송정중학교,201912,517,581,1098,37.554729,126.816093
강서구,1186, 송정중학교,202001,422,438,860,37.554729,126.816093
강서구,1186, 송정중학교,202002,387,452,839,37.554729,126.816093
강서구,1186, 송정중학교,202003,520,559,1079,37.554729,126.816093
강서구,1186, 송정중학교,202004,719,759,1478,37.554729,126.816093
강서구,1186, 송정중학교,202005,830,867,1697,37.554729,126.816093
강서구,1186, 송정중학교,202006,1045,1077,2122,37.554729,126.816093
강서구,1187, 강서수산물도매시장,201901,56,59,115,37.55302,126.818367
강서구,1187, 강서수산물도매시장,201902,67,84,151,37.55302,126.818367
강서구,1187, 강서수산물도매시장,201903,108,137,245,37.55302,126.818367
강서구,1187, 강서수산물도매시장,201904,168,143,311,37.55302,126.818367
강서구,1187, 강서수산물도매시장,201905,342,355,697,37.55302,126.818367
강서구,1187, 강서수산물도매시장,201906,373,419,792,37.55302,126.818367
강서구,1187, 강서수산물도매시장,201907,334,330,664,37.55302,126.818367
강서구,1187, 강서수산물도매시장,201908,321,380,701,37.55302,126.818367
강서구,1187, 강서수산물도매시장,201909,386,384,770,37.55302,126.818367
강서구,1187, 강서수산물도매시장,201910,562,579,1141,37.55302,126.818367
강서구,1187, 강서수산물도매시장,201911,431,444,875,37.55302,126.818367
강서구,1187, 강서수산물도매시장,201912,313,353,666,37.55302,126.818367
강서구,1187, 강서수산물도매시장,202001,314,319,633,37.55302,126.818367
강서구,1187, 강서수산물도매시장,202002,217,225,442,37.55302,126.818367
강서구,1187, 강서수산물도매시장,202003,356,340,696,37.55302,126.818367
강서구,1187, 강서수산물도매시장,202004,444,460,904,37.55302,126.818367
강서구,1187, 강서수산물도매시장,202005,566,574,1140,37.55302,126.818367
강서구,1187, 강서수산물도매시장,202006,659,681,1340,37.55302,126.818367
강서구,1188, 롯데중앙연구소,201901,64,64,128,37.571381,126.828339
강서구,1188, 롯데중앙연구소,201902,58,46,104,37.571381,126.828339
강서구,1188, 롯데중앙연구소,201903,119,126,245,37.571381,126.828339
강서구,1188, 롯데중앙연구소,201904,55,56,111,37.571381,126.828339
강서구,1188, 롯데중앙연구소,201905,502,483,985,37.571381,126.828339
강서구,1188, 롯데중앙연구소,201906,624,592,1216,37.571381,126.828339
강서구,1188, 롯데중앙연구소,201907,645,618,1263,37.571381,126.828339
강서구,1188, 롯데중앙연구소,201908,545,547,1092,37.571381,126.828339
강서구,1188, 롯데중앙연구소,201909,577,588,1165,37.571381,126.828339
강서구,1188, 롯데중앙연구소,201910,584,574,1158,37.571381,126.828339
강서구,1188, 롯데중앙연구소,201911,440,494,934,37.571381,126.828339
강서구,1188, 롯데중앙연구소,201912,228,248,476,37.571381,126.828339
강서구,1188, 롯데중앙연구소,202001,175,185,360,37.571381,126.828339
강서구,1188, 롯데중앙연구소,202002,240,256,496,37.571381,126.828339
강서구,1188, 롯데중앙연구소,202003,382,374,756,37.571381,126.828339
강서구,1188, 롯데중앙연구소,202004,713,689,1402,37.571381,126.828339
강서구,1188, 롯데중앙연구소,202005,786,790,1576,37.571381,126.828339
강서구,1188, 롯데중앙연구소,202006,561,532,1093,37.571381,126.828339
강서구,1190, 마곡역 교차로(2번출구),201901,119,77,196,37.560501,126.826653
강서구,1190, 마곡역 교차로(2번출구),201902,118,62,180,37.560501,126.826653
강서구,1190, 마곡역 교차로(2번출구),201903,255,154,409,37.560501,126.826653
강서구,1190, 마곡역 교차로(2번출구),201904,369,226,595,37.560501,126.826653
강서구,1190, 마곡역 교차로(2번출구),201905,462,379,841,37.560501,126.826653
강서구,1190, 마곡역 교차로(2번출구),201906,756,558,1314,37.560501,126.826653
강서구,1190, 마곡역 교차로(2번출구),201907,744,583,1327,37.560501,126.826653
강서구,1190, 마곡역 교차로(2번출구),201908,957,903,1860,37.560501,126.826653
강서구,1190, 마곡역 교차로(2번출구),201909,645,509,1154,37.560501,126.826653
강서구,1190, 마곡역 교차로(2번출구),201910,775,661,1436,37.560501,126.826653
강서구,1190, 마곡역 교차로(2번출구),201911,693,546,1239,37.560501,126.826653
강서구,1190, 마곡역 교차로(2번출구),201912,536,430,966,37.560501,126.826653
강서구,1190, 마곡역 교차로(2번출구),202001,414,291,705,37.560501,126.826653
강서구,1190, 마곡역 교차로(2번출구),202002,408,294,702,37.560501,126.826653
강서구,1190, 마곡역 교차로(2번출구),202003,533,391,924,37.560501,126.826653
강서구,1190, 마곡역 교차로(2번출구),202004,666,586,1252,37.560501,126.826653
강서구,1190, 마곡역 교차로(2번출구),202005,693,641,1334,37.560501,126.826653
강서구,1190, 마곡역 교차로(2번출구),202006,967,885,1852,37.560501,126.826653
강서구,1191, 마곡역 교차로(NH농협),201901,280,220,500,37.560242,126.827164
강서구,1191, 마곡역 교차로(NH농협),201902,326,249,575,37.560242,126.827164
강서구,1191, 마곡역 교차로(NH농협),201903,669,531,1200,37.560242,126.827164
강서구,1191, 마곡역 교차로(NH농협),201904,1081,871,1952,37.560242,126.827164
강서구,1191, 마곡역 교차로(NH농협),201905,1896,1829,3725,37.560242,126.827164
강서구,1191, 마곡역 교차로(NH농협),201906,2521,2460,4981,37.560242,126.827164
강서구,1191, 마곡역 교차로(NH농협),201907,2312,2138,4450,37.560242,126.827164
강서구,1191, 마곡역 교차로(NH농협),201908,1481,1375,2856,37.560242,126.827164
강서구,1191, 마곡역 교차로(NH농협),201909,2105,1995,4100,37.560242,126.827164
강서구,1191, 마곡역 교차로(NH농협),201910,2509,2404,4913,37.560242,126.827164
강서구,1191, 마곡역 교차로(NH농협),201911,1973,1801,3774,37.560242,126.827164
강서구,1191, 마곡역 교차로(NH농협),201912,1343,1195,2538,37.560242,126.827164
강서구,1191, 마곡역 교차로(NH농협),202001,1212,1044,2256,37.560242,126.827164
강서구,1191, 마곡역 교차로(NH농협),202002,1060,929,1989,37.560242,126.827164
강서구,1191, 마곡역 교차로(NH농협),202003,1566,1395,2961,37.560242,126.827164
강서구,1191, 마곡역 교차로(NH농협),202004,2278,2147,4425,37.560242,126.827164
강서구,1191, 마곡역 교차로(NH농협),202005,2817,2698,5515,37.560242,126.827164
강서구,1191, 마곡역 교차로(NH농협),202006,3179,2909,6088,37.560242,126.827164
강서구,1192, 마곡수명산파크 209동 건너편,201901,223,178,401,37.555538,126.826759
강서구,1192, 마곡수명산파크 209동 건너편,201902,255,236,491,37.555538,126.826759
강서구,1192, 마곡수명산파크 209동 건너편,201903,522,471,993,37.555538,126.826759
강서구,1192, 마곡수명산파크 209동 건너편,201904,692,619,1311,37.555538,126.826759
강서구,1192, 마곡수명산파크 209동 건너편,201905,1006,983,1989,37.555538,126.826759
강서구,1192, 마곡수명산파크 209동 건너편,201906,1349,1350,2699,37.555538,126.826759
강서구,1192, 마곡수명산파크 209동 건너편,201907,1526,1554,3080,37.555538,126.826759
강서구,1192, 마곡수명산파크 209동 건너편,201908,1376,1417,2793,37.555538,126.826759
강서구,1192, 마곡수명산파크 209동 건너편,201909,1309,1282,2591,37.555538,126.826759
강서구,1192, 마곡수명산파크 209동 건너편,201910,1517,1486,3003,37.555538,126.826759
강서구,1192, 마곡수명산파크 209동 건너편,201911,1203,1176,2379,37.555538,126.826759
강서구,1192, 마곡수명산파크 209동 건너편,201912,730,716,1446,37.555538,126.826759
강서구,1192, 마곡수명산파크 209동 건너편,202001,639,630,1269,37.555538,126.826759
강서구,1192, 마곡수명산파크 209동 건너편,202002,582,579,1161,37.555538,126.826759
강서구,1192, 마곡수명산파크 209동 건너편,202003,883,856,1739,37.555538,126.826759
강서구,1192, 마곡수명산파크 209동 건너편,202004,1254,1227,2481,37.555538,126.826759
강서구,1192, 마곡수명산파크 209동 건너편,202005,1586,1516,3102,37.555538,126.826759
강서구,1192, 마곡수명산파크 209동 건너편,202006,1743,1586,3329,37.555538,126.826759
강서구,1193, 마곡센트럴타워 1차,201901,273,305,578,37.559471,126.832077
강서구,1193, 마곡센트럴타워 1차,201902,294,253,547,37.559471,126.832077
강서구,1193, 마곡센트럴타워 1차,201903,601,620,1221,37.559471,126.832077
강서구,1193, 마곡센트럴타워 1차,201904,961,1110,2071,37.559471,126.832077
강서구,1193, 마곡센트럴타워 1차,201905,1713,1824,3537,37.559471,126.832077
강서구,1193, 마곡센트럴타워 1차,201906,1968,2023,3991,37.559471,126.832077
강서구,1193, 마곡센트럴타워 1차,201907,2204,2723,4927,37.559471,126.832077
강서구,1193, 마곡센트럴타워 1차,201908,2385,2652,5037,37.559471,126.832077
강서구,1193, 마곡센트럴타워 1차,201909,1985,2343,4328,37.559471,126.832077
강서구,1193, 마곡센트럴타워 1차,201910,2546,2984,5530,37.559471,126.832077
강서구,1193, 마곡센트럴타워 1차,201911,1636,2012,3648,37.559471,126.832077
강서구,1193, 마곡센트럴타워 1차,201912,945,1135,2080,37.559471,126.832077
강서구,1193, 마곡센트럴타워 1차,202001,966,1129,2095,37.559471,126.832077
강서구,1193, 마곡센트럴타워 1차,202002,968,1095,2063,37.559471,126.832077
강서구,1193, 마곡센트럴타워 1차,202003,1559,1755,3314,37.559471,126.832077
강서구,1193, 마곡센트럴타워 1차,202004,2065,2331,4396,37.559471,126.832077
강서구,1193, 마곡센트럴타워 1차,202005,2722,2942,5664,37.559471,126.832077
강서구,1193, 마곡센트럴타워 1차,202006,2667,3167,5834,37.559471,126.832077
강서구,1194, 센서텍㈜,201901,157,178,335,37.563301,126.836823
강서구,1194, 센서텍㈜,201902,115,136,251,37.563301,126.836823
강서구,1194, 센서텍㈜,201903,272,250,522,37.563301,126.836823
강서구,1194, 센서텍㈜,201904,442,456,898,37.563301,126.836823
강서구,1194, 센서텍㈜,201905,760,852,1612,37.563301,126.836823
강서구,1194, 센서텍㈜,201906,1075,1096,2171,37.563301,126.836823
강서구,1194, 센서텍㈜,201907,1037,1121,2158,37.563301,126.836823
강서구,1194, 센서텍㈜,201908,930,927,1857,37.563301,126.836823
강서구,1194, 센서텍㈜,201909,969,1027,1996,37.563301,126.836823
강서구,1194, 센서텍㈜,201910,1193,1299,2492,37.563301,126.836823
강서구,1194, 센서텍㈜,201911,876,972,1848,37.563301,126.836823
강서구,1194, 센서텍㈜,201912,527,670,1197,37.563301,126.836823
강서구,1194, 센서텍㈜,202001,447,615,1062,37.563301,126.836823
강서구,1194, 센서텍㈜,202002,547,639,1186,37.563301,126.836823
강서구,1194, 센서텍㈜,202003,676,736,1412,37.563301,126.836823
강서구,1194, 센서텍㈜,202004,1017,1202,2219,37.563301,126.836823
강서구,1194, 센서텍㈜,202005,1411,1539,2950,37.563301,126.836823
강서구,1194, 센서텍㈜,202006,1530,1725,3255,37.563301,126.836823
강서구,1195, 코오롱One&Only타워,201901,354,348,702,37.564129,126.834312
강서구,1195, 코오롱One&Only타워,201902,266,253,519,37.564129,126.834312
강서구,1195, 코오롱One&Only타워,201903,649,673,1322,37.564129,126.834312
강서구,1195, 코오롱One&Only타워,201904,926,1033,1959,37.564129,126.834312
강서구,1195, 코오롱One&Only타워,201905,1610,1699,3309,37.564129,126.834312
강서구,1195, 코오롱One&Only타워,201906,2031,2167,4198,37.564129,126.834312
강서구,1195, 코오롱One&Only타워,201907,2016,2586,4602,37.564129,126.834312
강서구,1195, 코오롱One&Only타워,201908,2245,2368,4613,37.564129,126.834312
강서구,1195, 코오롱One&Only타워,201909,2006,2191,4197,37.564129,126.834312
강서구,1195, 코오롱One&Only타워,201910,2328,2708,5036,37.564129,126.834312
강서구,1195, 코오롱One&Only타워,201911,1650,2053,3703,37.564129,126.834312
강서구,1195, 코오롱One&Only타워,201912,949,1112,2061,37.564129,126.834312
강서구,1195, 코오롱One&Only타워,202001,870,1081,1951,37.564129,126.834312
강서구,1195, 코오롱One&Only타워,202002,1015,1198,2213,37.564129,126.834312
강서구,1195, 코오롱One&Only타워,202003,1245,1525,2770,37.564129,126.834312
강서구,1195, 코오롱One&Only타워,202004,1641,1989,3630,37.564129,126.834312
강서구,1195, 코오롱One&Only타워,202005,2017,2347,4364,37.564129,126.834312
강서구,1195, 코오롱One&Only타워,202006,2451,3092,5543,37.564129,126.834312
강서구,1196, 서울식물원(문화센터) 건너편,201901,69,47,116,37.568241,126.835831
강서구,1196, 서울식물원(문화센터) 건너편,201902,86,60,146,37.568241,126.835831
강서구,1196, 서울식물원(문화센터) 건너편,201903,221,182,403,37.568241,126.835831
강서구,1196, 서울식물원(문화센터) 건너편,201904,434,364,798,37.568241,126.835831
강서구,1196, 서울식물원(문화센터) 건너편,201905,657,577,1234,37.568241,126.835831
강서구,1196, 서울식물원(문화센터) 건너편,201906,793,659,1452,37.568241,126.835831
강서구,1196, 서울식물원(문화센터) 건너편,201907,848,685,1533,37.568241,126.835831
강서구,1196, 서울식물원(문화센터) 건너편,201908,860,665,1525,37.568241,126.835831
강서구,1196, 서울식물원(문화센터) 건너편,201909,895,716,1611,37.568241,126.835831
강서구,1196, 서울식물원(문화센터) 건너편,201910,1125,903,2028,37.568241,126.835831
강서구,1196, 서울식물원(문화센터) 건너편,201911,778,562,1340,37.568241,126.835831
강서구,1196, 서울식물원(문화센터) 건너편,201912,363,291,654,37.568241,126.835831
강서구,1196, 서울식물원(문화센터) 건너편,202001,311,250,561,37.568241,126.835831
강서구,1196, 서울식물원(문화센터) 건너편,202002,331,258,589,37.568241,126.835831
강서구,1196, 서울식물원(문화센터) 건너편,202003,757,613,1370,37.568241,126.835831
강서구,1196, 서울식물원(문화센터) 건너편,202004,1090,850,1940,37.568241,126.835831
강서구,1196, 서울식물원(문화센터) 건너편,202005,1402,1141,2543,37.568241,126.835831
강서구,1196, 서울식물원(문화센터) 건너편,202006,1172,915,2087,37.568241,126.835831
강서구,1197, 엘펠리체 호텔 건너편,201901,459,440,899,37.560242,126.835808
강서구,1197, 엘펠리체 호텔 건너편,201902,468,495,963,37.560242,126.835808
강서구,1197, 엘펠리체 호텔 건너편,201903,930,964,1894,37.560242,126.835808
강서구,1197, 엘펠리체 호텔 건너편,201904,1559,1620,3179,37.560242,126.835808
강서구,1197, 엘펠리체 호텔 건너편,201905,2622,2640,5262,37.560242,126.835808
강서구,1197, 엘펠리체 호텔 건너편,201906,3506,3582,7088,37.560242,126.835808
강서구,1197, 엘펠리체 호텔 건너편,201907,3221,3315,6536,37.560242,126.835808
강서구,1197, 엘펠리체 호텔 건너편,201908,3375,3378,6753,37.560242,126.835808
강서구,1197, 엘펠리체 호텔 건너편,201909,3228,3249,6477,37.560242,126.835808
강서구,1197, 엘펠리체 호텔 건너편,201910,4002,3995,7997,37.560242,126.835808
강서구,1197, 엘펠리체 호텔 건너편,201911,2524,2573,5097,37.560242,126.835808
강서구,1197, 엘펠리체 호텔 건너편,201912,1417,1489,2906,37.560242,126.835808
강서구,1197, 엘펠리체 호텔 건너편,202001,1229,1406,2635,37.560242,126.835808
강서구,1197, 엘펠리체 호텔 건너편,202002,1334,1428,2762,37.560242,126.835808
강서구,1197, 엘펠리체 호텔 건너편,202003,1975,2036,4011,37.560242,126.835808
강서구,1197, 엘펠리체 호텔 건너편,202004,2923,2961,5884,37.560242,126.835808
강서구,1197, 엘펠리체 호텔 건너편,202005,4159,4219,8378,37.560242,126.835808
강서구,1197, 엘펠리체 호텔 건너편,202006,4103,4193,8296,37.560242,126.835808
강서구,1198, LG 사이언스파크,201901,180,113,293,37.56255,126.827438
강서구,1198, LG 사이언스파크,201902,198,140,338,37.56255,126.827438
강서구,1198, LG 사이언스파크,201903,371,298,669,37.56255,126.827438
강서구,1198, LG 사이언스파크,201904,568,438,1006,37.56255,126.827438
강서구,1198, LG 사이언스파크,201905,974,865,1839,37.56255,126.827438
강서구,1198, LG 사이언스파크,201906,948,911,1859,37.56255,126.827438
강서구,1198, LG 사이언스파크,201907,1169,1046,2215,37.56255,126.827438
강서구,1198, LG 사이언스파크,201908,1188,999,2187,37.56255,126.827438
강서구,1198, LG 사이언스파크,201909,1009,897,1906,37.56255,126.827438
강서구,1198, LG 사이언스파크,201910,1191,1060,2251,37.56255,126.827438
강서구,1198, LG 사이언스파크,201911,934,742,1676,37.56255,126.827438
강서구,1198, LG 사이언스파크,201912,603,492,1095,37.56255,126.827438
강서구,1198, LG 사이언스파크,202001,571,423,994,37.56255,126.827438
강서구,1198, LG 사이언스파크,202002,563,453,1016,37.56255,126.827438
강서구,1198, LG 사이언스파크,202003,803,704,1507,37.56255,126.827438
강서구,1198, LG 사이언스파크,202004,1004,876,1880,37.56255,126.827438
강서구,1198, LG 사이언스파크,202005,1156,1007,2163,37.56255,126.827438
강서구,1198, LG 사이언스파크,202006,1369,1171,2540,37.56255,126.827438
강서구,1199, 우장산역 3번출구,201901,271,177,448,37.547821,126.836128
강서구,1199, 우장산역 3번출구,201902,246,193,439,37.547821,126.836128
강서구,1199, 우장산역 3번출구,201903,488,334,822,37.547821,126.836128
강서구,1199, 우장산역 3번출구,201904,758,502,1260,37.547821,126.836128
강서구,1199, 우장산역 3번출구,201905,1358,1063,2421,37.547821,126.836128
강서구,1199, 우장산역 3번출구,201906,1603,1303,2906,37.547821,126.836128
강서구,1199, 우장산역 3번출구,201907,1521,1125,2646,37.547821,126.836128
강서구,1199, 우장산역 3번출구,201908,491,439,930,37.547821,126.836128
강서구,1199, 우장산역 3번출구,201909,592,526,1118,37.547821,126.836128
강서구,1199, 우장산역 3번출구,201910,762,742,1504,37.547821,126.836128
강서구,1199, 우장산역 3번출구,201911,879,769,1648,37.547821,126.836128
강서구,1199, 우장산역 3번출구,201912,557,443,1000,37.547821,126.836128
강서구,1199, 우장산역 3번출구,202001,642,476,1118,37.547821,126.836128
강서구,1199, 우장산역 3번출구,202002,619,413,1032,37.547821,126.836128
강서구,1199, 우장산역 3번출구,202003,1041,738,1779,37.547821,126.836128
강서구,1199, 우장산역 3번출구,202004,1661,1322,2983,37.547821,126.836128
강서구,1199, 우장산역 3번출구,202005,2133,1761,3894,37.547821,126.836128
강서구,1199, 우장산역 3번출구,202006,2683,2166,4849,37.547821,126.836128
강서구,1200, 개화광역환승센터,201901,15,12,27,37.578449,126.798973
강서구,1200, 개화광역환승센터,201902,19,17,36,37.578449,126.798973
강서구,1200, 개화광역환승센터,201903,53,60,113,37.578449,126.798973
강서구,1200, 개화광역환승센터,201904,119,117,236,37.578449,126.798973
강서구,1200, 개화광역환승센터,201905,204,193,397,37.578449,126.798973
강서구,1200, 개화광역환승센터,201906,228,216,444,37.578449,126.798973
강서구,1200, 개화광역환승센터,201907,236,218,454,37.578449,126.798973
강서구,1200, 개화광역환승센터,201908,231,217,448,37.578449,126.798973
강서구,1200, 개화광역환승센터,201909,256,240,496,37.578449,126.798973
강서구,1200, 개화광역환승센터,201910,306,331,637,37.578449,126.798973
강서구,1200, 개화광역환승센터,201911,160,176,336,37.578449,126.798973
강서구,1200, 개화광역환승센터,201912,139,121,260,37.578449,126.798973
강서구,1200, 개화광역환승센터,202001,96,92,188,37.578449,126.798973
강서구,1200, 개화광역환승센터,202002,119,92,211,37.578449,126.798973
강서구,1200, 개화광역환승센터,202003,173,153,326,37.578449,126.798973
강서구,1200, 개화광역환승센터,202004,244,212,456,37.578449,126.798973
강서구,1200, 개화광역환승센터,202005,331,330,661,37.578449,126.798973
강서구,1200, 개화광역환승센터,202006,303,359,662,37.578449,126.798973
송파구,1201, 가락시장역 3번 출구,201901,496,586,1082,37.493179,127.118546
송파구,1201, 가락시장역 3번 출구,201902,564,617,1181,37.493179,127.118546
송파구,1201, 가락시장역 3번 출구,201903,1057,1224,2281,37.493179,127.118546
송파구,1201, 가락시장역 3번 출구,201904,1591,1786,3377,37.493179,127.118546
송파구,1201, 가락시장역 3번 출구,201905,2781,2808,5589,37.493179,127.118546
송파구,1201, 가락시장역 3번 출구,201906,2940,2963,5903,37.493179,127.118546
송파구,1201, 가락시장역 3번 출구,201907,2788,2844,5632,37.493179,127.118546
송파구,1201, 가락시장역 3번 출구,201908,2616,2692,5308,37.493179,127.118546
송파구,1201, 가락시장역 3번 출구,201909,2779,2846,5625,37.493179,127.118546
송파구,1201, 가락시장역 3번 출구,201910,3586,3664,7250,37.493179,127.118546
송파구,1201, 가락시장역 3번 출구,201911,1993,2177,4170,37.493179,127.118546
송파구,1201, 가락시장역 3번 출구,201912,1225,1345,2570,37.493179,127.118546
송파구,1201, 가락시장역 3번 출구,202001,1020,1186,2206,37.493179,127.118546
송파구,1201, 가락시장역 3번 출구,202002,987,1034,2021,37.493179,127.118546
송파구,1201, 가락시장역 3번 출구,202003,1829,1887,3716,37.493179,127.118546
송파구,1201, 가락시장역 3번 출구,202004,2250,2295,4545,37.493179,127.118546
송파구,1201, 가락시장역 3번 출구,202005,2708,2705,5413,37.493179,127.118546
송파구,1201, 가락시장역 3번 출구,202006,2758,2800,5558,37.493179,127.118546
송파구,1203, 밀리아나2빌딩 앞,201901,548,639,1187,37.493729,127.120621
송파구,1203, 밀리아나2빌딩 앞,201902,548,626,1174,37.493729,127.120621
송파구,1203, 밀리아나2빌딩 앞,201903,1023,1151,2174,37.493729,127.120621
송파구,1203, 밀리아나2빌딩 앞,201904,1712,1868,3580,37.493729,127.120621
송파구,1203, 밀리아나2빌딩 앞,201905,2849,2926,5775,37.493729,127.120621
송파구,1203, 밀리아나2빌딩 앞,201906,3149,3179,6328,37.493729,127.120621
송파구,1203, 밀리아나2빌딩 앞,201907,2920,3033,5953,37.493729,127.120621
송파구,1203, 밀리아나2빌딩 앞,201908,2791,2836,5627,37.493729,127.120621
송파구,1203, 밀리아나2빌딩 앞,201909,2922,2920,5842,37.493729,127.120621
송파구,1203, 밀리아나2빌딩 앞,201910,2816,2879,5695,37.493729,127.120621
송파구,1203, 밀리아나2빌딩 앞,201911,2068,2075,4143,37.493729,127.120621
송파구,1203, 밀리아나2빌딩 앞,201912,1137,1213,2350,37.493729,127.120621
송파구,1203, 밀리아나2빌딩 앞,202001,1047,1085,2132,37.493729,127.120621
송파구,1203, 밀리아나2빌딩 앞,202002,1057,1081,2138,37.493729,127.120621
송파구,1203, 밀리아나2빌딩 앞,202003,1996,2040,4036,37.493729,127.120621
송파구,1203, 밀리아나2빌딩 앞,202004,2616,2650,5266,37.493729,127.120621
송파구,1203, 밀리아나2빌딩 앞,202005,2899,2902,5801,37.493729,127.120621
송파구,1203, 밀리아나2빌딩 앞,202006,2853,2871,5724,37.493729,127.120621
송파구,1204, 거여역 3번출구,201901,201,210,411,37.493343,127.14473
송파구,1204, 거여역 3번출구,201902,220,243,463,37.493343,127.14473
송파구,1204, 거여역 3번출구,201903,367,402,769,37.493343,127.14473
송파구,1204, 거여역 3번출구,201904,627,696,1323,37.493343,127.14473
송파구,1204, 거여역 3번출구,201905,1096,1148,2244,37.493343,127.14473
송파구,1204, 거여역 3번출구,201906,1299,1323,2622,37.493343,127.14473
송파구,1204, 거여역 3번출구,201907,1233,1233,2466,37.493343,127.14473
송파구,1204, 거여역 3번출구,201908,1120,1154,2274,37.493343,127.14473
송파구,1204, 거여역 3번출구,201909,1170,1213,2383,37.493343,127.14473
송파구,1204, 거여역 3번출구,201910,1296,1294,2590,37.493343,127.14473
송파구,1204, 거여역 3번출구,201911,822,847,1669,37.493343,127.14473
송파구,1204, 거여역 3번출구,201912,500,493,993,37.493343,127.14473
송파구,1204, 거여역 3번출구,202001,504,519,1023,37.493343,127.14473
송파구,1204, 거여역 3번출구,202002,525,576,1101,37.493343,127.14473
송파구,1204, 거여역 3번출구,202003,1101,1105,2206,37.493343,127.14473
송파구,1204, 거여역 3번출구,202004,1273,1297,2570,37.493343,127.14473
송파구,1204, 거여역 3번출구,202005,1564,1566,3130,37.493343,127.14473
송파구,1204, 거여역 3번출구,202006,1544,1549,3093,37.493343,127.14473
송파구,1205, 종합운동장역 4번출구,201901,302,301,603,37.510429,127.071373
송파구,1205, 종합운동장역 4번출구,201902,229,241,470,37.510429,127.071373
송파구,1205, 종합운동장역 4번출구,201903,631,644,1275,37.510429,127.071373
송파구,1205, 종합운동장역 4번출구,201904,1102,1133,2235,37.510429,127.071373
송파구,1205, 종합운동장역 4번출구,201905,1663,1602,3265,37.510429,127.071373
송파구,1205, 종합운동장역 4번출구,201906,1904,1727,3631,37.510429,127.071373
송파구,1205, 종합운동장역 4번출구,201907,1499,1313,2812,37.510429,127.071373
송파구,1205, 종합운동장역 4번출구,201908,1534,1412,2946,37.510429,127.071373
송파구,1205, 종합운동장역 4번출구,201909,1440,1322,2762,37.510429,127.071373
송파구,1205, 종합운동장역 4번출구,201910,1928,1669,3597,37.510429,127.071373
송파구,1205, 종합운동장역 4번출구,201911,935,711,1646,37.510429,127.071373
송파구,1205, 종합운동장역 4번출구,201912,442,374,816,37.510429,127.071373
송파구,1205, 종합운동장역 4번출구,202001,435,412,847,37.510429,127.071373
송파구,1205, 종합운동장역 4번출구,202002,452,359,811,37.510429,127.071373
송파구,1205, 종합운동장역 4번출구,202003,1114,896,2010,37.510429,127.071373
송파구,1205, 종합운동장역 4번출구,202004,1426,1126,2552,37.510429,127.071373
송파구,1205, 종합운동장역 4번출구,202005,1392,1188,2580,37.510429,127.071373
송파구,1205, 종합운동장역 4번출구,202006,1491,1186,2677,37.510429,127.071373
송파구,1206, 9호선종합운동장역 9번출구,201901,377,438,815,37.51128,127.078239
송파구,1206, 9호선종합운동장역 9번출구,201902,402,376,778,37.51128,127.078239
송파구,1206, 9호선종합운동장역 9번출구,201903,971,940,1911,37.51128,127.078239
송파구,1206, 9호선종합운동장역 9번출구,201904,1644,1568,3212,37.51128,127.078239
송파구,1206, 9호선종합운동장역 9번출구,201905,2423,2315,4738,37.51128,127.078239
송파구,1206, 9호선종합운동장역 9번출구,201906,1881,1793,3674,37.51128,127.078239
송파구,1206, 9호선종합운동장역 9번출구,201907,2458,2140,4598,37.51128,127.078239
송파구,1206, 9호선종합운동장역 9번출구,201908,2297,2056,4353,37.51128,127.078239
송파구,1206, 9호선종합운동장역 9번출구,201909,2237,2042,4279,37.51128,127.078239
송파구,1206, 9호선종합운동장역 9번출구,201910,2954,2644,5598,37.51128,127.078239
송파구,1206, 9호선종합운동장역 9번출구,201911,1675,1538,3213,37.51128,127.078239
송파구,1206, 9호선종합운동장역 9번출구,201912,912,854,1766,37.51128,127.078239
송파구,1206, 9호선종합운동장역 9번출구,202001,749,713,1462,37.51128,127.078239
송파구,1206, 9호선종합운동장역 9번출구,202002,677,606,1283,37.51128,127.078239
송파구,1206, 9호선종합운동장역 9번출구,202003,1488,1360,2848,37.51128,127.078239
송파구,1206, 9호선종합운동장역 9번출구,202004,1694,1669,3363,37.51128,127.078239
송파구,1206, 9호선종합운동장역 9번출구,202005,1757,1736,3493,37.51128,127.078239
송파구,1206, 9호선종합운동장역 9번출구,202006,1367,1343,2710,37.51128,127.078239
송파구,1207, 마천CU우방점 앞,201901,175,232,407,37.499756,127.152504
송파구,1207, 마천CU우방점 앞,201902,187,226,413,37.499756,127.152504
송파구,1207, 마천CU우방점 앞,201903,314,419,733,37.499756,127.152504
송파구,1207, 마천CU우방점 앞,201904,480,635,1115,37.499756,127.152504
송파구,1207, 마천CU우방점 앞,201905,804,963,1767,37.499756,127.152504
송파구,1207, 마천CU우방점 앞,201906,919,1238,2157,37.499756,127.152504
송파구,1207, 마천CU우방점 앞,201907,816,1078,1894,37.499756,127.152504
송파구,1207, 마천CU우방점 앞,201908,772,1057,1829,37.499756,127.152504
송파구,1207, 마천CU우방점 앞,201909,795,1016,1811,37.499756,127.152504
송파구,1207, 마천CU우방점 앞,201910,926,1120,2046,37.499756,127.152504
송파구,1207, 마천CU우방점 앞,201911,521,733,1254,37.499756,127.152504
송파구,1207, 마천CU우방점 앞,201912,317,404,721,37.499756,127.152504
송파구,1207, 마천CU우방점 앞,202001,337,412,749,37.499756,127.152504
송파구,1207, 마천CU우방점 앞,202002,317,390,707,37.499756,127.152504
송파구,1207, 마천CU우방점 앞,202003,666,728,1394,37.499756,127.152504
송파구,1207, 마천CU우방점 앞,202004,970,1115,2085,37.499756,127.152504
송파구,1207, 마천CU우방점 앞,202005,1037,1134,2171,37.499756,127.152504
송파구,1207, 마천CU우방점 앞,202006,1036,1148,2184,37.499756,127.152504
송파구,1208, 풍납현대아파트쉼터,201901,557,586,1143,37.529675,127.119789
송파구,1208, 풍납현대아파트쉼터,201902,559,577,1136,37.529675,127.119789
송파구,1208, 풍납현대아파트쉼터,201903,927,885,1812,37.529675,127.119789
송파구,1208, 풍납현대아파트쉼터,201904,1381,1353,2734,37.529675,127.119789
송파구,1208, 풍납현대아파트쉼터,201905,2305,2303,4608,37.529675,127.119789
송파구,1208, 풍납현대아파트쉼터,201906,2407,2370,4777,37.529675,127.119789
송파구,1208, 풍납현대아파트쉼터,201907,2269,2280,4549,37.529675,127.119789
송파구,1208, 풍납현대아파트쉼터,201908,2331,2305,4636,37.529675,127.119789
송파구,1208, 풍납현대아파트쉼터,201909,2358,2305,4663,37.529675,127.119789
송파구,1208, 풍납현대아파트쉼터,201910,2694,2686,5380,37.529675,127.119789
송파구,1208, 풍납현대아파트쉼터,201911,1679,1700,3379,37.529675,127.119789
송파구,1208, 풍납현대아파트쉼터,201912,999,1009,2008,37.529675,127.119789
송파구,1208, 풍납현대아파트쉼터,202001,899,901,1800,37.529675,127.119789
송파구,1208, 풍납현대아파트쉼터,202002,914,857,1771,37.529675,127.119789
송파구,1208, 풍납현대아파트쉼터,202003,1746,1669,3415,37.529675,127.119789
송파구,1208, 풍납현대아파트쉼터,202004,2117,2105,4222,37.529675,127.119789
송파구,1208, 풍납현대아파트쉼터,202005,2478,2443,4921,37.529675,127.119789
송파구,1208, 풍납현대아파트쉼터,202006,2134,2118,4252,37.529675,127.119789
송파구,1209, 잠실나루역 (2번 출구 쪽),201901,990,862,1852,37.520451,127.104202
송파구,1209, 잠실나루역 (2번 출구 쪽),201902,888,862,1750,37.520451,127.104202
송파구,1209, 잠실나루역 (2번 출구 쪽),201903,1799,1727,3526,37.520451,127.104202
송파구,1209, 잠실나루역 (2번 출구 쪽),201904,3336,3228,6564,37.520451,127.104202
송파구,1209, 잠실나루역 (2번 출구 쪽),201905,4844,4724,9568,37.520451,127.104202
송파구,1209, 잠실나루역 (2번 출구 쪽),201906,4969,4942,9911,37.520451,127.104202
송파구,1209, 잠실나루역 (2번 출구 쪽),201907,4620,4453,9073,37.520451,127.104202
송파구,1209, 잠실나루역 (2번 출구 쪽),201908,4584,4469,9053,37.520451,127.104202
송파구,1209, 잠실나루역 (2번 출구 쪽),201909,4585,4271,8856,37.520451,127.104202
송파구,1209, 잠실나루역 (2번 출구 쪽),201910,5658,5214,10872,37.520451,127.104202
송파구,1209, 잠실나루역 (2번 출구 쪽),201911,3191,2893,6084,37.520451,127.104202
송파구,1209, 잠실나루역 (2번 출구 쪽),201912,1744,1568,3312,37.520451,127.104202
송파구,1209, 잠실나루역 (2번 출구 쪽),202001,1728,1566,3294,37.520451,127.104202
송파구,1209, 잠실나루역 (2번 출구 쪽),202002,1617,1498,3115,37.520451,127.104202
송파구,1209, 잠실나루역 (2번 출구 쪽),202003,3950,3807,7757,37.520451,127.104202
송파구,1209, 잠실나루역 (2번 출구 쪽),202004,5185,5133,10318,37.520451,127.104202
송파구,1209, 잠실나루역 (2번 출구 쪽),202005,5547,5478,11025,37.520451,127.104202
송파구,1209, 잠실나루역 (2번 출구 쪽),202006,5741,5591,11332,37.520451,127.104202
송파구,1210, 롯데월드타워(잠실역2번출구 쪽),201901,1708,1687,3395,37.513126,127.10096
송파구,1210, 롯데월드타워(잠실역2번출구 쪽),201902,1732,1724,3456,37.513126,127.10096
송파구,1210, 롯데월드타워(잠실역2번출구 쪽),201903,3656,3648,7304,37.513126,127.10096
송파구,1210, 롯데월드타워(잠실역2번출구 쪽),201904,5725,5628,11353,37.513126,127.10096
송파구,1210, 롯데월드타워(잠실역2번출구 쪽),201905,8719,8696,17415,37.513126,127.10096
송파구,1210, 롯데월드타워(잠실역2번출구 쪽),201906,8965,8899,17864,37.513126,127.10096
송파구,1210, 롯데월드타워(잠실역2번출구 쪽),201907,7702,7653,15355,37.513126,127.10096
송파구,1210, 롯데월드타워(잠실역2번출구 쪽),201908,7397,7316,14713,37.513126,127.10096
송파구,1210, 롯데월드타워(잠실역2번출구 쪽),201909,8010,7991,16001,37.513126,127.10096
송파구,1210, 롯데월드타워(잠실역2번출구 쪽),201910,10141,10126,20267,37.513126,127.10096
송파구,1210, 롯데월드타워(잠실역2번출구 쪽),201911,5848,5890,11738,37.513126,127.10096
송파구,1210, 롯데월드타워(잠실역2번출구 쪽),201912,3140,3139,6279,37.513126,127.10096
송파구,1210, 롯데월드타워(잠실역2번출구 쪽),202001,2895,2900,5795,37.513126,127.10096
송파구,1210, 롯데월드타워(잠실역2번출구 쪽),202002,2574,2522,5096,37.513126,127.10096
송파구,1210, 롯데월드타워(잠실역2번출구 쪽),202003,4872,4866,9738,37.513126,127.10096
송파구,1210, 롯데월드타워(잠실역2번출구 쪽),202004,6270,6253,12523,37.513126,127.10096
송파구,1210, 롯데월드타워(잠실역2번출구 쪽),202005,7047,7032,14079,37.513126,127.10096
송파구,1210, 롯데월드타워(잠실역2번출구 쪽),202006,7386,7389,14775,37.513126,127.10096
송파구,1211, 방이삼거리,201901,860,925,1785,37.512104,127.10778
송파구,1211, 방이삼거리,201902,710,756,1466,37.512104,127.10778
송파구,1211, 방이삼거리,201903,1520,1544,3064,37.512104,127.10778
송파구,1211, 방이삼거리,201904,2417,2655,5072,37.512104,127.10778
송파구,1211, 방이삼거리,201905,3766,3757,7523,37.512104,127.10778
송파구,1211, 방이삼거리,201906,4173,4210,8383,37.512104,127.10778
송파구,1211, 방이삼거리,201907,3702,3696,7398,37.512104,127.10778
송파구,1211, 방이삼거리,201908,3569,3553,7122,37.512104,127.10778
송파구,1211, 방이삼거리,201909,3521,3510,7031,37.512104,127.10778
송파구,1211, 방이삼거리,201910,4393,4416,8809,37.512104,127.10778
송파구,1211, 방이삼거리,201911,2903,3054,5957,37.512104,127.10778
송파구,1211, 방이삼거리,201912,1366,1496,2862,37.512104,127.10778
송파구,1211, 방이삼거리,202001,1208,1321,2529,37.512104,127.10778
송파구,1211, 방이삼거리,202002,1193,1298,2491,37.512104,127.10778
송파구,1211, 방이삼거리,202003,2558,2747,5305,37.512104,127.10778
송파구,1211, 방이삼거리,202004,3138,3157,6295,37.512104,127.10778
송파구,1211, 방이삼거리,202005,3970,3985,7955,37.512104,127.10778
송파구,1211, 방이삼거리,202006,4165,4239,8404,37.512104,127.10778
송파구,1212, 송파역 2번 출구앞,201901,513,538,1051,37.499413,127.112869
송파구,1212, 송파역 2번 출구앞,201902,608,605,1213,37.499413,127.112869
송파구,1212, 송파역 2번 출구앞,201903,1164,1316,2480,37.499413,127.112869
송파구,1212, 송파역 2번 출구앞,201904,2388,2783,5171,37.499413,127.112869
송파구,1212, 송파역 2번 출구앞,201905,3838,4518,8356,37.499413,127.112869
송파구,1212, 송파역 2번 출구앞,201906,4533,5107,9640,37.499413,127.112869
송파구,1212, 송파역 2번 출구앞,201907,4232,4628,8860,37.499413,127.112869
송파구,1212, 송파역 2번 출구앞,201908,3829,4255,8084,37.499413,127.112869
송파구,1212, 송파역 2번 출구앞,201909,3984,4242,8226,37.499413,127.112869
송파구,1212, 송파역 2번 출구앞,201910,4681,5007,9688,37.499413,127.112869
송파구,1212, 송파역 2번 출구앞,201911,2745,2958,5703,37.499413,127.112869
송파구,1212, 송파역 2번 출구앞,201912,1566,1690,3256,37.499413,127.112869
송파구,1212, 송파역 2번 출구앞,202001,1404,1574,2978,37.499413,127.112869
송파구,1212, 송파역 2번 출구앞,202002,571,612,1183,37.499413,127.112869
송파구,1212, 송파역 2번 출구앞,202003,1059,1118,2177,37.499413,127.112869
송파구,1212, 송파역 2번 출구앞,202004,3589,3753,7342,37.499413,127.112869
송파구,1212, 송파역 2번 출구앞,202005,3614,3731,7345,37.499413,127.112869
송파구,1212, 송파역 2번 출구앞,202006,2689,2698,5387,37.499413,127.112869
송파구,1213, 백토공원 앞,201901,347,304,651,37.50766,127.132736
송파구,1213, 백토공원 앞,201902,331,273,604,37.50766,127.132736
송파구,1213, 백토공원 앞,201903,651,591,1242,37.50766,127.132736
송파구,1213, 백토공원 앞,201904,802,821,1623,37.50766,127.132736
송파구,1213, 백토공원 앞,201905,1131,1045,2176,37.50766,127.132736
송파구,1213, 백토공원 앞,201906,1258,1097,2355,37.50766,127.132736
송파구,1213, 백토공원 앞,201907,1234,1088,2322,37.50766,127.132736
송파구,1213, 백토공원 앞,201908,1144,1008,2152,37.50766,127.132736
송파구,1213, 백토공원 앞,201909,1156,1000,2156,37.50766,127.132736
송파구,1213, 백토공원 앞,201910,1555,1322,2877,37.50766,127.132736
송파구,1213, 백토공원 앞,201911,1036,854,1890,37.50766,127.132736
송파구,1213, 백토공원 앞,201912,554,524,1078,37.50766,127.132736
송파구,1213, 백토공원 앞,202001,493,444,937,37.50766,127.132736
송파구,1213, 백토공원 앞,202002,546,473,1019,37.50766,127.132736
송파구,1213, 백토공원 앞,202003,971,813,1784,37.50766,127.132736
송파구,1213, 백토공원 앞,202004,1119,999,2118,37.50766,127.132736
송파구,1213, 백토공원 앞,202005,984,949,1933,37.50766,127.132736
송파구,1213, 백토공원 앞,202006,974,867,1841,37.50766,127.132736
송파구,1214, 오금역 7번 출구 인근,201901,342,274,616,37.502594,127.127647
송파구,1214, 오금역 7번 출구 인근,201902,292,256,548,37.502594,127.127647
송파구,1214, 오금역 7번 출구 인근,201903,566,513,1079,37.502594,127.127647
송파구,1214, 오금역 7번 출구 인근,201904,918,829,1747,37.502594,127.127647
송파구,1214, 오금역 7번 출구 인근,201905,1216,1154,2370,37.502594,127.127647
송파구,1214, 오금역 7번 출구 인근,201906,1257,1229,2486,37.502594,127.127647
송파구,1214, 오금역 7번 출구 인근,201907,1317,1309,2626,37.502594,127.127647
송파구,1214, 오금역 7번 출구 인근,201908,1188,1162,2350,37.502594,127.127647
송파구,1214, 오금역 7번 출구 인근,201909,1229,1213,2442,37.502594,127.127647
송파구,1214, 오금역 7번 출구 인근,201910,1766,1751,3517,37.502594,127.127647
송파구,1214, 오금역 7번 출구 인근,201911,1465,1394,2859,37.502594,127.127647
송파구,1214, 오금역 7번 출구 인근,201912,592,571,1163,37.502594,127.127647
송파구,1214, 오금역 7번 출구 인근,202001,518,481,999,37.502594,127.127647
송파구,1214, 오금역 7번 출구 인근,202002,492,439,931,37.502594,127.127647
송파구,1214, 오금역 7번 출구 인근,202003,956,882,1838,37.502594,127.127647
송파구,1214, 오금역 7번 출구 인근,202004,1378,1277,2655,37.502594,127.127647
송파구,1214, 오금역 7번 출구 인근,202005,1374,1353,2727,37.502594,127.127647
송파구,1214, 오금역 7번 출구 인근,202006,1517,1437,2954,37.502594,127.127647
송파구,1215, 올림픽공원역 1번출구 앞,201901,544,532,1076,37.516571,127.131538
송파구,1215, 올림픽공원역 1번출구 앞,201902,421,426,847,37.516571,127.131538
송파구,1215, 올림픽공원역 1번출구 앞,201903,808,775,1583,37.516571,127.131538
송파구,1215, 올림픽공원역 1번출구 앞,201904,1347,1239,2586,37.516571,127.131538
송파구,1215, 올림픽공원역 1번출구 앞,201905,1840,1754,3594,37.516571,127.131538
송파구,1215, 올림픽공원역 1번출구 앞,201906,1971,1955,3926,37.516571,127.131538
송파구,1215, 올림픽공원역 1번출구 앞,201907,1781,1780,3561,37.516571,127.131538
송파구,1215, 올림픽공원역 1번출구 앞,201908,1726,1720,3446,37.516571,127.131538
송파구,1215, 올림픽공원역 1번출구 앞,201909,1563,1559,3122,37.516571,127.131538
송파구,1215, 올림픽공원역 1번출구 앞,201910,1716,1725,3441,37.516571,127.131538
송파구,1215, 올림픽공원역 1번출구 앞,201911,1026,1018,2044,37.516571,127.131538
송파구,1215, 올림픽공원역 1번출구 앞,201912,623,593,1216,37.516571,127.131538
송파구,1215, 올림픽공원역 1번출구 앞,202001,593,585,1178,37.516571,127.131538
송파구,1215, 올림픽공원역 1번출구 앞,202002,535,521,1056,37.516571,127.131538
송파구,1215, 올림픽공원역 1번출구 앞,202003,1090,1086,2176,37.516571,127.131538
송파구,1215, 올림픽공원역 1번출구 앞,202004,1552,1564,3116,37.516571,127.131538
송파구,1215, 올림픽공원역 1번출구 앞,202005,1714,1690,3404,37.516571,127.131538
송파구,1215, 올림픽공원역 1번출구 앞,202006,1819,1770,3589,37.516571,127.131538
송파구,1217, 송파파인타운 7단지,201901,287,261,548,37.479305,127.129799
송파구,1217, 송파파인타운 7단지,201902,203,151,354,37.479305,127.129799
송파구,1217, 송파파인타운 7단지,201903,351,328,679,37.479305,127.129799
송파구,1217, 송파파인타운 7단지,201904,615,585,1200,37.479305,127.129799
송파구,1217, 송파파인타운 7단지,201905,970,956,1926,37.479305,127.129799
송파구,1217, 송파파인타운 7단지,201906,1101,1065,2166,37.479305,127.129799
송파구,1217, 송파파인타운 7단지,201907,1236,1230,2466,37.479305,127.129799
송파구,1217, 송파파인타운 7단지,201908,1054,1040,2094,37.479305,127.129799
송파구,1217, 송파파인타운 7단지,201909,1048,1079,2127,37.479305,127.129799
송파구,1217, 송파파인타운 7단지,201910,1175,1156,2331,37.479305,127.129799
송파구,1217, 송파파인타운 7단지,201911,805,799,1604,37.479305,127.129799
송파구,1217, 송파파인타운 7단지,201912,435,424,859,37.479305,127.129799
송파구,1217, 송파파인타운 7단지,202001,408,412,820,37.479305,127.129799
송파구,1217, 송파파인타운 7단지,202002,408,391,799,37.479305,127.129799
송파구,1217, 송파파인타운 7단지,202003,653,637,1290,37.479305,127.129799
송파구,1217, 송파파인타운 7단지,202004,928,921,1849,37.479305,127.129799
송파구,1217, 송파파인타운 7단지,202005,1013,1011,2024,37.479305,127.129799
송파구,1217, 송파파인타운 7단지,202006,1360,1339,2699,37.479305,127.129799
송파구,1218, 방이역 4번출구,201901,483,667,1150,37.508968,127.125839
송파구,1218, 방이역 4번출구,201902,441,526,967,37.508968,127.125839
송파구,1218, 방이역 4번출구,201903,1034,1079,2113,37.508968,127.125839
송파구,1218, 방이역 4번출구,201904,1485,1495,2980,37.508968,127.125839
송파구,1218, 방이역 4번출구,201905,2445,2434,4879,37.508968,127.125839
송파구,1218, 방이역 4번출구,201906,2618,2631,5249,37.508968,127.125839
송파구,1218, 방이역 4번출구,201907,2555,2549,5104,37.508968,127.125839
송파구,1218, 방이역 4번출구,201908,2425,2456,4881,37.508968,127.125839
송파구,1218, 방이역 4번출구,201909,2391,2392,4783,37.508968,127.125839
송파구,1218, 방이역 4번출구,201910,2804,2799,5603,37.508968,127.125839
송파구,1218, 방이역 4번출구,201911,1800,1846,3646,37.508968,127.125839
송파구,1218, 방이역 4번출구,201912,980,1101,2081,37.508968,127.125839
송파구,1218, 방이역 4번출구,202001,975,1032,2007,37.508968,127.125839
송파구,1218, 방이역 4번출구,202002,897,909,1806,37.508968,127.125839
송파구,1218, 방이역 4번출구,202003,1787,1790,3577,37.508968,127.125839
송파구,1218, 방이역 4번출구,202004,2404,2425,4829,37.508968,127.125839
송파구,1218, 방이역 4번출구,202005,2574,2572,5146,37.508968,127.125839
송파구,1218, 방이역 4번출구,202006,2755,2771,5526,37.508968,127.125839
송파구,1220, 잠실본동주민센터뒤 잠실근린공원,201901,396,464,860,37.505692,127.084038
송파구,1220, 잠실본동주민센터뒤 잠실근린공원,201902,394,453,847,37.505692,127.084038
송파구,1220, 잠실본동주민센터뒤 잠실근린공원,201903,849,1004,1853,37.505692,127.084038
송파구,1220, 잠실본동주민센터뒤 잠실근린공원,201904,1321,1681,3002,37.505692,127.084038
송파구,1220, 잠실본동주민센터뒤 잠실근린공원,201905,2173,2446,4619,37.505692,127.084038
송파구,1220, 잠실본동주민센터뒤 잠실근린공원,201906,2350,2657,5007,37.505692,127.084038
송파구,1220, 잠실본동주민센터뒤 잠실근린공원,201907,2203,2594,4797,37.505692,127.084038
송파구,1220, 잠실본동주민센터뒤 잠실근린공원,201908,2173,2534,4707,37.505692,127.084038
송파구,1220, 잠실본동주민센터뒤 잠실근린공원,201909,2102,2399,4501,37.505692,127.084038
송파구,1220, 잠실본동주민센터뒤 잠실근린공원,201910,2601,2926,5527,37.505692,127.084038
송파구,1220, 잠실본동주민센터뒤 잠실근린공원,201911,1548,1831,3379,37.505692,127.084038
송파구,1220, 잠실본동주민센터뒤 잠실근린공원,201912,869,1034,1903,37.505692,127.084038
송파구,1220, 잠실본동주민센터뒤 잠실근린공원,202001,874,993,1867,37.505692,127.084038
송파구,1220, 잠실본동주민센터뒤 잠실근린공원,202002,772,884,1656,37.505692,127.084038
송파구,1220, 잠실본동주민센터뒤 잠실근린공원,202003,1509,1641,3150,37.505692,127.084038
송파구,1220, 잠실본동주민센터뒤 잠실근린공원,202004,1634,1834,3468,37.505692,127.084038
송파구,1220, 잠실본동주민센터뒤 잠실근린공원,202005,1297,1394,2691,37.505692,127.084038
송파구,1220, 잠실본동주민센터뒤 잠실근린공원,202006,2279,2446,4725,37.505692,127.084038
송파구,1221, 삼전사거리 포스코더샵,201901,298,413,711,37.5042,127.087532
송파구,1221, 삼전사거리 포스코더샵,201902,330,435,765,37.5042,127.087532
송파구,1221, 삼전사거리 포스코더샵,201903,759,877,1636,37.5042,127.087532
송파구,1221, 삼전사거리 포스코더샵,201904,1208,1488,2696,37.5042,127.087532
송파구,1221, 삼전사거리 포스코더샵,201905,2076,2321,4397,37.5042,127.087532
송파구,1221, 삼전사거리 포스코더샵,201906,2427,2647,5074,37.5042,127.087532
송파구,1221, 삼전사거리 포스코더샵,201907,2120,2286,4406,37.5042,127.087532
송파구,1221, 삼전사거리 포스코더샵,201908,2180,2349,4529,37.5042,127.087532
송파구,1221, 삼전사거리 포스코더샵,201909,2128,2327,4455,37.5042,127.087532
송파구,1221, 삼전사거리 포스코더샵,201910,2333,2480,4813,37.5042,127.087532
송파구,1221, 삼전사거리 포스코더샵,201911,1423,1562,2985,37.5042,127.087532
송파구,1221, 삼전사거리 포스코더샵,201912,782,828,1610,37.5042,127.087532
송파구,1221, 삼전사거리 포스코더샵,202001,722,763,1485,37.5042,127.087532
송파구,1221, 삼전사거리 포스코더샵,202002,652,656,1308,37.5042,127.087532
송파구,1221, 삼전사거리 포스코더샵,202003,1325,1404,2729,37.5042,127.087532
송파구,1221, 삼전사거리 포스코더샵,202004,1889,2122,4011,37.5042,127.087532
송파구,1221, 삼전사거리 포스코더샵,202005,2479,2673,5152,37.5042,127.087532
송파구,1221, 삼전사거리 포스코더샵,202006,2750,2887,5637,37.5042,127.087532
송파구,1222, 잠실새내역 5번 출구 뒤,201901,816,896,1712,37.511982,127.085052
송파구,1222, 잠실새내역 5번 출구 뒤,201902,898,954,1852,37.511982,127.085052
송파구,1222, 잠실새내역 5번 출구 뒤,201903,1930,2096,4026,37.511982,127.085052
송파구,1222, 잠실새내역 5번 출구 뒤,201904,3667,4004,7671,37.511982,127.085052
송파구,1222, 잠실새내역 5번 출구 뒤,201905,6504,6687,13191,37.511982,127.085052
송파구,1222, 잠실새내역 5번 출구 뒤,201906,6563,6638,13201,37.511982,127.085052
송파구,1222, 잠실새내역 5번 출구 뒤,201907,5184,5189,10373,37.511982,127.085052
송파구,1222, 잠실새내역 5번 출구 뒤,201908,5842,5798,11640,37.511982,127.085052
송파구,1222, 잠실새내역 5번 출구 뒤,201909,5774,5782,11556,37.511982,127.085052
송파구,1222, 잠실새내역 5번 출구 뒤,201910,6753,6766,13519,37.511982,127.085052
송파구,1222, 잠실새내역 5번 출구 뒤,201911,3392,3490,6882,37.511982,127.085052
송파구,1222, 잠실새내역 5번 출구 뒤,201912,1623,1727,3350,37.511982,127.085052
송파구,1222, 잠실새내역 5번 출구 뒤,202001,1372,1520,2892,37.511982,127.085052
송파구,1222, 잠실새내역 5번 출구 뒤,202002,1398,1556,2954,37.511982,127.085052
송파구,1222, 잠실새내역 5번 출구 뒤,202003,4450,4858,9308,37.511982,127.085052
송파구,1222, 잠실새내역 5번 출구 뒤,202004,5911,6212,12123,37.511982,127.085052
송파구,1222, 잠실새내역 5번 출구 뒤,202005,6002,6095,12097,37.511982,127.085052
송파구,1222, 잠실새내역 5번 출구 뒤,202006,5143,5189,10332,37.511982,127.085052
송파구,1224, 아시아지하보도 2번 출구,201901,365,357,722,37.512169,127.078934
송파구,1224, 아시아지하보도 2번 출구,201902,306,320,626,37.512169,127.078934
송파구,1224, 아시아지하보도 2번 출구,201903,759,784,1543,37.512169,127.078934
송파구,1224, 아시아지하보도 2번 출구,201904,1407,1457,2864,37.512169,127.078934
송파구,1224, 아시아지하보도 2번 출구,201905,2584,2536,5120,37.512169,127.078934
송파구,1224, 아시아지하보도 2번 출구,201906,2681,2680,5361,37.512169,127.078934
송파구,1224, 아시아지하보도 2번 출구,201907,2181,2103,4284,37.512169,127.078934
송파구,1224, 아시아지하보도 2번 출구,201908,1863,1863,3726,37.512169,127.078934
송파구,1224, 아시아지하보도 2번 출구,201909,1929,1872,3801,37.512169,127.078934
송파구,1224, 아시아지하보도 2번 출구,201910,2417,2392,4809,37.512169,127.078934
송파구,1224, 아시아지하보도 2번 출구,201911,1306,1312,2618,37.512169,127.078934
송파구,1224, 아시아지하보도 2번 출구,201912,688,675,1363,37.512169,127.078934
송파구,1224, 아시아지하보도 2번 출구,202001,618,626,1244,37.512169,127.078934
송파구,1224, 아시아지하보도 2번 출구,202002,562,554,1116,37.512169,127.078934
송파구,1224, 아시아지하보도 2번 출구,202003,1398,1470,2868,37.512169,127.078934
송파구,1224, 아시아지하보도 2번 출구,202004,1847,1846,3693,37.512169,127.078934
송파구,1224, 아시아지하보도 2번 출구,202005,1986,2001,3987,37.512169,127.078934
송파구,1224, 아시아지하보도 2번 출구,202006,1894,1832,3726,37.512169,127.078934
송파구,1226, 잠실4동 주민센터 옆,201901,506,576,1082,37.520077,127.112366
송파구,1226, 잠실4동 주민센터 옆,201902,460,493,953,37.520077,127.112366
송파구,1226, 잠실4동 주민센터 옆,201903,843,865,1708,37.520077,127.112366
송파구,1226, 잠실4동 주민센터 옆,201904,1247,1261,2508,37.520077,127.112366
송파구,1226, 잠실4동 주민센터 옆,201905,1894,1847,3741,37.520077,127.112366
송파구,1226, 잠실4동 주민센터 옆,201906,2000,2003,4003,37.520077,127.112366
송파구,1226, 잠실4동 주민센터 옆,201907,1820,1852,3672,37.520077,127.112366
송파구,1226, 잠실4동 주민센터 옆,201908,1881,1863,3744,37.520077,127.112366
송파구,1226, 잠실4동 주민센터 옆,201909,1810,1842,3652,37.520077,127.112366
송파구,1226, 잠실4동 주민센터 옆,201910,2185,2238,4423,37.520077,127.112366
송파구,1226, 잠실4동 주민센터 옆,201911,1265,1335,2600,37.520077,127.112366
송파구,1226, 잠실4동 주민센터 옆,201912,750,835,1585,37.520077,127.112366
송파구,1226, 잠실4동 주민센터 옆,202001,728,848,1576,37.520077,127.112366
송파구,1226, 잠실4동 주민센터 옆,202002,596,690,1286,37.520077,127.112366
송파구,1226, 잠실4동 주민센터 옆,202003,1271,1310,2581,37.520077,127.112366
송파구,1226, 잠실4동 주민센터 옆,202004,1888,1937,3825,37.520077,127.112366
송파구,1226, 잠실4동 주민센터 옆,202005,1990,1974,3964,37.520077,127.112366
송파구,1226, 잠실4동 주민센터 옆,202006,2056,2071,4127,37.520077,127.112366
송파구,1227, 거여역 8번출구 뒤,201901,313,304,617,37.493126,127.143822
송파구,1227, 거여역 8번출구 뒤,201902,264,278,542,37.493126,127.143822
송파구,1227, 거여역 8번출구 뒤,201903,478,488,966,37.493126,127.143822
송파구,1227, 거여역 8번출구 뒤,201904,726,769,1495,37.493126,127.143822
송파구,1227, 거여역 8번출구 뒤,201905,1040,1220,2260,37.493126,127.143822
송파구,1227, 거여역 8번출구 뒤,201906,1143,1213,2356,37.493126,127.143822
송파구,1227, 거여역 8번출구 뒤,201907,1160,1204,2364,37.493126,127.143822
송파구,1227, 거여역 8번출구 뒤,201908,991,1068,2059,37.493126,127.143822
송파구,1227, 거여역 8번출구 뒤,201909,1025,1042,2067,37.493126,127.143822
송파구,1227, 거여역 8번출구 뒤,201910,1296,1313,2609,37.493126,127.143822
송파구,1227, 거여역 8번출구 뒤,201911,832,845,1677,37.493126,127.143822
송파구,1227, 거여역 8번출구 뒤,201912,475,474,949,37.493126,127.143822
송파구,1227, 거여역 8번출구 뒤,202001,434,453,887,37.493126,127.143822
송파구,1227, 거여역 8번출구 뒤,202002,479,475,954,37.493126,127.143822
송파구,1227, 거여역 8번출구 뒤,202003,1054,1058,2112,37.493126,127.143822
송파구,1227, 거여역 8번출구 뒤,202004,1405,1425,2830,37.493126,127.143822
송파구,1227, 거여역 8번출구 뒤,202005,1564,1571,3135,37.493126,127.143822
송파구,1227, 거여역 8번출구 뒤,202006,1660,1661,3321,37.493126,127.143822
송파구,1228, 마천사거리,201901,243,301,544,37.4977,127.146202
송파구,1228, 마천사거리,201902,267,312,579,37.4977,127.146202
송파구,1228, 마천사거리,201903,463,536,999,37.4977,127.146202
송파구,1228, 마천사거리,201904,712,834,1546,37.4977,127.146202
송파구,1228, 마천사거리,201905,1128,1384,2512,37.4977,127.146202
송파구,1228, 마천사거리,201906,1306,1588,2894,37.4977,127.146202
송파구,1228, 마천사거리,201907,1338,1697,3035,37.4977,127.146202
송파구,1228, 마천사거리,201908,1342,1537,2879,37.4977,127.146202
송파구,1228, 마천사거리,201909,1243,1519,2762,37.4977,127.146202
송파구,1228, 마천사거리,201910,1513,1589,3102,37.4977,127.146202
송파구,1228, 마천사거리,201911,1006,1149,2155,37.4977,127.146202
송파구,1228, 마천사거리,201912,576,613,1189,37.4977,127.146202
송파구,1228, 마천사거리,202001,518,580,1098,37.4977,127.146202
송파구,1228, 마천사거리,202002,439,494,933,37.4977,127.146202
송파구,1228, 마천사거리,202003,1060,1118,2178,37.4977,127.146202
송파구,1228, 마천사거리,202004,1347,1475,2822,37.4977,127.146202
송파구,1228, 마천사거리,202005,1577,1628,3205,37.4977,127.146202
송파구,1228, 마천사거리,202006,1469,1582,3051,37.4977,127.146202
송파구,1229, 송파체육문화회관 앞,201901,260,274,534,37.490688,127.143127
송파구,1229, 송파체육문화회관 앞,201902,220,224,444,37.490688,127.143127
송파구,1229, 송파체육문화회관 앞,201903,322,318,640,37.490688,127.143127
송파구,1229, 송파체육문화회관 앞,201904,553,542,1095,37.490688,127.143127
송파구,1229, 송파체육문화회관 앞,201905,811,888,1699,37.490688,127.143127
송파구,1229, 송파체육문화회관 앞,201906,857,919,1776,37.490688,127.143127
송파구,1229, 송파체육문화회관 앞,201907,1029,1081,2110,37.490688,127.143127
송파구,1229, 송파체육문화회관 앞,201908,979,1020,1999,37.490688,127.143127
송파구,1229, 송파체육문화회관 앞,201909,877,943,1820,37.490688,127.143127
송파구,1229, 송파체육문화회관 앞,201910,1217,1224,2441,37.490688,127.143127
송파구,1229, 송파체육문화회관 앞,201911,871,870,1741,37.490688,127.143127
송파구,1229, 송파체육문화회관 앞,201912,450,451,901,37.490688,127.143127
송파구,1229, 송파체육문화회관 앞,202001,461,462,923,37.490688,127.143127
송파구,1229, 송파체육문화회관 앞,202002,382,370,752,37.490688,127.143127
송파구,1229, 송파체육문화회관 앞,202003,591,582,1173,37.490688,127.143127
송파구,1229, 송파체육문화회관 앞,202004,923,915,1838,37.490688,127.143127
송파구,1229, 송파체육문화회관 앞,202005,1214,1208,2422,37.490688,127.143127
송파구,1229, 송파체육문화회관 앞,202006,1343,1375,2718,37.490688,127.143127
송파구,1230, 송파중학교 정문,201901,215,134,349,37.49567,127.130592
송파구,1230, 송파중학교 정문,201902,193,111,304,37.49567,127.130592
송파구,1230, 송파중학교 정문,201903,346,258,604,37.49567,127.130592
송파구,1230, 송파중학교 정문,201904,599,470,1069,37.49567,127.130592
송파구,1230, 송파중학교 정문,201905,961,864,1825,37.49567,127.130592
송파구,1230, 송파중학교 정문,201906,1234,1098,2332,37.49567,127.130592
송파구,1230, 송파중학교 정문,201907,1268,1106,2374,37.49567,127.130592
송파구,1230, 송파중학교 정문,201908,1035,906,1941,37.49567,127.130592
송파구,1230, 송파중학교 정문,201909,1045,960,2005,37.49567,127.130592
송파구,1230, 송파중학교 정문,201910,1135,1033,2168,37.49567,127.130592
송파구,1230, 송파중학교 정문,201911,814,649,1463,37.49567,127.130592
송파구,1230, 송파중학교 정문,201912,431,336,767,37.49567,127.130592
송파구,1230, 송파중학교 정문,202001,518,334,852,37.49567,127.130592
송파구,1230, 송파중학교 정문,202002,431,320,751,37.49567,127.130592
송파구,1230, 송파중학교 정문,202003,805,690,1495,37.49567,127.130592
송파구,1230, 송파중학교 정문,202004,1074,900,1974,37.49567,127.130592
송파구,1230, 송파중학교 정문,202005,1154,1097,2251,37.49567,127.130592
송파구,1230, 송파중학교 정문,202006,1112,1069,2181,37.49567,127.130592
송파구,1231, 잠실역 6번출구,201901,447,409,856,37.514088,127.09903
송파구,1231, 잠실역 6번출구,201902,453,458,911,37.514088,127.09903
송파구,1231, 잠실역 6번출구,201903,1095,1217,2312,37.514088,127.09903
송파구,1231, 잠실역 6번출구,201904,2070,2260,4330,37.514088,127.09903
송파구,1231, 잠실역 6번출구,201905,3499,3551,7050,37.514088,127.09903
송파구,1231, 잠실역 6번출구,201906,3147,3182,6329,37.514088,127.09903
송파구,1231, 잠실역 6번출구,201907,2418,2409,4827,37.514088,127.09903
송파구,1231, 잠실역 6번출구,201908,2763,2759,5522,37.514088,127.09903
송파구,1231, 잠실역 6번출구,201909,3054,3076,6130,37.514088,127.09903
송파구,1231, 잠실역 6번출구,201910,3410,3393,6803,37.514088,127.09903
송파구,1231, 잠실역 6번출구,201911,1660,1657,3317,37.514088,127.09903
송파구,1231, 잠실역 6번출구,201912,878,884,1762,37.514088,127.09903
송파구,1231, 잠실역 6번출구,202001,768,777,1545,37.514088,127.09903
송파구,1231, 잠실역 6번출구,202002,800,833,1633,37.514088,127.09903
송파구,1231, 잠실역 6번출구,202003,2443,2548,4991,37.514088,127.09903
송파구,1231, 잠실역 6번출구,202004,3033,3062,6095,37.514088,127.09903
송파구,1231, 잠실역 6번출구,202005,3484,3482,6966,37.514088,127.09903
송파구,1231, 잠실역 6번출구,202006,2899,2870,5769,37.514088,127.09903
송파구,1232, 롯데마트 주차장 옆,201901,412,363,775,37.512089,127.096191
송파구,1232, 롯데마트 주차장 옆,201902,398,344,742,37.512089,127.096191
송파구,1232, 롯데마트 주차장 옆,201903,638,580,1218,37.512089,127.096191
송파구,1232, 롯데마트 주차장 옆,201904,1360,1258,2618,37.512089,127.096191
송파구,1232, 롯데마트 주차장 옆,201905,1963,1924,3887,37.512089,127.096191
송파구,1232, 롯데마트 주차장 옆,201906,1905,1847,3752,37.512089,127.096191
송파구,1232, 롯데마트 주차장 옆,201907,1539,1533,3072,37.512089,127.096191
송파구,1232, 롯데마트 주차장 옆,201908,1485,1386,2871,37.512089,127.096191
송파구,1232, 롯데마트 주차장 옆,201909,1654,1533,3187,37.512089,127.096191
송파구,1232, 롯데마트 주차장 옆,201910,1947,1827,3774,37.512089,127.096191
송파구,1232, 롯데마트 주차장 옆,201911,1208,1111,2319,37.512089,127.096191
송파구,1232, 롯데마트 주차장 옆,201912,590,538,1128,37.512089,127.096191
송파구,1232, 롯데마트 주차장 옆,202001,633,506,1139,37.512089,127.096191
송파구,1232, 롯데마트 주차장 옆,202002,460,386,846,37.512089,127.096191
송파구,1232, 롯데마트 주차장 옆,202003,1176,1081,2257,37.512089,127.096191
송파구,1232, 롯데마트 주차장 옆,202004,1523,1445,2968,37.512089,127.096191
송파구,1232, 롯데마트 주차장 옆,202005,1628,1610,3238,37.512089,127.096191
송파구,1232, 롯데마트 주차장 옆,202006,1612,1600,3212,37.512089,127.096191
송파구,1233, 잠실3거리(갤러리아팰리스),201901,224,195,419,37.510509,127.093369
송파구,1233, 잠실3거리(갤러리아팰리스),201902,224,205,429,37.510509,127.093369
송파구,1233, 잠실3거리(갤러리아팰리스),201903,487,456,943,37.510509,127.093369
송파구,1233, 잠실3거리(갤러리아팰리스),201904,753,628,1381,37.510509,127.093369
송파구,1233, 잠실3거리(갤러리아팰리스),201905,1182,1070,2252,37.510509,127.093369
송파구,1233, 잠실3거리(갤러리아팰리스),201906,1247,1111,2358,37.510509,127.093369
송파구,1233, 잠실3거리(갤러리아팰리스),201907,1101,1015,2116,37.510509,127.093369
송파구,1233, 잠실3거리(갤러리아팰리스),201908,953,926,1879,37.510509,127.093369
송파구,1233, 잠실3거리(갤러리아팰리스),201909,981,929,1910,37.510509,127.093369
송파구,1233, 잠실3거리(갤러리아팰리스),201910,1034,976,2010,37.510509,127.093369
송파구,1233, 잠실3거리(갤러리아팰리스),201911,716,609,1325,37.510509,127.093369
송파구,1233, 잠실3거리(갤러리아팰리스),201912,342,295,637,37.510509,127.093369
송파구,1233, 잠실3거리(갤러리아팰리스),202001,361,284,645,37.510509,127.093369
송파구,1233, 잠실3거리(갤러리아팰리스),202002,292,266,558,37.510509,127.093369
송파구,1233, 잠실3거리(갤러리아팰리스),202003,776,673,1449,37.510509,127.093369
송파구,1233, 잠실3거리(갤러리아팰리스),202004,912,875,1787,37.510509,127.093369
송파구,1233, 잠실3거리(갤러리아팰리스),202005,1023,975,1998,37.510509,127.093369
송파구,1233, 잠실3거리(갤러리아팰리스),202006,1056,1014,2070,37.510509,127.093369
송파구,1235, 잠실트리지움310동 옆,201901,446,448,894,37.508339,127.088142
송파구,1235, 잠실트리지움310동 옆,201902,365,386,751,37.508339,127.088142
송파구,1235, 잠실트리지움310동 옆,201903,868,897,1765,37.508339,127.088142
송파구,1235, 잠실트리지움310동 옆,201904,1486,1599,3085,37.508339,127.088142
송파구,1235, 잠실트리지움310동 옆,201905,2193,2176,4369,37.508339,127.088142
송파구,1235, 잠실트리지움310동 옆,201906,2533,2548,5081,37.508339,127.088142
송파구,1235, 잠실트리지움310동 옆,201907,2364,2342,4706,37.508339,127.088142
송파구,1235, 잠실트리지움310동 옆,201908,2194,2188,4382,37.508339,127.088142
송파구,1235, 잠실트리지움310동 옆,201909,1991,1963,3954,37.508339,127.088142
송파구,1235, 잠실트리지움310동 옆,201910,2347,2337,4684,37.508339,127.088142
송파구,1235, 잠실트리지움310동 옆,201911,1418,1462,2880,37.508339,127.088142
송파구,1235, 잠실트리지움310동 옆,201912,767,821,1588,37.508339,127.088142
송파구,1235, 잠실트리지움310동 옆,202001,688,738,1426,37.508339,127.088142
송파구,1235, 잠실트리지움310동 옆,202002,578,615,1193,37.508339,127.088142
송파구,1235, 잠실트리지움310동 옆,202003,1530,1630,3160,37.508339,127.088142
송파구,1235, 잠실트리지움310동 옆,202004,1861,1869,3730,37.508339,127.088142
송파구,1235, 잠실트리지움310동 옆,202005,2241,2231,4472,37.508339,127.088142
송파구,1235, 잠실트리지움310동 옆,202006,2111,2132,4243,37.508339,127.088142
송파구,1239, 문정 법조단지3,201901,131,140,271,37.480843,127.118011
송파구,1239, 문정 법조단지3,201902,132,125,257,37.480843,127.118011
송파구,1239, 문정 법조단지3,201903,253,247,500,37.480843,127.118011
송파구,1239, 문정 법조단지3,201904,355,309,664,37.480843,127.118011
송파구,1239, 문정 법조단지3,201905,462,410,872,37.480843,127.118011
송파구,1239, 문정 법조단지3,201906,421,400,821,37.480843,127.118011
송파구,1239, 문정 법조단지3,201907,466,407,873,37.480843,127.118011
송파구,1239, 문정 법조단지3,201908,462,471,933,37.480843,127.118011
송파구,1239, 문정 법조단지3,201909,496,449,945,37.480843,127.118011
송파구,1239, 문정 법조단지3,201910,630,562,1192,37.480843,127.118011
송파구,1239, 문정 법조단지3,201911,490,411,901,37.480843,127.118011
송파구,1239, 문정 법조단지3,201912,283,255,538,37.480843,127.118011
송파구,1239, 문정 법조단지3,202001,359,266,625,37.480843,127.118011
송파구,1239, 문정 법조단지3,202002,301,276,577,37.480843,127.118011
송파구,1239, 문정 법조단지3,202003,481,383,864,37.480843,127.118011
송파구,1239, 문정 법조단지3,202004,558,504,1062,37.480843,127.118011
송파구,1239, 문정 법조단지3,202005,554,553,1107,37.480843,127.118011
송파구,1239, 문정 법조단지3,202006,565,565,1130,37.480843,127.118011
송파구,1240, 문정 법조단지4,201901,101,90,191,37.480576,127.118568
송파구,1240, 문정 법조단지4,201902,122,96,218,37.480576,127.118568
송파구,1240, 문정 법조단지4,201903,224,190,414,37.480576,127.118568
송파구,1240, 문정 법조단지4,201904,401,322,723,37.480576,127.118568
송파구,1240, 문정 법조단지4,201905,576,497,1073,37.480576,127.118568
송파구,1240, 문정 법조단지4,201906,669,644,1313,37.480576,127.118568
송파구,1240, 문정 법조단지4,201907,636,592,1228,37.480576,127.118568
송파구,1240, 문정 법조단지4,201908,497,460,957,37.480576,127.118568
송파구,1240, 문정 법조단지4,201909,592,542,1134,37.480576,127.118568
송파구,1240, 문정 법조단지4,201910,573,537,1110,37.480576,127.118568
송파구,1240, 문정 법조단지4,201911,362,318,680,37.480576,127.118568
송파구,1240, 문정 법조단지4,201912,196,163,359,37.480576,127.118568
송파구,1240, 문정 법조단지4,202001,175,163,338,37.480576,127.118568
송파구,1240, 문정 법조단지4,202002,144,130,274,37.480576,127.118568
송파구,1240, 문정 법조단지4,202003,382,371,753,37.480576,127.118568
송파구,1240, 문정 법조단지4,202004,511,503,1014,37.480576,127.118568
송파구,1240, 문정 법조단지4,202005,649,642,1291,37.480576,127.118568
송파구,1240, 문정 법조단지4,202006,696,679,1375,37.480576,127.118568
송파구,1241, 문정 법조단지5,201901,102,102,204,37.481239,127.119797
송파구,1241, 문정 법조단지5,201902,130,91,221,37.481239,127.119797
송파구,1241, 문정 법조단지5,201903,199,152,351,37.481239,127.119797
송파구,1241, 문정 법조단지5,201904,361,301,662,37.481239,127.119797
송파구,1241, 문정 법조단지5,201905,625,478,1103,37.481239,127.119797
송파구,1241, 문정 법조단지5,201906,542,454,996,37.481239,127.119797
송파구,1241, 문정 법조단지5,201907,749,436,1185,37.481239,127.119797
송파구,1241, 문정 법조단지5,201908,680,435,1115,37.481239,127.119797
송파구,1241, 문정 법조단지5,201909,675,488,1163,37.481239,127.119797
송파구,1241, 문정 법조단지5,201910,722,557,1279,37.481239,127.119797
송파구,1241, 문정 법조단지5,201911,435,276,711,37.481239,127.119797
송파구,1241, 문정 법조단지5,201912,200,92,292,37.481239,127.119797
송파구,1241, 문정 법조단지5,202001,214,111,325,37.481239,127.119797
송파구,1241, 문정 법조단지5,202002,203,124,327,37.481239,127.119797
송파구,1241, 문정 법조단지5,202003,462,321,783,37.481239,127.119797
송파구,1241, 문정 법조단지5,202004,455,392,847,37.481239,127.119797
송파구,1241, 문정 법조단지5,202005,598,520,1118,37.481239,127.119797
송파구,1241, 문정 법조단지5,202006,518,461,979,37.481239,127.119797
송파구,1242, 문정 법조단지6,201901,72,70,142,37.48209,127.119743
송파구,1242, 문정 법조단지6,201902,73,68,141,37.48209,127.119743
송파구,1242, 문정 법조단지6,201903,160,134,294,37.48209,127.119743
송파구,1242, 문정 법조단지6,201904,186,154,340,37.48209,127.119743
송파구,1242, 문정 법조단지6,201905,211,185,396,37.48209,127.119743
송파구,1242, 문정 법조단지6,201906,216,205,421,37.48209,127.119743
송파구,1242, 문정 법조단지6,201907,164,165,329,37.48209,127.119743
송파구,1242, 문정 법조단지6,201908,106,114,220,37.48209,127.119743
송파구,1242, 문정 법조단지6,201909,135,133,268,37.48209,127.119743
송파구,1242, 문정 법조단지6,201910,238,160,398,37.48209,127.119743
송파구,1242, 문정 법조단지6,201911,109,60,169,37.48209,127.119743
송파구,1242, 문정 법조단지6,201912,112,52,164,37.48209,127.119743
송파구,1242, 문정 법조단지6,202001,89,64,153,37.48209,127.119743
송파구,1242, 문정 법조단지6,202002,105,33,138,37.48209,127.119743
송파구,1242, 문정 법조단지6,202003,132,102,234,37.48209,127.119743
송파구,1242, 문정 법조단지6,202004,182,178,360,37.48209,127.119743
송파구,1242, 문정 법조단지6,202005,235,221,456,37.48209,127.119743
송파구,1242, 문정 법조단지6,202006,184,169,353,37.48209,127.119743
송파구,1243, 문정 법조단지7,201901,794,891,1685,37.484531,127.120163
송파구,1243, 문정 법조단지7,201902,704,767,1471,37.484531,127.120163
송파구,1243, 문정 법조단지7,201903,1273,1305,2578,37.484531,127.120163
송파구,1243, 문정 법조단지7,201904,2082,2169,4251,37.484531,127.120163
송파구,1243, 문정 법조단지7,201905,3261,3243,6504,37.484531,127.120163
송파구,1243, 문정 법조단지7,201906,3211,3145,6356,37.484531,127.120163
송파구,1243, 문정 법조단지7,201907,3374,3344,6718,37.484531,127.120163
송파구,1243, 문정 법조단지7,201908,2957,2939,5896,37.484531,127.120163
송파구,1243, 문정 법조단지7,201909,3105,3173,6278,37.484531,127.120163
송파구,1243, 문정 법조단지7,201910,3723,3726,7449,37.484531,127.120163
송파구,1243, 문정 법조단지7,201911,2303,2387,4690,37.484531,127.120163
송파구,1243, 문정 법조단지7,201912,1415,1367,2782,37.484531,127.120163
송파구,1243, 문정 법조단지7,202001,1301,1344,2645,37.484531,127.120163
송파구,1243, 문정 법조단지7,202002,1161,1219,2380,37.484531,127.120163
송파구,1243, 문정 법조단지7,202003,2174,2097,4271,37.484531,127.120163
송파구,1243, 문정 법조단지7,202004,2722,2703,5425,37.484531,127.120163
송파구,1243, 문정 법조단지7,202005,2870,2943,5813,37.484531,127.120163
송파구,1243, 문정 법조단지7,202006,3028,3173,6201,37.484531,127.120163
송파구,1244, 문정 법조단지8,201901,559,565,1124,37.481537,127.122124
송파구,1244, 문정 법조단지8,201902,527,549,1076,37.481537,127.122124
송파구,1244, 문정 법조단지8,201903,1130,1147,2277,37.481537,127.122124
송파구,1244, 문정 법조단지8,201904,1921,1966,3887,37.481537,127.122124
송파구,1244, 문정 법조단지8,201905,3169,3159,6328,37.481537,127.122124
송파구,1244, 문정 법조단지8,201906,3164,3187,6351,37.481537,127.122124
송파구,1244, 문정 법조단지8,201907,2954,2946,5900,37.481537,127.122124
송파구,1244, 문정 법조단지8,201908,2798,2797,5595,37.481537,127.122124
송파구,1244, 문정 법조단지8,201909,2886,2903,5789,37.481537,127.122124
송파구,1244, 문정 법조단지8,201910,3288,3279,6567,37.481537,127.122124
송파구,1244, 문정 법조단지8,201911,1784,1803,3587,37.481537,127.122124
송파구,1244, 문정 법조단지8,201912,1047,1040,2087,37.481537,127.122124
송파구,1244, 문정 법조단지8,202001,891,882,1773,37.481537,127.122124
송파구,1244, 문정 법조단지8,202002,715,726,1441,37.481537,127.122124
송파구,1244, 문정 법조단지8,202003,1427,1418,2845,37.481537,127.122124
송파구,1244, 문정 법조단지8,202004,2106,2111,4217,37.481537,127.122124
송파구,1244, 문정 법조단지8,202005,2631,2610,5241,37.481537,127.122124
송파구,1244, 문정 법조단지8,202006,2794,2780,5574,37.481537,127.122124
송파구,1245, 문정 법조단지9,201901,446,451,897,37.479465,127.125328
송파구,1245, 문정 법조단지9,201902,478,473,951,37.479465,127.125328
송파구,1245, 문정 법조단지9,201903,747,724,1471,37.479465,127.125328
송파구,1245, 문정 법조단지9,201904,1294,1257,2551,37.479465,127.125328
송파구,1245, 문정 법조단지9,201905,2085,2076,4161,37.479465,127.125328
송파구,1245, 문정 법조단지9,201906,2462,2431,4893,37.479465,127.125328
송파구,1245, 문정 법조단지9,201907,2213,2178,4391,37.479465,127.125328
송파구,1245, 문정 법조단지9,201908,1865,1855,3720,37.479465,127.125328
송파구,1245, 문정 법조단지9,201909,2016,1996,4012,37.479465,127.125328
송파구,1245, 문정 법조단지9,201910,2465,2439,4904,37.479465,127.125328
송파구,1245, 문정 법조단지9,201911,1476,1466,2942,37.479465,127.125328
송파구,1245, 문정 법조단지9,201912,818,780,1598,37.479465,127.125328
송파구,1245, 문정 법조단지9,202001,731,733,1464,37.479465,127.125328
송파구,1245, 문정 법조단지9,202002,689,686,1375,37.479465,127.125328
송파구,1245, 문정 법조단지9,202003,1199,1199,2398,37.479465,127.125328
송파구,1245, 문정 법조단지9,202004,1669,1618,3287,37.479465,127.125328
송파구,1245, 문정 법조단지9,202005,1875,1854,3729,37.479465,127.125328
송파구,1245, 문정 법조단지9,202006,1952,1915,3867,37.479465,127.125328
송파구,1246, 문정 법조단지10,201901,564,475,1039,37.477509,127.126328
송파구,1246, 문정 법조단지10,201902,400,371,771,37.477509,127.126328
송파구,1246, 문정 법조단지10,201903,797,721,1518,37.477509,127.126328
송파구,1246, 문정 법조단지10,201904,1259,1210,2469,37.477509,127.126328
송파구,1246, 문정 법조단지10,201905,1884,1843,3727,37.477509,127.126328
송파구,1246, 문정 법조단지10,201906,1825,1816,3641,37.477509,127.126328
송파구,1246, 문정 법조단지10,201907,1699,1691,3390,37.477509,127.126328
송파구,1246, 문정 법조단지10,201908,1359,1377,2736,37.477509,127.126328
송파구,1246, 문정 법조단지10,201909,1689,1594,3283,37.477509,127.126328
송파구,1246, 문정 법조단지10,201910,1978,1933,3911,37.477509,127.126328
송파구,1246, 문정 법조단지10,201911,1474,1375,2849,37.477509,127.126328
송파구,1246, 문정 법조단지10,201912,763,741,1504,37.477509,127.126328
송파구,1246, 문정 법조단지10,202001,922,688,1610,37.477509,127.126328
송파구,1246, 문정 법조단지10,202002,795,732,1527,37.477509,127.126328
송파구,1246, 문정 법조단지10,202003,1246,1196,2442,37.477509,127.126328
송파구,1246, 문정 법조단지10,202004,1622,1588,3210,37.477509,127.126328
송파구,1246, 문정 법조단지10,202005,1765,1743,3508,37.477509,127.126328
송파구,1246, 문정 법조단지10,202006,1799,1768,3567,37.477509,127.126328
송파구,1247, 문정 법조단지11,201901,395,328,723,37.478821,127.123512
송파구,1247, 문정 법조단지11,201902,398,353,751,37.478821,127.123512
송파구,1247, 문정 법조단지11,201903,668,630,1298,37.478821,127.123512
송파구,1247, 문정 법조단지11,201904,1023,951,1974,37.478821,127.123512
송파구,1247, 문정 법조단지11,201905,1348,1273,2621,37.478821,127.123512
송파구,1247, 문정 법조단지11,201906,1338,1300,2638,37.478821,127.123512
송파구,1247, 문정 법조단지11,201907,1316,1291,2607,37.478821,127.123512
송파구,1247, 문정 법조단지11,201908,1224,1167,2391,37.478821,127.123512
송파구,1247, 문정 법조단지11,201909,1182,1120,2302,37.478821,127.123512
송파구,1247, 문정 법조단지11,201910,1550,1535,3085,37.478821,127.123512
송파구,1247, 문정 법조단지11,201911,982,945,1927,37.478821,127.123512
송파구,1247, 문정 법조단지11,201912,674,622,1296,37.478821,127.123512
송파구,1247, 문정 법조단지11,202001,579,547,1126,37.478821,127.123512
송파구,1247, 문정 법조단지11,202002,436,437,873,37.478821,127.123512
송파구,1247, 문정 법조단지11,202003,868,866,1734,37.478821,127.123512
송파구,1247, 문정 법조단지11,202004,1209,1188,2397,37.478821,127.123512
송파구,1247, 문정 법조단지11,202005,1202,1159,2361,37.478821,127.123512
송파구,1247, 문정 법조단지11,202006,1265,1206,2471,37.478821,127.123512
송파구,1248, 방이초등학교,201901,379,303,682,37.513962,127.121674
송파구,1248, 방이초등학교,201902,307,264,571,37.513962,127.121674
송파구,1248, 방이초등학교,201903,746,701,1447,37.513962,127.121674
송파구,1248, 방이초등학교,201904,1328,1166,2494,37.513962,127.121674
송파구,1248, 방이초등학교,201905,2045,1732,3777,37.513962,127.121674
송파구,1248, 방이초등학교,201906,2430,1997,4427,37.513962,127.121674
송파구,1248, 방이초등학교,201907,2391,1988,4379,37.513962,127.121674
송파구,1248, 방이초등학교,201908,2035,1725,3760,37.513962,127.121674
송파구,1248, 방이초등학교,201909,2021,1616,3637,37.513962,127.121674
송파구,1248, 방이초등학교,201910,2556,1973,4529,37.513962,127.121674
송파구,1248, 방이초등학교,201911,1447,1152,2599,37.513962,127.121674
송파구,1248, 방이초등학교,201912,836,739,1575,37.513962,127.121674
송파구,1248, 방이초등학교,202001,743,686,1429,37.513962,127.121674
송파구,1248, 방이초등학교,202002,730,662,1392,37.513962,127.121674
송파구,1248, 방이초등학교,202003,1328,1087,2415,37.513962,127.121674
송파구,1248, 방이초등학교,202004,1884,1620,3504,37.513962,127.121674
송파구,1248, 방이초등학교,202005,1998,1780,3778,37.513962,127.121674
송파구,1248, 방이초등학교,202006,2563,2255,4818,37.513962,127.121674
송파구,1249, 아주중학교건너편,201901,424,438,862,37.505463,127.077347
송파구,1249, 아주중학교건너편,201902,405,434,839,37.505463,127.077347
송파구,1249, 아주중학교건너편,201903,645,675,1320,37.505463,127.077347
송파구,1249, 아주중학교건너편,201904,823,867,1690,37.505463,127.077347
송파구,1249, 아주중학교건너편,201905,1209,1314,2523,37.505463,127.077347
송파구,1249, 아주중학교건너편,201906,1413,1454,2867,37.505463,127.077347
송파구,1249, 아주중학교건너편,201907,1325,1441,2766,37.505463,127.077347
송파구,1249, 아주중학교건너편,201908,1308,1379,2687,37.505463,127.077347
송파구,1249, 아주중학교건너편,201909,1275,1388,2663,37.505463,127.077347
송파구,1249, 아주중학교건너편,201910,1502,1598,3100,37.505463,127.077347
송파구,1249, 아주중학교건너편,201911,992,1010,2002,37.505463,127.077347
송파구,1249, 아주중학교건너편,201912,544,567,1111,37.505463,127.077347
송파구,1249, 아주중학교건너편,202001,502,525,1027,37.505463,127.077347
송파구,1249, 아주중학교건너편,202002,491,515,1006,37.505463,127.077347
송파구,1249, 아주중학교건너편,202003,763,806,1569,37.505463,127.077347
송파구,1249, 아주중학교건너편,202004,995,1082,2077,37.505463,127.077347
송파구,1249, 아주중학교건너편,202005,1387,1436,2823,37.505463,127.077347
송파구,1249, 아주중학교건너편,202006,1471,1519,2990,37.505463,127.077347
송파구,1250,문정2동 주민센터,201901,88,90,178,37.489872,127.11084
송파구,1250,문정2동 주민센터,201902,105,117,222,37.489872,127.11084
송파구,1250,문정2동 주민센터,201903,257,257,514,37.489872,127.11084
송파구,1250,문정2동 주민센터,201904,353,368,721,37.489872,127.11084
송파구,1250,문정2동 주민센터,201905,519,517,1036,37.489872,127.11084
송파구,1250,문정2동 주민센터,201906,480,493,973,37.489872,127.11084
송파구,1250,문정2동 주민센터,201907,522,547,1069,37.489872,127.11084
송파구,1250,문정2동 주민센터,201908,539,550,1089,37.489872,127.11084
송파구,1250,문정2동 주민센터,201909,561,569,1130,37.489872,127.11084
송파구,1250,문정2동 주민센터,201910,554,553,1107,37.489872,127.11084
송파구,1250,문정2동 주민센터,201911,359,369,728,37.489872,127.11084
송파구,1250,문정2동 주민센터,201912,213,232,445,37.489872,127.11084
송파구,1250,문정2동 주민센터,202001,207,209,416,37.489872,127.11084
송파구,1250,문정2동 주민센터,202002,209,215,424,37.489872,127.11084
송파구,1250,문정2동 주민센터,202003,470,468,938,37.489872,127.11084
송파구,1250,문정2동 주민센터,202004,607,602,1209,37.489872,127.11084
송파구,1250,문정2동 주민센터,202005,680,673,1353,37.489872,127.11084
송파구,1250,문정2동 주민센터,202006,715,718,1433,37.489872,127.11084
송파구,1251, 석촌역 2번출구,201901,659,670,1329,37.505932,127.10775
송파구,1251, 석촌역 2번출구,201902,646,690,1336,37.505932,127.10775
송파구,1251, 석촌역 2번출구,201903,1537,1561,3098,37.505932,127.10775
송파구,1251, 석촌역 2번출구,201904,2393,2386,4779,37.505932,127.10775
송파구,1251, 석촌역 2번출구,201905,3899,3878,7777,37.505932,127.10775
송파구,1251, 석촌역 2번출구,201906,4485,4484,8969,37.505932,127.10775
송파구,1251, 석촌역 2번출구,201907,3914,3914,7828,37.505932,127.10775
송파구,1251, 석촌역 2번출구,201908,3752,3767,7519,37.505932,127.10775
송파구,1251, 석촌역 2번출구,201909,3821,3802,7623,37.505932,127.10775
송파구,1251, 석촌역 2번출구,201910,4571,4592,9163,37.505932,127.10775
송파구,1251, 석촌역 2번출구,201911,2666,2680,5346,37.505932,127.10775
송파구,1251, 석촌역 2번출구,201912,1520,1512,3032,37.505932,127.10775
송파구,1251, 석촌역 2번출구,202001,1313,1343,2656,37.505932,127.10775
송파구,1251, 석촌역 2번출구,202002,1425,1436,2861,37.505932,127.10775
송파구,1251, 석촌역 2번출구,202003,2894,2913,5807,37.505932,127.10775
송파구,1251, 석촌역 2번출구,202004,3484,3494,6978,37.505932,127.10775
송파구,1251, 석촌역 2번출구,202005,3489,3482,6971,37.505932,127.10775
송파구,1251, 석촌역 2번출구,202006,3031,3021,6052,37.505932,127.10775
송파구,1253, 오금역 3번 출구 뒤,201901,232,175,407,37.501652,127.128181
송파구,1253, 오금역 3번 출구 뒤,201902,196,179,375,37.501652,127.128181
송파구,1253, 오금역 3번 출구 뒤,201903,348,269,617,37.501652,127.128181
송파구,1253, 오금역 3번 출구 뒤,201904,689,589,1278,37.501652,127.128181
송파구,1253, 오금역 3번 출구 뒤,201905,878,813,1691,37.501652,127.128181
송파구,1253, 오금역 3번 출구 뒤,201906,1053,877,1930,37.501652,127.128181
송파구,1253, 오금역 3번 출구 뒤,201907,858,774,1632,37.501652,127.128181
송파구,1253, 오금역 3번 출구 뒤,201908,815,770,1585,37.501652,127.128181
송파구,1253, 오금역 3번 출구 뒤,201909,891,789,1680,37.501652,127.128181
송파구,1253, 오금역 3번 출구 뒤,201910,673,633,1306,37.501652,127.128181
송파구,1253, 오금역 3번 출구 뒤,201912,224,182,406,37.501652,127.128181
송파구,1253, 오금역 3번 출구 뒤,202001,446,309,755,37.501652,127.128181
송파구,1253, 오금역 3번 출구 뒤,202002,430,361,791,37.501652,127.128181
송파구,1253, 오금역 3번 출구 뒤,202003,733,608,1341,37.501652,127.128181
송파구,1253, 오금역 3번 출구 뒤,202004,907,818,1725,37.501652,127.128181
송파구,1253, 오금역 3번 출구 뒤,202005,801,783,1584,37.501652,127.128181
송파구,1253, 오금역 3번 출구 뒤,202006,865,830,1695,37.501652,127.128181
송파구,1256, 문정현대아파트 교차로,201901,201,180,381,37.491131,127.125809
송파구,1256, 문정현대아파트 교차로,201902,249,228,477,37.491131,127.125809
송파구,1256, 문정현대아파트 교차로,201903,447,375,822,37.491131,127.125809
송파구,1256, 문정현대아파트 교차로,201904,756,676,1432,37.491131,127.125809
송파구,1256, 문정현대아파트 교차로,201905,1222,1165,2387,37.491131,127.125809
송파구,1256, 문정현대아파트 교차로,201906,1397,1378,2775,37.491131,127.125809
송파구,1256, 문정현대아파트 교차로,201907,1431,1409,2840,37.491131,127.125809
송파구,1256, 문정현대아파트 교차로,201908,1154,1142,2296,37.491131,127.125809
송파구,1256, 문정현대아파트 교차로,201909,1138,1124,2262,37.491131,127.125809
송파구,1256, 문정현대아파트 교차로,201910,1343,1333,2676,37.491131,127.125809
송파구,1256, 문정현대아파트 교차로,201911,802,725,1527,37.491131,127.125809
송파구,1256, 문정현대아파트 교차로,201912,455,409,864,37.491131,127.125809
송파구,1256, 문정현대아파트 교차로,202001,445,385,830,37.491131,127.125809
송파구,1256, 문정현대아파트 교차로,202002,400,388,788,37.491131,127.125809
송파구,1256, 문정현대아파트 교차로,202003,641,649,1290,37.491131,127.125809
송파구,1256, 문정현대아파트 교차로,202004,905,900,1805,37.491131,127.125809
송파구,1256, 문정현대아파트 교차로,202005,1172,1177,2349,37.491131,127.125809
송파구,1256, 문정현대아파트 교차로,202006,1173,1178,2351,37.491131,127.125809
송파구,1257, 가락시장역 롯데마트앞,201901,342,335,677,37.4921,127.117752
송파구,1257, 가락시장역 롯데마트앞,201902,320,315,635,37.4921,127.117752
송파구,1257, 가락시장역 롯데마트앞,201903,502,479,981,37.4921,127.117752
송파구,1257, 가락시장역 롯데마트앞,201904,1009,957,1966,37.4921,127.117752
송파구,1257, 가락시장역 롯데마트앞,201905,1702,1596,3298,37.4921,127.117752
송파구,1257, 가락시장역 롯데마트앞,201906,1765,1765,3530,37.4921,127.117752
송파구,1257, 가락시장역 롯데마트앞,201907,1739,1738,3477,37.4921,127.117752
송파구,1257, 가락시장역 롯데마트앞,201908,1635,1605,3240,37.4921,127.117752
송파구,1257, 가락시장역 롯데마트앞,201909,1829,1822,3651,37.4921,127.117752
송파구,1257, 가락시장역 롯데마트앞,201910,2093,2097,4190,37.4921,127.117752
송파구,1257, 가락시장역 롯데마트앞,201911,1209,1172,2381,37.4921,127.117752
송파구,1257, 가락시장역 롯데마트앞,201912,710,695,1405,37.4921,127.117752
송파구,1257, 가락시장역 롯데마트앞,202001,664,655,1319,37.4921,127.117752
송파구,1257, 가락시장역 롯데마트앞,202002,531,529,1060,37.4921,127.117752
송파구,1257, 가락시장역 롯데마트앞,202003,1175,1156,2331,37.4921,127.117752
송파구,1257, 가락시장역 롯데마트앞,202004,1754,1709,3463,37.4921,127.117752
송파구,1257, 가락시장역 롯데마트앞,202005,1866,1845,3711,37.4921,127.117752
송파구,1257, 가락시장역 롯데마트앞,202006,1964,1958,3922,37.4921,127.117752
송파구,1258, 가락미륭아파트 앞,201901,270,124,394,37.493198,127.128998
송파구,1258, 가락미륭아파트 앞,201902,223,134,357,37.493198,127.128998
송파구,1258, 가락미륭아파트 앞,201903,323,217,540,37.493198,127.128998
송파구,1258, 가락미륭아파트 앞,201904,499,355,854,37.493198,127.128998
송파구,1258, 가락미륭아파트 앞,201905,726,495,1221,37.493198,127.128998
송파구,1258, 가락미륭아파트 앞,201906,597,464,1061,37.493198,127.128998
송파구,1258, 가락미륭아파트 앞,201907,390,286,676,37.493198,127.128998
송파구,1258, 가락미륭아파트 앞,201908,630,474,1104,37.493198,127.128998
송파구,1258, 가락미륭아파트 앞,201909,528,428,956,37.493198,127.128998
송파구,1258, 가락미륭아파트 앞,201910,708,624,1332,37.493198,127.128998
송파구,1258, 가락미륭아파트 앞,201911,433,386,819,37.493198,127.128998
송파구,1258, 가락미륭아파트 앞,201912,208,195,403,37.493198,127.128998
송파구,1258, 가락미륭아파트 앞,202001,275,199,474,37.493198,127.128998
송파구,1258, 가락미륭아파트 앞,202002,203,159,362,37.493198,127.128998
송파구,1258, 가락미륭아파트 앞,202003,332,290,622,37.493198,127.128998
송파구,1258, 가락미륭아파트 앞,202004,447,423,870,37.493198,127.128998
송파구,1258, 가락미륭아파트 앞,202005,504,465,969,37.493198,127.128998
송파구,1258, 가락미륭아파트 앞,202006,433,418,851,37.493198,127.128998
송파구,1259, 방이역 1번출구,201901,486,563,1049,37.508984,127.126595
송파구,1259, 방이역 1번출구,201902,437,461,898,37.508984,127.126595
송파구,1259, 방이역 1번출구,201903,824,832,1656,37.508984,127.126595
송파구,1259, 방이역 1번출구,201904,1308,1276,2584,37.508984,127.126595
송파구,1259, 방이역 1번출구,201905,1927,1899,3826,37.508984,127.126595
송파구,1259, 방이역 1번출구,201906,2216,2169,4385,37.508984,127.126595
송파구,1259, 방이역 1번출구,201907,2070,2069,4139,37.508984,127.126595
송파구,1259, 방이역 1번출구,201908,2093,2086,4179,37.508984,127.126595
송파구,1259, 방이역 1번출구,201909,1958,1981,3939,37.508984,127.126595
송파구,1259, 방이역 1번출구,201910,2250,2233,4483,37.508984,127.126595
송파구,1259, 방이역 1번출구,201911,1240,1306,2546,37.508984,127.126595
송파구,1259, 방이역 1번출구,201912,730,731,1461,37.508984,127.126595
송파구,1259, 방이역 1번출구,202001,728,766,1494,37.508984,127.126595
송파구,1259, 방이역 1번출구,202002,639,651,1290,37.508984,127.126595
송파구,1259, 방이역 1번출구,202003,1321,1300,2621,37.508984,127.126595
송파구,1259, 방이역 1번출구,202004,2079,2068,4147,37.508984,127.126595
송파구,1259, 방이역 1번출구,202005,2362,2362,4724,37.508984,127.126595
송파구,1259, 방이역 1번출구,202006,2407,2391,4798,37.508984,127.126595
송파구,1260, 방이동 한양3차아파트 옆,201901,423,450,873,37.506302,127.121399
송파구,1260, 방이동 한양3차아파트 옆,201902,366,365,731,37.506302,127.121399
송파구,1260, 방이동 한양3차아파트 옆,201903,659,643,1302,37.506302,127.121399
송파구,1260, 방이동 한양3차아파트 옆,201904,1121,1073,2194,37.506302,127.121399
송파구,1260, 방이동 한양3차아파트 옆,201905,1840,1836,3676,37.506302,127.121399
송파구,1260, 방이동 한양3차아파트 옆,201906,2097,2126,4223,37.506302,127.121399
송파구,1260, 방이동 한양3차아파트 옆,201907,1849,1840,3689,37.506302,127.121399
송파구,1260, 방이동 한양3차아파트 옆,201908,1727,1707,3434,37.506302,127.121399
송파구,1260, 방이동 한양3차아파트 옆,201909,1765,1761,3526,37.506302,127.121399
송파구,1260, 방이동 한양3차아파트 옆,201910,1992,2017,4009,37.506302,127.121399
송파구,1260, 방이동 한양3차아파트 옆,201911,1198,1195,2393,37.506302,127.121399
송파구,1260, 방이동 한양3차아파트 옆,201912,624,614,1238,37.506302,127.121399
송파구,1260, 방이동 한양3차아파트 옆,202001,652,643,1295,37.506302,127.121399
송파구,1260, 방이동 한양3차아파트 옆,202002,509,512,1021,37.506302,127.121399
송파구,1260, 방이동 한양3차아파트 옆,202003,1239,1233,2472,37.506302,127.121399
송파구,1260, 방이동 한양3차아파트 옆,202004,1653,1668,3321,37.506302,127.121399
송파구,1260, 방이동 한양3차아파트 옆,202005,1702,1699,3401,37.506302,127.121399
송파구,1260, 방이동 한양3차아파트 옆,202006,1819,1809,3628,37.506302,127.121399
송파구,1262, 송파여성문화회관 앞,201901,393,394,787,37.505802,127.109718
송파구,1262, 송파여성문화회관 앞,201902,376,353,729,37.505802,127.109718
송파구,1262, 송파여성문화회관 앞,201903,757,765,1522,37.505802,127.109718
송파구,1262, 송파여성문화회관 앞,201904,1241,1272,2513,37.505802,127.109718
송파구,1262, 송파여성문화회관 앞,201905,2176,2153,4329,37.505802,127.109718
송파구,1262, 송파여성문화회관 앞,201906,2012,1985,3997,37.505802,127.109718
송파구,1262, 송파여성문화회관 앞,201907,2197,2146,4343,37.505802,127.109718
송파구,1262, 송파여성문화회관 앞,201908,2072,2049,4121,37.505802,127.109718
송파구,1262, 송파여성문화회관 앞,201909,2051,2061,4112,37.505802,127.109718
송파구,1262, 송파여성문화회관 앞,201910,2474,2471,4945,37.505802,127.109718
송파구,1262, 송파여성문화회관 앞,201911,1513,1488,3001,37.505802,127.109718
송파구,1262, 송파여성문화회관 앞,201912,792,785,1577,37.505802,127.109718
송파구,1262, 송파여성문화회관 앞,202001,795,767,1562,37.505802,127.109718
송파구,1262, 송파여성문화회관 앞,202002,618,600,1218,37.505802,127.109718
송파구,1262, 송파여성문화회관 앞,202003,1236,1220,2456,37.505802,127.109718
송파구,1262, 송파여성문화회관 앞,202004,1620,1622,3242,37.505802,127.109718
송파구,1262, 송파여성문화회관 앞,202005,1868,1844,3712,37.505802,127.109718
송파구,1262, 송파여성문화회관 앞,202006,2015,2007,4022,37.505802,127.109718
송파구,1263, 장지공영차고지,201901,61,72,133,37.480541,127.137016
송파구,1263, 장지공영차고지,201902,50,65,115,37.480541,127.137016
송파구,1263, 장지공영차고지,201903,112,113,225,37.480541,127.137016
송파구,1263, 장지공영차고지,201904,235,235,470,37.480541,127.137016
송파구,1263, 장지공영차고지,201905,321,295,616,37.480541,127.137016
송파구,1263, 장지공영차고지,201906,333,291,624,37.480541,127.137016
송파구,1263, 장지공영차고지,201907,358,333,691,37.480541,127.137016
송파구,1263, 장지공영차고지,201908,283,269,552,37.480541,127.137016
송파구,1263, 장지공영차고지,201909,314,313,627,37.480541,127.137016
송파구,1263, 장지공영차고지,201910,441,447,888,37.480541,127.137016
송파구,1263, 장지공영차고지,201911,352,315,667,37.480541,127.137016
송파구,1263, 장지공영차고지,201912,195,195,390,37.480541,127.137016
송파구,1263, 장지공영차고지,202001,131,135,266,37.480541,127.137016
송파구,1263, 장지공영차고지,202002,180,159,339,37.480541,127.137016
송파구,1263, 장지공영차고지,202003,212,216,428,37.480541,127.137016
송파구,1263, 장지공영차고지,202004,274,268,542,37.480541,127.137016
송파구,1263, 장지공영차고지,202005,307,305,612,37.480541,127.137016
송파구,1263, 장지공영차고지,202006,338,341,679,37.480541,127.137016
송파구,1264, 천호역 10번 출구 앞,201901,360,404,764,37.538582,127.122803
송파구,1264, 천호역 10번 출구 앞,201902,400,457,857,37.538582,127.122803
송파구,1264, 천호역 10번 출구 앞,201903,812,833,1645,37.538582,127.122803
송파구,1264, 천호역 10번 출구 앞,201904,1330,1361,2691,37.538582,127.122803
송파구,1264, 천호역 10번 출구 앞,201905,2420,2414,4834,37.538582,127.122803
송파구,1264, 천호역 10번 출구 앞,201906,2533,2551,5084,37.538582,127.122803
송파구,1264, 천호역 10번 출구 앞,201907,2319,2329,4648,37.538582,127.122803
송파구,1264, 천호역 10번 출구 앞,201908,2302,2351,4653,37.538582,127.122803
송파구,1264, 천호역 10번 출구 앞,201909,2354,2398,4752,37.538582,127.122803
송파구,1264, 천호역 10번 출구 앞,201910,2727,2801,5528,37.538582,127.122803
송파구,1264, 천호역 10번 출구 앞,201911,1815,1869,3684,37.538582,127.122803
송파구,1264, 천호역 10번 출구 앞,201912,951,968,1919,37.538582,127.122803
송파구,1264, 천호역 10번 출구 앞,202001,771,808,1579,37.538582,127.122803
송파구,1264, 천호역 10번 출구 앞,202002,873,944,1817,37.538582,127.122803
송파구,1264, 천호역 10번 출구 앞,202003,1894,1961,3855,37.538582,127.122803
송파구,1264, 천호역 10번 출구 앞,202004,2367,2425,4792,37.538582,127.122803
송파구,1264, 천호역 10번 출구 앞,202005,2849,2928,5777,37.538582,127.122803
송파구,1264, 천호역 10번 출구 앞,202006,2859,2915,5774,37.538582,127.122803
송파구,1265, 문정동 근린공원,201901,450,573,1023,37.486149,127.124802
송파구,1265, 문정동 근린공원,201902,516,603,1119,37.486149,127.124802
송파구,1265, 문정동 근린공원,201903,1015,1099,2114,37.486149,127.124802
송파구,1265, 문정동 근린공원,201904,1486,1573,3059,37.486149,127.124802
송파구,1265, 문정동 근린공원,201905,2342,2296,4638,37.486149,127.124802
송파구,1265, 문정동 근린공원,201906,2704,2749,5453,37.486149,127.124802
송파구,1265, 문정동 근린공원,201907,2739,2801,5540,37.486149,127.124802
송파구,1265, 문정동 근린공원,201908,2471,2492,4963,37.486149,127.124802
송파구,1265, 문정동 근린공원,201909,2540,2557,5097,37.486149,127.124802
송파구,1265, 문정동 근린공원,201910,3003,3069,6072,37.486149,127.124802
송파구,1265, 문정동 근린공원,201911,1986,2084,4070,37.486149,127.124802
송파구,1265, 문정동 근린공원,201912,1134,1160,2294,37.486149,127.124802
송파구,1265, 문정동 근린공원,202001,935,1002,1937,37.486149,127.124802
송파구,1265, 문정동 근린공원,202002,795,834,1629,37.486149,127.124802
송파구,1265, 문정동 근린공원,202003,1512,1564,3076,37.486149,127.124802
송파구,1265, 문정동 근린공원,202004,2016,2021,4037,37.486149,127.124802
송파구,1265, 문정동 근린공원,202005,2214,2212,4426,37.486149,127.124802
송파구,1265, 문정동 근린공원,202006,2211,2195,4406,37.486149,127.124802
송파구,1266, 문정동 글샘 공원,201901,98,116,214,37.478809,127.120003
송파구,1266, 문정동 글샘 공원,201902,121,121,242,37.478809,127.120003
송파구,1266, 문정동 글샘 공원,201903,232,211,443,37.478809,127.120003
송파구,1266, 문정동 글샘 공원,201904,325,324,649,37.478809,127.120003
송파구,1266, 문정동 글샘 공원,201905,648,556,1204,37.478809,127.120003
송파구,1266, 문정동 글샘 공원,201906,676,670,1346,37.478809,127.120003
송파구,1266, 문정동 글샘 공원,201907,659,565,1224,37.478809,127.120003
송파구,1266, 문정동 글샘 공원,201908,635,607,1242,37.478809,127.120003
송파구,1266, 문정동 글샘 공원,201909,585,570,1155,37.478809,127.120003
송파구,1266, 문정동 글샘 공원,201910,667,657,1324,37.478809,127.120003
송파구,1266, 문정동 글샘 공원,201911,400,385,785,37.478809,127.120003
송파구,1266, 문정동 글샘 공원,201912,218,201,419,37.478809,127.120003
송파구,1266, 문정동 글샘 공원,202001,170,170,340,37.478809,127.120003
송파구,1266, 문정동 글샘 공원,202002,176,167,343,37.478809,127.120003
송파구,1266, 문정동 글샘 공원,202003,387,370,757,37.478809,127.120003
송파구,1266, 문정동 글샘 공원,202004,560,539,1099,37.478809,127.120003
송파구,1266, 문정동 글샘 공원,202005,571,566,1137,37.478809,127.120003
송파구,1266, 문정동 글샘 공원,202006,675,653,1328,37.478809,127.120003
송파구,1267, 올림픽공원 남2문 앞,201901,229,208,437,#N/A,#N/A
송파구,1267, 올림픽공원 남2문 앞,201902,273,264,537,#N/A,#N/A
송파구,1267, 올림픽공원 남2문 앞,201903,621,551,1172,#N/A,#N/A
송파구,1267, 올림픽공원 남2문 앞,201904,1135,1018,2153,#N/A,#N/A
송파구,1267, 올림픽공원 남2문 앞,201905,1811,1693,3504,#N/A,#N/A
송파구,1267, 올림픽공원 남2문 앞,201906,1913,1735,3648,#N/A,#N/A
송파구,1267, 올림픽공원 남2문 앞,201907,1487,1306,2793,#N/A,#N/A
송파구,1267, 올림픽공원 남2문 앞,201908,1399,1261,2660,#N/A,#N/A
송파구,1267, 올림픽공원 남2문 앞,201909,1706,1556,3262,#N/A,#N/A
송파구,1267, 올림픽공원 남2문 앞,201910,2409,2109,4518,#N/A,#N/A
송파구,1267, 올림픽공원 남2문 앞,201911,1256,1069,2325,#N/A,#N/A
송파구,1267, 올림픽공원 남2문 앞,201912,586,470,1056,#N/A,#N/A
송파구,1267, 올림픽공원 남2문 앞,202001,424,336,760,#N/A,#N/A
송파구,1267, 올림픽공원 남2문 앞,202002,485,358,843,#N/A,#N/A
송파구,1267, 올림픽공원 남2문 앞,202003,1203,1087,2290,#N/A,#N/A
송파구,1267, 올림픽공원 남2문 앞,202004,1416,1276,2692,#N/A,#N/A
송파구,1267, 올림픽공원 남2문 앞,202005,1729,1563,3292,#N/A,#N/A
송파구,1267, 올림픽공원 남2문 앞,202006,1161,1015,2176,#N/A,#N/A
송파구,1268, 몽촌토성역 1번출구 옆,201901,503,547,1050,#N/A,#N/A
송파구,1268, 몽촌토성역 1번출구 옆,201902,651,678,1329,#N/A,#N/A
송파구,1268, 몽촌토성역 1번출구 옆,201903,1450,1437,2887,#N/A,#N/A
송파구,1268, 몽촌토성역 1번출구 옆,201904,3292,3227,6519,#N/A,#N/A
송파구,1268, 몽촌토성역 1번출구 옆,201905,5339,5328,10667,#N/A,#N/A
송파구,1268, 몽촌토성역 1번출구 옆,201906,4410,4311,8721,#N/A,#N/A
송파구,1268, 몽촌토성역 1번출구 옆,201907,3537,3415,6952,#N/A,#N/A
송파구,1268, 몽촌토성역 1번출구 옆,201908,3982,3942,7924,#N/A,#N/A
송파구,1268, 몽촌토성역 1번출구 옆,201909,4774,4716,9490,#N/A,#N/A
송파구,1268, 몽촌토성역 1번출구 옆,201910,5121,5122,10243,#N/A,#N/A
송파구,1268, 몽촌토성역 1번출구 옆,201911,2534,2650,5184,#N/A,#N/A
송파구,1268, 몽촌토성역 1번출구 옆,201912,770,813,1583,#N/A,#N/A
송파구,1268, 몽촌토성역 1번출구 옆,202001,1042,1063,2105,#N/A,#N/A
송파구,1268, 몽촌토성역 1번출구 옆,202002,1021,1035,2056,#N/A,#N/A
송파구,1268, 몽촌토성역 1번출구 옆,202003,3565,3627,7192,#N/A,#N/A
송파구,1268, 몽촌토성역 1번출구 옆,202004,4886,4896,9782,#N/A,#N/A
송파구,1268, 몽촌토성역 1번출구 옆,202005,5212,5187,10399,#N/A,#N/A
송파구,1268, 몽촌토성역 1번출구 옆,202006,3908,3879,7787,#N/A,#N/A
송파구,1269, 리센츠아파트,201901,369,333,702,37.511944,127.091217
송파구,1269, 리센츠아파트,201902,358,335,693,37.511944,127.091217
송파구,1269, 리센츠아파트,201903,743,683,1426,37.511944,127.091217
송파구,1269, 리센츠아파트,201904,1127,1046,2173,37.511944,127.091217
송파구,1269, 리센츠아파트,201905,1624,1446,3070,37.511944,127.091217
송파구,1269, 리센츠아파트,201906,1838,1566,3404,37.511944,127.091217
송파구,1269, 리센츠아파트,201907,1614,1443,3057,37.511944,127.091217
송파구,1269, 리센츠아파트,201908,1756,1537,3293,37.511944,127.091217
송파구,1269, 리센츠아파트,201909,1440,1294,2734,37.511944,127.091217
송파구,1269, 리센츠아파트,201910,1749,1590,3339,37.511944,127.091217
송파구,1269, 리센츠아파트,201911,1000,940,1940,37.511944,127.091217
송파구,1269, 리센츠아파트,201912,589,462,1051,37.511944,127.091217
송파구,1269, 리센츠아파트,202001,555,482,1037,37.511944,127.091217
송파구,1269, 리센츠아파트,202002,580,514,1094,37.511944,127.091217
송파구,1269, 리센츠아파트,202003,1188,1085,2273,37.511944,127.091217
송파구,1269, 리센츠아파트,202004,1314,1236,2550,37.511944,127.091217
송파구,1269, 리센츠아파트,202005,1378,1314,2692,37.511944,127.091217
송파구,1269, 리센츠아파트,202006,1693,1514,3207,37.511944,127.091217
송파구,1271, 송파도서관,201901,368,367,735,37.499985,127.135391
송파구,1271, 송파도서관,201902,365,343,708,37.499985,127.135391
송파구,1271, 송파도서관,201903,664,651,1315,37.499985,127.135391
송파구,1271, 송파도서관,201904,1176,1119,2295,37.499985,127.135391
송파구,1271, 송파도서관,201905,1574,1533,3107,37.499985,127.135391
송파구,1271, 송파도서관,201906,1670,1622,3292,37.499985,127.135391
송파구,1271, 송파도서관,201907,1698,1640,3338,37.499985,127.135391
송파구,1271, 송파도서관,201908,1462,1432,2894,37.499985,127.135391
송파구,1271, 송파도서관,201909,1517,1476,2993,37.499985,127.135391
송파구,1271, 송파도서관,201910,1749,1750,3499,37.499985,127.135391
송파구,1271, 송파도서관,201911,898,880,1778,37.499985,127.135391
송파구,1271, 송파도서관,201912,679,665,1344,37.499985,127.135391
송파구,1271, 송파도서관,202001,749,747,1496,37.499985,127.135391
송파구,1271, 송파도서관,202002,444,445,889,37.499985,127.135391
송파구,1271, 송파도서관,202003,734,722,1456,37.499985,127.135391
송파구,1271, 송파도서관,202004,1082,1096,2178,37.499985,127.135391
송파구,1271, 송파도서관,202005,1446,1429,2875,37.499985,127.135391
송파구,1271, 송파도서관,202006,947,937,1884,37.499985,127.135391
송파구,1274, 영파여고 앞,201901,233,195,428,37.532848,127.121048
송파구,1274, 영파여고 앞,201902,180,183,363,37.532848,127.121048
송파구,1274, 영파여고 앞,201903,335,322,657,37.532848,127.121048
송파구,1274, 영파여고 앞,201904,565,589,1154,37.532848,127.121048
송파구,1274, 영파여고 앞,201905,1058,997,2055,37.532848,127.121048
송파구,1274, 영파여고 앞,201906,1109,1045,2154,37.532848,127.121048
송파구,1274, 영파여고 앞,201907,1105,940,2045,37.532848,127.121048
송파구,1274, 영파여고 앞,201908,1142,1001,2143,37.532848,127.121048
송파구,1274, 영파여고 앞,201909,1093,939,2032,37.532848,127.121048
송파구,1274, 영파여고 앞,201910,1288,1160,2448,37.532848,127.121048
송파구,1274, 영파여고 앞,201911,731,634,1365,37.532848,127.121048
송파구,1274, 영파여고 앞,201912,411,357,768,37.532848,127.121048
송파구,1274, 영파여고 앞,202001,333,265,598,37.532848,127.121048
송파구,1274, 영파여고 앞,202002,364,329,693,37.532848,127.121048
송파구,1274, 영파여고 앞,202003,842,639,1481,37.532848,127.121048
송파구,1274, 영파여고 앞,202004,1013,863,1876,37.532848,127.121048
송파구,1274, 영파여고 앞,202005,1086,966,2052,37.532848,127.121048
송파구,1274, 영파여고 앞,202006,1336,1169,2505,37.532848,127.121048
송파구,1275, 거여초등학교 옆,201901,151,155,306,37.504589,127.139366
송파구,1275, 거여초등학교 옆,201902,138,132,270,37.504589,127.139366
송파구,1275, 거여초등학교 옆,201903,207,214,421,37.504589,127.139366
송파구,1275, 거여초등학교 옆,201904,322,345,667,37.504589,127.139366
송파구,1275, 거여초등학교 옆,201905,569,588,1157,37.504589,127.139366
송파구,1275, 거여초등학교 옆,201906,619,638,1257,37.504589,127.139366
송파구,1275, 거여초등학교 옆,201907,503,532,1035,37.504589,127.139366
송파구,1275, 거여초등학교 옆,201908,495,520,1015,37.504589,127.139366
송파구,1275, 거여초등학교 옆,201909,555,576,1131,37.504589,127.139366
송파구,1275, 거여초등학교 옆,201910,628,658,1286,37.504589,127.139366
송파구,1275, 거여초등학교 옆,201911,448,484,932,37.504589,127.139366
송파구,1275, 거여초등학교 옆,201912,276,317,593,37.504589,127.139366
송파구,1275, 거여초등학교 옆,202001,254,286,540,37.504589,127.139366
송파구,1275, 거여초등학교 옆,202002,246,226,472,37.504589,127.139366
송파구,1275, 거여초등학교 옆,202003,408,376,784,37.504589,127.139366
송파구,1275, 거여초등학교 옆,202004,578,591,1169,37.504589,127.139366
송파구,1275, 거여초등학교 옆,202005,652,644,1296,37.504589,127.139366
송파구,1275, 거여초등학교 옆,202006,630,664,1294,37.504589,127.139366
송파구,1277, 오금동 송파 참병원,201901,176,274,450,37.503757,127.137093
송파구,1277, 오금동 송파 참병원,201902,240,307,547,37.503757,127.137093
송파구,1277, 오금동 송파 참병원,201903,420,528,948,37.503757,127.137093
송파구,1277, 오금동 송파 참병원,201904,690,885,1575,37.503757,127.137093
송파구,1277, 오금동 송파 참병원,201905,1267,1470,2737,37.503757,127.137093
송파구,1277, 오금동 송파 참병원,201906,1370,1512,2882,37.503757,127.137093
송파구,1277, 오금동 송파 참병원,201907,1500,1719,3219,37.503757,127.137093
송파구,1277, 오금동 송파 참병원,201908,1511,1631,3142,37.503757,127.137093
송파구,1277, 오금동 송파 참병원,201909,1430,1531,2961,37.503757,127.137093
송파구,1277, 오금동 송파 참병원,201910,1673,1821,3494,37.503757,127.137093
송파구,1277, 오금동 송파 참병원,201911,967,1107,2074,37.503757,127.137093
송파구,1277, 오금동 송파 참병원,201912,752,824,1576,37.503757,127.137093
송파구,1277, 오금동 송파 참병원,202001,565,630,1195,37.503757,127.137093
송파구,1277, 오금동 송파 참병원,202002,536,670,1206,37.503757,127.137093
송파구,1277, 오금동 송파 참병원,202003,1192,1397,2589,37.503757,127.137093
송파구,1277, 오금동 송파 참병원,202004,1634,1840,3474,37.503757,127.137093
송파구,1277, 오금동 송파 참병원,202005,1808,1900,3708,37.503757,127.137093
송파구,1277, 오금동 송파 참병원,202006,1597,1751,3348,37.503757,127.137093
송파구,1278, 송파구청 교차로,201901,642,714,1356,37.515831,127.106796
송파구,1278, 송파구청 교차로,201902,610,688,1298,37.515831,127.106796
송파구,1278, 송파구청 교차로,201903,1061,1187,2248,37.515831,127.106796
송파구,1278, 송파구청 교차로,201904,1980,2017,3997,37.515831,127.106796
송파구,1278, 송파구청 교차로,201905,2934,3033,5967,37.515831,127.106796
송파구,1278, 송파구청 교차로,201906,2656,2842,5498,37.515831,127.106796
송파구,1278, 송파구청 교차로,201907,2540,2845,5385,37.515831,127.106796
송파구,1278, 송파구청 교차로,201908,2595,2754,5349,37.515831,127.106796
송파구,1278, 송파구청 교차로,201909,2689,2819,5508,37.515831,127.106796
송파구,1278, 송파구청 교차로,201910,3186,3275,6461,37.515831,127.106796
송파구,1278, 송파구청 교차로,201911,1838,1973,3811,37.515831,127.106796
송파구,1278, 송파구청 교차로,201912,965,1056,2021,37.515831,127.106796
송파구,1278, 송파구청 교차로,202001,822,869,1691,37.515831,127.106796
송파구,1278, 송파구청 교차로,202002,856,963,1819,37.515831,127.106796
송파구,1278, 송파구청 교차로,202003,1798,1941,3739,37.515831,127.106796
송파구,1278, 송파구청 교차로,202004,2587,2808,5395,37.515831,127.106796
송파구,1278, 송파구청 교차로,202005,2994,3180,6174,37.515831,127.106796
송파구,1278, 송파구청 교차로,202006,2910,3244,6154,37.515831,127.106796
송파구,1279, 마천금호어울림 1차아파트 건너편,201901,80,85,165,37.497517,127.154678
송파구,1279, 마천금호어울림 1차아파트 건너편,201902,105,99,204,37.497517,127.154678
송파구,1279, 마천금호어울림 1차아파트 건너편,201903,201,196,397,37.497517,127.154678
송파구,1279, 마천금호어울림 1차아파트 건너편,201904,402,417,819,37.497517,127.154678
송파구,1279, 마천금호어울림 1차아파트 건너편,201905,638,685,1323,37.497517,127.154678
송파구,1279, 마천금호어울림 1차아파트 건너편,201906,712,801,1513,37.497517,127.154678
송파구,1279, 마천금호어울림 1차아파트 건너편,201907,673,690,1363,37.497517,127.154678
송파구,1279, 마천금호어울림 1차아파트 건너편,201908,588,647,1235,37.497517,127.154678
송파구,1279, 마천금호어울림 1차아파트 건너편,201909,565,646,1211,37.497517,127.154678
송파구,1279, 마천금호어울림 1차아파트 건너편,201910,666,694,1360,37.497517,127.154678
송파구,1279, 마천금호어울림 1차아파트 건너편,201911,398,423,821,37.497517,127.154678
송파구,1279, 마천금호어울림 1차아파트 건너편,201912,226,242,468,37.497517,127.154678
송파구,1279, 마천금호어울림 1차아파트 건너편,202001,233,238,471,37.497517,127.154678
송파구,1279, 마천금호어울림 1차아파트 건너편,202002,247,249,496,37.497517,127.154678
송파구,1279, 마천금호어울림 1차아파트 건너편,202003,449,514,963,37.497517,127.154678
송파구,1279, 마천금호어울림 1차아파트 건너편,202004,694,717,1411,37.497517,127.154678
송파구,1279, 마천금호어울림 1차아파트 건너편,202005,884,890,1774,37.497517,127.154678
송파구,1279, 마천금호어울림 1차아파트 건너편,202006,829,856,1685,37.497517,127.154678
송파구,1280, 송파파크데일 2단지입구 앞 주차장,201901,191,132,323,37.495659,127.157173
송파구,1280, 송파파크데일 2단지입구 앞 주차장,201902,212,144,356,37.495659,127.157173
송파구,1280, 송파파크데일 2단지입구 앞 주차장,201903,377,293,670,37.495659,127.157173
송파구,1280, 송파파크데일 2단지입구 앞 주차장,201904,467,355,822,37.495659,127.157173
송파구,1280, 송파파크데일 2단지입구 앞 주차장,201905,641,602,1243,37.495659,127.157173
송파구,1280, 송파파크데일 2단지입구 앞 주차장,201906,799,715,1514,37.495659,127.157173
송파구,1280, 송파파크데일 2단지입구 앞 주차장,201907,708,674,1382,37.495659,127.157173
송파구,1280, 송파파크데일 2단지입구 앞 주차장,201908,697,674,1371,37.495659,127.157173
송파구,1280, 송파파크데일 2단지입구 앞 주차장,201909,661,637,1298,37.495659,127.157173
송파구,1280, 송파파크데일 2단지입구 앞 주차장,201910,772,731,1503,37.495659,127.157173
송파구,1280, 송파파크데일 2단지입구 앞 주차장,201911,497,422,919,37.495659,127.157173
송파구,1280, 송파파크데일 2단지입구 앞 주차장,201912,227,212,439,37.495659,127.157173
송파구,1280, 송파파크데일 2단지입구 앞 주차장,202001,214,181,395,37.495659,127.157173
송파구,1280, 송파파크데일 2단지입구 앞 주차장,202002,266,192,458,37.495659,127.157173
송파구,1280, 송파파크데일 2단지입구 앞 주차장,202003,515,462,977,37.495659,127.157173
송파구,1280, 송파파크데일 2단지입구 앞 주차장,202004,811,730,1541,37.495659,127.157173
송파구,1280, 송파파크데일 2단지입구 앞 주차장,202005,900,882,1782,37.495659,127.157173
송파구,1280, 송파파크데일 2단지입구 앞 주차장,202006,857,831,1688,37.495659,127.157173
송파구,1282, 송파소방서 맞은편(성내4교),201901,277,297,574,37.499874,127.141479
송파구,1282, 송파소방서 맞은편(성내4교),201902,252,289,541,37.499874,127.141479
송파구,1282, 송파소방서 맞은편(성내4교),201903,418,586,1004,37.499874,127.141479
송파구,1282, 송파소방서 맞은편(성내4교),201904,931,1194,2125,37.499874,127.141479
송파구,1282, 송파소방서 맞은편(성내4교),201905,1493,1919,3412,37.499874,127.141479
송파구,1282, 송파소방서 맞은편(성내4교),201906,1677,2158,3835,37.499874,127.141479
송파구,1282, 송파소방서 맞은편(성내4교),201907,1809,2376,4185,37.499874,127.141479
송파구,1282, 송파소방서 맞은편(성내4교),201908,1750,2343,4093,37.499874,127.141479
송파구,1282, 송파소방서 맞은편(성내4교),201909,1932,2337,4269,37.499874,127.141479
송파구,1282, 송파소방서 맞은편(성내4교),201910,1981,2489,4470,37.499874,127.141479
송파구,1282, 송파소방서 맞은편(성내4교),201911,761,960,1721,37.499874,127.141479
송파구,1282, 송파소방서 맞은편(성내4교),202001,341,421,762,37.499874,127.141479
송파구,1282, 송파소방서 맞은편(성내4교),202002,523,668,1191,37.499874,127.141479
송파구,1282, 송파소방서 맞은편(성내4교),202003,1176,1391,2567,37.499874,127.141479
송파구,1282, 송파소방서 맞은편(성내4교),202004,2023,2344,4367,37.499874,127.141479
송파구,1282, 송파소방서 맞은편(성내4교),202005,2047,2297,4344,37.499874,127.141479
송파구,1282, 송파소방서 맞은편(성내4교),202006,1984,2424,4408,37.499874,127.141479
송파구,1283, 오금공원 사거리,201901,169,102,271,37.505455,127.131752
송파구,1283, 오금공원 사거리,201902,128,75,203,37.505455,127.131752
송파구,1283, 오금공원 사거리,201903,187,149,336,37.505455,127.131752
송파구,1283, 오금공원 사거리,201904,426,282,708,37.505455,127.131752
송파구,1283, 오금공원 사거리,201905,488,420,908,37.505455,127.131752
송파구,1283, 오금공원 사거리,201906,554,439,993,37.505455,127.131752
송파구,1283, 오금공원 사거리,201907,542,444,986,37.505455,127.131752
송파구,1283, 오금공원 사거리,201908,510,385,895,37.505455,127.131752
송파구,1283, 오금공원 사거리,201909,446,388,834,37.505455,127.131752
송파구,1283, 오금공원 사거리,201910,552,482,1034,37.505455,127.131752
송파구,1283, 오금공원 사거리,201911,401,260,661,37.505455,127.131752
송파구,1283, 오금공원 사거리,201912,237,164,401,37.505455,127.131752
송파구,1283, 오금공원 사거리,202001,295,177,472,37.505455,127.131752
송파구,1283, 오금공원 사거리,202002,211,145,356,37.505455,127.131752
송파구,1283, 오금공원 사거리,202003,307,228,535,37.505455,127.131752
송파구,1283, 오금공원 사거리,202004,464,357,821,37.505455,127.131752
송파구,1283, 오금공원 사거리,202005,393,368,761,37.505455,127.131752
송파구,1283, 오금공원 사거리,202006,326,284,610,37.505455,127.131752
송파구,1285, 위례별 유치원 뒤,201901,150,135,285,37.47747,127.144592
송파구,1285, 위례별 유치원 뒤,201902,134,109,243,37.47747,127.144592
송파구,1285, 위례별 유치원 뒤,201903,355,305,660,37.47747,127.144592
송파구,1285, 위례별 유치원 뒤,201904,587,534,1121,37.47747,127.144592
송파구,1285, 위례별 유치원 뒤,201905,984,960,1944,37.47747,127.144592
송파구,1285, 위례별 유치원 뒤,201906,1031,949,1980,37.47747,127.144592
송파구,1285, 위례별 유치원 뒤,201907,777,721,1498,37.47747,127.144592
송파구,1285, 위례별 유치원 뒤,201908,560,512,1072,37.47747,127.144592
송파구,1285, 위례별 유치원 뒤,201909,622,579,1201,37.47747,127.144592
송파구,1285, 위례별 유치원 뒤,201910,817,796,1613,37.47747,127.144592
송파구,1285, 위례별 유치원 뒤,201911,537,460,997,37.47747,127.144592
송파구,1285, 위례별 유치원 뒤,201912,234,197,431,37.47747,127.144592
송파구,1285, 위례별 유치원 뒤,202001,213,180,393,37.47747,127.144592
송파구,1285, 위례별 유치원 뒤,202002,282,260,542,37.47747,127.144592
송파구,1285, 위례별 유치원 뒤,202003,596,562,1158,37.47747,127.144592
송파구,1285, 위례별 유치원 뒤,202004,871,834,1705,37.47747,127.144592
송파구,1285, 위례별 유치원 뒤,202005,863,828,1691,37.47747,127.144592
송파구,1285, 위례별 유치원 뒤,202006,689,651,1340,37.47747,127.144592
송파구,1286, 위례중앙푸르지오 1단지 앞,201901,330,278,608,37.474377,127.140671
송파구,1286, 위례중앙푸르지오 1단지 앞,201902,320,278,598,37.474377,127.140671
송파구,1286, 위례중앙푸르지오 1단지 앞,201903,540,494,1034,37.474377,127.140671
송파구,1286, 위례중앙푸르지오 1단지 앞,201904,879,851,1730,37.474377,127.140671
송파구,1286, 위례중앙푸르지오 1단지 앞,201905,1575,1572,3147,37.474377,127.140671
송파구,1286, 위례중앙푸르지오 1단지 앞,201906,1767,1722,3489,37.474377,127.140671
송파구,1286, 위례중앙푸르지오 1단지 앞,201907,1438,1399,2837,37.474377,127.140671
송파구,1286, 위례중앙푸르지오 1단지 앞,201908,1287,1263,2550,37.474377,127.140671
송파구,1286, 위례중앙푸르지오 1단지 앞,201909,1270,1233,2503,37.474377,127.140671
송파구,1286, 위례중앙푸르지오 1단지 앞,201910,1460,1458,2918,37.474377,127.140671
송파구,1286, 위례중앙푸르지오 1단지 앞,201911,905,893,1798,37.474377,127.140671
송파구,1286, 위례중앙푸르지오 1단지 앞,201912,472,452,924,37.474377,127.140671
송파구,1286, 위례중앙푸르지오 1단지 앞,202001,485,468,953,37.474377,127.140671
송파구,1286, 위례중앙푸르지오 1단지 앞,202002,417,416,833,37.474377,127.140671
송파구,1286, 위례중앙푸르지오 1단지 앞,202003,1064,1049,2113,37.474377,127.140671
송파구,1286, 위례중앙푸르지오 1단지 앞,202004,1422,1405,2827,37.474377,127.140671
송파구,1286, 위례중앙푸르지오 1단지 앞,202005,1748,1742,3490,37.474377,127.140671
송파구,1286, 위례중앙푸르지오 1단지 앞,202006,1772,1757,3529,37.474377,127.140671
송파구,1287, 위례아이파크 101동 맞은편,201901,141,81,222,37.477531,127.141518
송파구,1287, 위례아이파크 101동 맞은편,201902,122,98,220,37.477531,127.141518
송파구,1287, 위례아이파크 101동 맞은편,201903,195,158,353,37.477531,127.141518
송파구,1287, 위례아이파크 101동 맞은편,201904,313,280,593,37.477531,127.141518
송파구,1287, 위례아이파크 101동 맞은편,201905,530,508,1038,37.477531,127.141518
송파구,1287, 위례아이파크 101동 맞은편,201906,598,559,1157,37.477531,127.141518
송파구,1287, 위례아이파크 101동 맞은편,201907,477,462,939,37.477531,127.141518
송파구,1287, 위례아이파크 101동 맞은편,201908,462,426,888,37.477531,127.141518
송파구,1287, 위례아이파크 101동 맞은편,201909,505,476,981,37.477531,127.141518
송파구,1287, 위례아이파크 101동 맞은편,201910,607,573,1180,37.477531,127.141518
송파구,1287, 위례아이파크 101동 맞은편,201911,380,360,740,37.477531,127.141518
송파구,1287, 위례아이파크 101동 맞은편,201912,247,235,482,37.477531,127.141518
송파구,1287, 위례아이파크 101동 맞은편,202001,214,186,400,37.477531,127.141518
송파구,1287, 위례아이파크 101동 맞은편,202002,182,168,350,37.477531,127.141518
송파구,1287, 위례아이파크 101동 맞은편,202003,412,404,816,37.477531,127.141518
송파구,1287, 위례아이파크 101동 맞은편,202004,573,547,1120,37.477531,127.141518
송파구,1287, 위례아이파크 101동 맞은편,202005,699,667,1366,37.477531,127.141518
송파구,1287, 위례아이파크 101동 맞은편,202006,697,632,1329,37.477531,127.141518
송파구,1288, 문정중교 사거리,201901,632,489,1121,37.487999,127.131088
송파구,1288, 문정중교 사거리,201902,562,490,1052,37.487999,127.131088
송파구,1288, 문정중교 사거리,201903,932,787,1719,37.487999,127.131088
송파구,1288, 문정중교 사거리,201904,1394,1204,2598,37.487999,127.131088
송파구,1288, 문정중교 사거리,201905,2181,1866,4047,37.487999,127.131088
송파구,1288, 문정중교 사거리,201906,2212,2049,4261,37.487999,127.131088
송파구,1288, 문정중교 사거리,201907,2607,2098,4705,37.487999,127.131088
송파구,1288, 문정중교 사거리,201908,2370,1988,4358,37.487999,127.131088
송파구,1288, 문정중교 사거리,201909,2015,1885,3900,37.487999,127.131088
송파구,1288, 문정중교 사거리,201910,2247,2072,4319,37.487999,127.131088
송파구,1288, 문정중교 사거리,201911,1601,1323,2924,37.487999,127.131088
송파구,1288, 문정중교 사거리,201912,660,587,1247,37.487999,127.131088
송파구,1288, 문정중교 사거리,202001,855,695,1550,37.487999,127.131088
송파구,1288, 문정중교 사거리,202002,693,546,1239,37.487999,127.131088
송파구,1288, 문정중교 사거리,202003,1125,1021,2146,37.487999,127.131088
송파구,1288, 문정중교 사거리,202004,1518,1410,2928,37.487999,127.131088
송파구,1288, 문정중교 사거리,202005,1581,1533,3114,37.487999,127.131088
송파구,1288, 문정중교 사거리,202006,1857,1723,3580,37.487999,127.131088
송파구,1289, 풍납동 자전거보관소,201901,83,79,162,37.531471,127.111092
송파구,1289, 풍납동 자전거보관소,201902,92,104,196,37.531471,127.111092
송파구,1289, 풍납동 자전거보관소,201903,289,303,592,37.531471,127.111092
송파구,1289, 풍납동 자전거보관소,201904,494,539,1033,37.531471,127.111092
송파구,1289, 풍납동 자전거보관소,201905,741,841,1582,37.531471,127.111092
송파구,1289, 풍납동 자전거보관소,201906,704,841,1545,37.531471,127.111092
송파구,1289, 풍납동 자전거보관소,201907,735,843,1578,37.531471,127.111092
송파구,1289, 풍납동 자전거보관소,201908,615,742,1357,37.531471,127.111092
송파구,1289, 풍납동 자전거보관소,201909,750,843,1593,37.531471,127.111092
송파구,1289, 풍납동 자전거보관소,201910,800,874,1674,37.531471,127.111092
송파구,1289, 풍납동 자전거보관소,201911,467,503,970,37.531471,127.111092
송파구,1289, 풍납동 자전거보관소,201912,198,197,395,37.531471,127.111092
송파구,1289, 풍납동 자전거보관소,202001,163,150,313,37.531471,127.111092
송파구,1289, 풍납동 자전거보관소,202002,174,183,357,37.531471,127.111092
송파구,1289, 풍납동 자전거보관소,202003,602,621,1223,37.531471,127.111092
송파구,1289, 풍납동 자전거보관소,202004,797,800,1597,37.531471,127.111092
송파구,1289, 풍납동 자전거보관소,202005,930,948,1878,37.531471,127.111092
송파구,1289, 풍납동 자전거보관소,202006,743,794,1537,37.531471,127.111092
송파구,1290, 위례송파꿈에그린아파트24단지 앞 성벽 다리 밑,201901,256,225,481,37.474659,127.137718
송파구,1290, 위례송파꿈에그린아파트24단지 앞 성벽 다리 밑,201902,248,231,479,37.474659,127.137718
송파구,1290, 위례송파꿈에그린아파트24단지 앞 성벽 다리 밑,201903,407,409,816,37.474659,127.137718
송파구,1290, 위례송파꿈에그린아파트24단지 앞 성벽 다리 밑,201904,555,548,1103,37.474659,127.137718
송파구,1290, 위례송파꿈에그린아파트24단지 앞 성벽 다리 밑,201905,833,842,1675,37.474659,127.137718
송파구,1290, 위례송파꿈에그린아파트24단지 앞 성벽 다리 밑,201906,918,910,1828,37.474659,127.137718
송파구,1290, 위례송파꿈에그린아파트24단지 앞 성벽 다리 밑,201907,771,763,1534,37.474659,127.137718
송파구,1290, 위례송파꿈에그린아파트24단지 앞 성벽 다리 밑,201908,767,742,1509,37.474659,127.137718
송파구,1290, 위례송파꿈에그린아파트24단지 앞 성벽 다리 밑,201909,725,743,1468,37.474659,127.137718
송파구,1290, 위례송파꿈에그린아파트24단지 앞 성벽 다리 밑,201910,929,902,1831,37.474659,127.137718
송파구,1290, 위례송파꿈에그린아파트24단지 앞 성벽 다리 밑,201911,560,554,1114,37.474659,127.137718
송파구,1290, 위례송파꿈에그린아파트24단지 앞 성벽 다리 밑,201912,262,259,521,37.474659,127.137718
송파구,1290, 위례송파꿈에그린아파트24단지 앞 성벽 다리 밑,202001,299,302,601,37.474659,127.137718
송파구,1290, 위례송파꿈에그린아파트24단지 앞 성벽 다리 밑,202002,412,378,790,37.474659,127.137718
송파구,1290, 위례송파꿈에그린아파트24단지 앞 성벽 다리 밑,202003,702,713,1415,37.474659,127.137718
송파구,1290, 위례송파꿈에그린아파트24단지 앞 성벽 다리 밑,202004,858,835,1693,37.474659,127.137718
송파구,1290, 위례송파꿈에그린아파트24단지 앞 성벽 다리 밑,202005,1012,1010,2022,37.474659,127.137718
송파구,1290, 위례송파꿈에그린아파트24단지 앞 성벽 다리 밑,202006,868,847,1715,37.474659,127.137718
송파구,1291, 서울체육고등학교 앞,201901,139,204,343,37.521938,127.131866
송파구,1291, 서울체육고등학교 앞,201902,150,196,346,37.521938,127.131866
송파구,1291, 서울체육고등학교 앞,201903,580,671,1251,37.521938,127.131866
송파구,1291, 서울체육고등학교 앞,201904,1128,1270,2398,37.521938,127.131866
송파구,1291, 서울체육고등학교 앞,201905,1637,1771,3408,37.521938,127.131866
송파구,1291, 서울체육고등학교 앞,201906,1608,1736,3344,37.521938,127.131866
송파구,1291, 서울체육고등학교 앞,201907,1309,1400,2709,37.521938,127.131866
송파구,1291, 서울체육고등학교 앞,201908,1469,1554,3023,37.521938,127.131866
송파구,1291, 서울체육고등학교 앞,201909,1885,2110,3995,37.521938,127.131866
송파구,1291, 서울체육고등학교 앞,201910,2215,2488,4703,37.521938,127.131866
송파구,1291, 서울체육고등학교 앞,201911,1413,1609,3022,37.521938,127.131866
송파구,1291, 서울체육고등학교 앞,201912,526,571,1097,37.521938,127.131866
송파구,1291, 서울체육고등학교 앞,202001,321,370,691,37.521938,127.131866
송파구,1291, 서울체육고등학교 앞,202002,343,376,719,37.521938,127.131866
송파구,1291, 서울체육고등학교 앞,202003,774,810,1584,37.521938,127.131866
송파구,1291, 서울체육고등학교 앞,202004,1290,1305,2595,37.521938,127.131866
송파구,1291, 서울체육고등학교 앞,202005,1553,1577,3130,37.521938,127.131866
송파구,1291, 서울체육고등학교 앞,202006,864,862,1726,37.521938,127.131866
송파구,1293, 석촌호교차로 (스타벅스 앞),201901,591,598,1189,37.506561,127.096558
송파구,1293, 석촌호교차로 (스타벅스 앞),201902,410,457,867,37.506561,127.096558
송파구,1293, 석촌호교차로 (스타벅스 앞),201903,896,873,1769,37.506561,127.096558
송파구,1293, 석촌호교차로 (스타벅스 앞),201904,1570,1585,3155,37.506561,127.096558
송파구,1293, 석촌호교차로 (스타벅스 앞),201905,2599,2550,5149,37.506561,127.096558
송파구,1293, 석촌호교차로 (스타벅스 앞),201906,3151,3114,6265,37.506561,127.096558
송파구,1293, 석촌호교차로 (스타벅스 앞),201907,2959,2968,5927,37.506561,127.096558
송파구,1293, 석촌호교차로 (스타벅스 앞),201908,2963,2890,5853,37.506561,127.096558
송파구,1293, 석촌호교차로 (스타벅스 앞),201909,2790,2744,5534,37.506561,127.096558
송파구,1293, 석촌호교차로 (스타벅스 앞),201910,3196,3218,6414,37.506561,127.096558
송파구,1293, 석촌호교차로 (스타벅스 앞),201911,1836,1987,3823,37.506561,127.096558
송파구,1293, 석촌호교차로 (스타벅스 앞),201912,985,1010,1995,37.506561,127.096558
송파구,1293, 석촌호교차로 (스타벅스 앞),202001,990,980,1970,37.506561,127.096558
송파구,1293, 석촌호교차로 (스타벅스 앞),202002,980,981,1961,37.506561,127.096558
송파구,1293, 석촌호교차로 (스타벅스 앞),202003,1735,1748,3483,37.506561,127.096558
송파구,1293, 석촌호교차로 (스타벅스 앞),202004,1973,1999,3972,37.506561,127.096558
송파구,1293, 석촌호교차로 (스타벅스 앞),202005,2431,2428,4859,37.506561,127.096558
송파구,1293, 석촌호교차로 (스타벅스 앞),202006,2779,2796,5575,37.506561,127.096558
송파구,1295, 잠실역 8번출구,201901,748,745,1493,37.513962,127.100304
송파구,1295, 잠실역 8번출구,201902,934,851,1785,37.513962,127.100304
송파구,1295, 잠실역 8번출구,201903,2187,1859,4046,37.513962,127.100304
송파구,1295, 잠실역 8번출구,201904,3525,3385,6910,37.513962,127.100304
송파구,1295, 잠실역 8번출구,201905,4866,4842,9708,37.513962,127.100304
송파구,1295, 잠실역 8번출구,201906,4705,4721,9426,37.513962,127.100304
송파구,1295, 잠실역 8번출구,201907,4005,3989,7994,37.513962,127.100304
송파구,1295, 잠실역 8번출구,201908,4112,4097,8209,37.513962,127.100304
송파구,1295, 잠실역 8번출구,201909,4602,4597,9199,37.513962,127.100304
송파구,1295, 잠실역 8번출구,201910,5688,5678,11366,37.513962,127.100304
송파구,1295, 잠실역 8번출구,201911,3043,3050,6093,37.513962,127.100304
송파구,1295, 잠실역 8번출구,201912,1322,1323,2645,37.513962,127.100304
송파구,1295, 잠실역 8번출구,202001,1362,1371,2733,37.513962,127.100304
송파구,1295, 잠실역 8번출구,202002,1434,1431,2865,37.513962,127.100304
송파구,1295, 잠실역 8번출구,202003,4056,4060,8116,37.513962,127.100304
송파구,1295, 잠실역 8번출구,202004,4824,4793,9617,37.513962,127.100304
송파구,1295, 잠실역 8번출구,202005,5139,5129,10268,37.513962,127.100304
송파구,1295, 잠실역 8번출구,202006,4738,4794,9532,37.513962,127.100304
송파구,1296, 석촌호수교차로 (송파나루근린공원 앞),201901,182,175,357,37.508678,127.103432
송파구,1296, 석촌호수교차로 (송파나루근린공원 앞),201902,137,129,266,37.508678,127.103432
송파구,1296, 석촌호수교차로 (송파나루근린공원 앞),201903,305,306,611,37.508678,127.103432
송파구,1296, 석촌호수교차로 (송파나루근린공원 앞),201904,924,816,1740,37.508678,127.103432
송파구,1296, 석촌호수교차로 (송파나루근린공원 앞),201905,999,927,1926,37.508678,127.103432
송파구,1296, 석촌호수교차로 (송파나루근린공원 앞),201906,1061,992,2053,37.508678,127.103432
송파구,1296, 석촌호수교차로 (송파나루근린공원 앞),201907,883,842,1725,37.508678,127.103432
송파구,1296, 석촌호수교차로 (송파나루근린공원 앞),201908,968,919,1887,37.508678,127.103432
송파구,1296, 석촌호수교차로 (송파나루근린공원 앞),201909,974,887,1861,37.508678,127.103432
송파구,1296, 석촌호수교차로 (송파나루근린공원 앞),201910,1091,1057,2148,37.508678,127.103432
송파구,1296, 석촌호수교차로 (송파나루근린공원 앞),201911,629,569,1198,37.508678,127.103432
송파구,1296, 석촌호수교차로 (송파나루근린공원 앞),201912,267,262,529,37.508678,127.103432
송파구,1296, 석촌호수교차로 (송파나루근린공원 앞),202001,350,339,689,37.508678,127.103432
송파구,1296, 석촌호수교차로 (송파나루근린공원 앞),202002,279,261,540,37.508678,127.103432
송파구,1296, 석촌호수교차로 (송파나루근린공원 앞),202003,769,698,1467,37.508678,127.103432
송파구,1296, 석촌호수교차로 (송파나루근린공원 앞),202004,821,808,1629,37.508678,127.103432
송파구,1296, 석촌호수교차로 (송파나루근린공원 앞),202005,939,939,1878,37.508678,127.103432
송파구,1296, 석촌호수교차로 (송파나루근린공원 앞),202006,915,885,1800,37.508678,127.103432
송파구,1297, 석촌호수교차로(동호 팔각정 앞),201901,386,339,725,37.509201,127.104118
송파구,1297, 석촌호수교차로(동호 팔각정 앞),201902,425,379,804,37.509201,127.104118
송파구,1297, 석촌호수교차로(동호 팔각정 앞),201903,822,749,1571,37.509201,127.104118
송파구,1297, 석촌호수교차로(동호 팔각정 앞),201904,1662,1523,3185,37.509201,127.104118
송파구,1297, 석촌호수교차로(동호 팔각정 앞),201905,2094,1935,4029,37.509201,127.104118
송파구,1297, 석촌호수교차로(동호 팔각정 앞),201906,2092,1977,4069,37.509201,127.104118
송파구,1297, 석촌호수교차로(동호 팔각정 앞),201907,1868,1781,3649,37.509201,127.104118
송파구,1297, 석촌호수교차로(동호 팔각정 앞),201908,2032,1840,3872,37.509201,127.104118
송파구,1297, 석촌호수교차로(동호 팔각정 앞),201909,2069,1927,3996,37.509201,127.104118
송파구,1297, 석촌호수교차로(동호 팔각정 앞),201910,2547,2428,4975,37.509201,127.104118
송파구,1297, 석촌호수교차로(동호 팔각정 앞),201911,1682,1636,3318,37.509201,127.104118
송파구,1297, 석촌호수교차로(동호 팔각정 앞),201912,677,626,1303,37.509201,127.104118
송파구,1297, 석촌호수교차로(동호 팔각정 앞),202001,569,484,1053,37.509201,127.104118
송파구,1297, 석촌호수교차로(동호 팔각정 앞),202002,585,532,1117,37.509201,127.104118
송파구,1297, 석촌호수교차로(동호 팔각정 앞),202003,1680,1577,3257,37.509201,127.104118
송파구,1297, 석촌호수교차로(동호 팔각정 앞),202004,1914,1863,3777,37.509201,127.104118
송파구,1297, 석촌호수교차로(동호 팔각정 앞),202005,2056,2041,4097,37.509201,127.104118
송파구,1297, 석촌호수교차로(동호 팔각정 앞),202006,2074,2028,4102,37.509201,127.104118
송파구,1299, 송파소방서 (방이119안전센터),201901,178,99,277,37.519878,127.136711
송파구,1299, 송파소방서 (방이119안전센터),201902,142,107,249,37.519878,127.136711
송파구,1299, 송파소방서 (방이119안전센터),201903,238,213,451,37.519878,127.136711
송파구,1299, 송파소방서 (방이119안전센터),201904,403,353,756,37.519878,127.136711
송파구,1299, 송파소방서 (방이119안전센터),201905,704,622,1326,37.519878,127.136711
송파구,1299, 송파소방서 (방이119안전센터),201906,771,673,1444,37.519878,127.136711
송파구,1299, 송파소방서 (방이119안전센터),201907,830,735,1565,37.519878,127.136711
송파구,1299, 송파소방서 (방이119안전센터),201908,794,616,1410,37.519878,127.136711
송파구,1299, 송파소방서 (방이119안전센터),201909,799,669,1468,37.519878,127.136711
송파구,1299, 송파소방서 (방이119안전센터),201910,934,813,1747,37.519878,127.136711
송파구,1299, 송파소방서 (방이119안전센터),201911,597,515,1112,37.519878,127.136711
송파구,1299, 송파소방서 (방이119안전센터),201912,377,333,710,37.519878,127.136711
송파구,1299, 송파소방서 (방이119안전센터),202001,321,291,612,37.519878,127.136711
송파구,1299, 송파소방서 (방이119안전센터),202002,253,219,472,37.519878,127.136711
송파구,1299, 송파소방서 (방이119안전센터),202003,236,207,443,37.519878,127.136711
송파구,1299, 송파소방서 (방이119안전센터),202004,529,486,1015,37.519878,127.136711
송파구,1299, 송파소방서 (방이119안전센터),202005,617,543,1160,37.519878,127.136711
송파구,1299, 송파소방서 (방이119안전센터),202006,851,766,1617,37.519878,127.136711
송파구,1300, 오륜사거리,201901,143,178,321,37.506939,127.139221
송파구,1300, 오륜사거리,201902,117,126,243,37.506939,127.139221
송파구,1300, 오륜사거리,201903,192,235,427,37.506939,127.139221
송파구,1300, 오륜사거리,201904,318,376,694,37.506939,127.139221
송파구,1300, 오륜사거리,201905,573,576,1149,37.506939,127.139221
송파구,1300, 오륜사거리,201906,626,597,1223,37.506939,127.139221
송파구,1300, 오륜사거리,201907,663,655,1318,37.506939,127.139221
송파구,1300, 오륜사거리,201908,539,578,1117,37.506939,127.139221
송파구,1300, 오륜사거리,201909,595,624,1219,37.506939,127.139221
송파구,1300, 오륜사거리,201910,759,758,1517,37.506939,127.139221
송파구,1300, 오륜사거리,201911,446,465,911,37.506939,127.139221
송파구,1300, 오륜사거리,201912,294,313,607,37.506939,127.139221
송파구,1300, 오륜사거리,202001,215,219,434,37.506939,127.139221
송파구,1300, 오륜사거리,202002,254,257,511,37.506939,127.139221
송파구,1300, 오륜사거리,202003,574,573,1147,37.506939,127.139221
송파구,1300, 오륜사거리,202004,765,764,1529,37.506939,127.139221
송파구,1300, 오륜사거리,202005,819,822,1641,37.506939,127.139221
송파구,1300, 오륜사거리,202006,819,839,1658,37.506939,127.139221
성북구,1302, 한성대입구역6번출구 뒤,201901,201,197,398,37.588764,127.00631
성북구,1302, 한성대입구역6번출구 뒤,201902,185,195,380,37.588764,127.00631
성북구,1302, 한성대입구역6번출구 뒤,201903,351,345,696,37.588764,127.00631
성북구,1302, 한성대입구역6번출구 뒤,201904,548,550,1098,37.588764,127.00631
성북구,1302, 한성대입구역6번출구 뒤,201905,860,850,1710,37.588764,127.00631
성북구,1302, 한성대입구역6번출구 뒤,201906,830,818,1648,37.588764,127.00631
성북구,1302, 한성대입구역6번출구 뒤,201907,829,820,1649,37.588764,127.00631
성북구,1302, 한성대입구역6번출구 뒤,201908,811,812,1623,37.588764,127.00631
성북구,1302, 한성대입구역6번출구 뒤,201909,749,747,1496,37.588764,127.00631
성북구,1302, 한성대입구역6번출구 뒤,201910,881,882,1763,37.588764,127.00631
성북구,1302, 한성대입구역6번출구 뒤,201911,581,571,1152,37.588764,127.00631
성북구,1302, 한성대입구역6번출구 뒤,201912,369,360,729,37.588764,127.00631
성북구,1302, 한성대입구역6번출구 뒤,202001,355,369,724,37.588764,127.00631
성북구,1302, 한성대입구역6번출구 뒤,202002,366,356,722,37.588764,127.00631
성북구,1302, 한성대입구역6번출구 뒤,202003,540,543,1083,37.588764,127.00631
성북구,1302, 한성대입구역6번출구 뒤,202004,677,673,1350,37.588764,127.00631
성북구,1302, 한성대입구역6번출구 뒤,202005,589,588,1177,37.588764,127.00631
성북구,1302, 한성대입구역6번출구 뒤,202006,1893,1904,3797,37.588764,127.00631
성북구,1303, 돈암초교 입구,201901,357,371,728,37.591694,127.012497
성북구,1303, 돈암초교 입구,201902,328,315,643,37.591694,127.012497
성북구,1303, 돈암초교 입구,201903,620,614,1234,37.591694,127.012497
성북구,1303, 돈암초교 입구,201904,932,917,1849,37.591694,127.012497
성북구,1303, 돈암초교 입구,201905,1302,1296,2598,37.591694,127.012497
성북구,1303, 돈암초교 입구,201906,1361,1374,2735,37.591694,127.012497
성북구,1303, 돈암초교 입구,201907,1404,1431,2835,37.591694,127.012497
성북구,1303, 돈암초교 입구,201908,1334,1321,2655,37.591694,127.012497
성북구,1303, 돈암초교 입구,201909,1300,1319,2619,37.591694,127.012497
성북구,1303, 돈암초교 입구,201910,1600,1672,3272,37.591694,127.012497
성북구,1303, 돈암초교 입구,201911,1062,1070,2132,37.591694,127.012497
성북구,1303, 돈암초교 입구,201912,655,652,1307,37.591694,127.012497
성북구,1303, 돈암초교 입구,202001,565,523,1088,37.591694,127.012497
성북구,1303, 돈암초교 입구,202002,587,572,1159,37.591694,127.012497
성북구,1303, 돈암초교 입구,202003,917,916,1833,37.591694,127.012497
성북구,1303, 돈암초교 입구,202004,1074,1070,2144,37.591694,127.012497
성북구,1303, 돈암초교 입구,202005,1228,1216,2444,37.591694,127.012497
성북구,1303, 돈암초교 입구,202006,1476,1482,2958,37.591694,127.012497
성북구,1304, 만해공원,201901,112,31,143,37.594402,126.99231
성북구,1304, 만해공원,201902,89,22,111,37.594402,126.99231
성북구,1304, 만해공원,201903,202,37,239,37.594402,126.99231
성북구,1304, 만해공원,201904,282,67,349,37.594402,126.99231
성북구,1304, 만해공원,201905,324,83,407,37.594402,126.99231
성북구,1304, 만해공원,201906,326,81,407,37.594402,126.99231
성북구,1304, 만해공원,201907,368,96,464,37.594402,126.99231
성북구,1304, 만해공원,201908,425,97,522,37.594402,126.99231
성북구,1304, 만해공원,201909,324,89,413,37.594402,126.99231
성북구,1304, 만해공원,201910,412,69,481,37.594402,126.99231
성북구,1304, 만해공원,201911,349,54,403,37.594402,126.99231
성북구,1304, 만해공원,201912,241,30,271,37.594402,126.99231
성북구,1304, 만해공원,202001,248,52,300,37.594402,126.99231
성북구,1304, 만해공원,202002,187,80,267,37.594402,126.99231
성북구,1304, 만해공원,202003,282,96,378,37.594402,126.99231
성북구,1304, 만해공원,202004,275,129,404,37.594402,126.99231
성북구,1304, 만해공원,202005,256,96,352,37.594402,126.99231
성북구,1304, 만해공원,202006,328,115,443,37.594402,126.99231
성북구,1305, 성북구청,201901,2,2,4,37.589329,127.016434
성북구,1305, 성북구청,201902,179,181,360,37.589329,127.016434
성북구,1305, 성북구청,201903,479,463,942,37.589329,127.016434
성북구,1305, 성북구청,201904,774,624,1398,37.589329,127.016434
성북구,1305, 성북구청,201905,1268,1085,2353,37.589329,127.016434
성북구,1305, 성북구청,201906,1264,1072,2336,37.589329,127.016434
성북구,1305, 성북구청,201907,1181,1060,2241,37.589329,127.016434
성북구,1305, 성북구청,201908,968,828,1796,37.589329,127.016434
성북구,1305, 성북구청,201909,1010,849,1859,37.589329,127.016434
성북구,1305, 성북구청,201910,1213,1081,2294,37.589329,127.016434
성북구,1305, 성북구청,201911,715,617,1332,37.589329,127.016434
성북구,1305, 성북구청,201912,439,423,862,37.589329,127.016434
성북구,1305, 성북구청,202001,398,388,786,37.589329,127.016434
성북구,1305, 성북구청,202002,368,308,676,37.589329,127.016434
성북구,1305, 성북구청,202003,738,634,1372,37.589329,127.016434
성북구,1305, 성북구청,202004,1071,945,2016,37.589329,127.016434
성북구,1305, 성북구청,202005,955,858,1813,37.589329,127.016434
성북구,1305, 성북구청,202006,1099,973,2072,37.589329,127.016434
성북구,1306, 한성대입구역2번출구,201901,443,383,826,37.588448,127.006706
성북구,1306, 한성대입구역2번출구,201902,488,429,917,37.588448,127.006706
성북구,1306, 한성대입구역2번출구,201903,913,862,1775,37.588448,127.006706
성북구,1306, 한성대입구역2번출구,201904,1381,1378,2759,37.588448,127.006706
성북구,1306, 한성대입구역2번출구,201905,2011,1987,3998,37.588448,127.006706
성북구,1306, 한성대입구역2번출구,201906,2032,2024,4056,37.588448,127.006706
성북구,1306, 한성대입구역2번출구,201907,1898,1892,3790,37.588448,127.006706
성북구,1306, 한성대입구역2번출구,201908,1800,1808,3608,37.588448,127.006706
성북구,1306, 한성대입구역2번출구,201909,1891,1873,3764,37.588448,127.006706
성북구,1306, 한성대입구역2번출구,201910,2077,2097,4174,37.588448,127.006706
성북구,1306, 한성대입구역2번출구,201911,1448,1429,2877,37.588448,127.006706
성북구,1306, 한성대입구역2번출구,201912,765,728,1493,37.588448,127.006706
성북구,1306, 한성대입구역2번출구,202001,650,643,1293,37.588448,127.006706
성북구,1306, 한성대입구역2번출구,202002,687,666,1353,37.588448,127.006706
성북구,1306, 한성대입구역2번출구,202003,1489,1489,2978,37.588448,127.006706
성북구,1306, 한성대입구역2번출구,202004,2107,2143,4250,37.588448,127.006706
성북구,1306, 한성대입구역2번출구,202005,2164,2147,4311,37.588448,127.006706
성북구,1306, 한성대입구역2번출구,202006,44,38,82,37.588448,127.006706
성북구,1308, 안암로터리 버스정류장 앞,201901,1610,1816,3426,37.582592,127.028976
성북구,1308, 안암로터리 버스정류장 앞,201902,1382,1507,2889,37.582592,127.028976
성북구,1308, 안암로터리 버스정류장 앞,201903,3034,3552,6586,37.582592,127.028976
성북구,1308, 안암로터리 버스정류장 앞,201904,3926,4574,8500,37.582592,127.028976
성북구,1308, 안암로터리 버스정류장 앞,201905,5820,6401,12221,37.582592,127.028976
성북구,1308, 안암로터리 버스정류장 앞,201906,6445,7167,13612,37.582592,127.028976
성북구,1308, 안암로터리 버스정류장 앞,201907,6119,6748,12867,37.582592,127.028976
성북구,1308, 안암로터리 버스정류장 앞,201908,5810,6251,12061,37.582592,127.028976
성북구,1308, 안암로터리 버스정류장 앞,201909,6057,6444,12501,37.582592,127.028976
성북구,1308, 안암로터리 버스정류장 앞,201910,7181,7782,14963,37.582592,127.028976
성북구,1308, 안암로터리 버스정류장 앞,201911,5293,5882,11175,37.582592,127.028976
성북구,1308, 안암로터리 버스정류장 앞,201912,2860,3229,6089,37.582592,127.028976
성북구,1308, 안암로터리 버스정류장 앞,202001,2111,2436,4547,37.582592,127.028976
성북구,1308, 안암로터리 버스정류장 앞,202002,2201,2506,4707,37.582592,127.028976
성북구,1308, 안암로터리 버스정류장 앞,202003,3761,4078,7839,37.582592,127.028976
성북구,1308, 안암로터리 버스정류장 앞,202004,5434,5779,11213,37.582592,127.028976
성북구,1308, 안암로터리 버스정류장 앞,202005,5749,5965,11714,37.582592,127.028976
성북구,1308, 안암로터리 버스정류장 앞,202006,5567,6261,11828,37.582592,127.028976
성북구,1313, 정릉교회 앞,201901,139,154,293,#N/A,#N/A
성북구,1313, 정릉교회 앞,201902,122,121,243,#N/A,#N/A
성북구,1313, 정릉교회 앞,201903,204,232,436,#N/A,#N/A
성북구,1313, 정릉교회 앞,201904,320,338,658,#N/A,#N/A
성북구,1313, 정릉교회 앞,201905,493,500,993,#N/A,#N/A
성북구,1313, 정릉교회 앞,201906,593,629,1222,#N/A,#N/A
성북구,1313, 정릉교회 앞,201907,474,580,1054,#N/A,#N/A
성북구,1313, 정릉교회 앞,201908,530,577,1107,#N/A,#N/A
성북구,1313, 정릉교회 앞,201909,508,516,1024,#N/A,#N/A
성북구,1313, 정릉교회 앞,201910,625,618,1243,#N/A,#N/A
성북구,1313, 정릉교회 앞,201911,54,52,106,#N/A,#N/A
성북구,1314, 정릉꿈에그린1단지 201동 앞,201901,101,104,205,37.60244,127.011688
성북구,1314, 정릉꿈에그린1단지 201동 앞,201902,82,87,169,37.60244,127.011688
성북구,1314, 정릉꿈에그린1단지 201동 앞,201903,188,203,391,37.60244,127.011688
성북구,1314, 정릉꿈에그린1단지 201동 앞,201904,268,295,563,37.60244,127.011688
성북구,1314, 정릉꿈에그린1단지 201동 앞,201905,434,455,889,37.60244,127.011688
성북구,1314, 정릉꿈에그린1단지 201동 앞,201906,487,512,999,37.60244,127.011688
성북구,1314, 정릉꿈에그린1단지 201동 앞,201907,415,431,846,37.60244,127.011688
성북구,1314, 정릉꿈에그린1단지 201동 앞,201908,378,396,774,37.60244,127.011688
성북구,1314, 정릉꿈에그린1단지 201동 앞,201909,371,356,727,37.60244,127.011688
성북구,1314, 정릉꿈에그린1단지 201동 앞,201910,374,381,755,37.60244,127.011688
성북구,1314, 정릉꿈에그린1단지 201동 앞,201911,109,103,212,37.60244,127.011688
성북구,1314, 정릉꿈에그린1단지 201동 앞,201912,178,161,339,37.60244,127.011688
성북구,1314, 정릉꿈에그린1단지 201동 앞,202001,199,173,372,37.60244,127.011688
성북구,1314, 정릉꿈에그린1단지 201동 앞,202002,178,213,391,37.60244,127.011688
성북구,1314, 정릉꿈에그린1단지 201동 앞,202003,425,418,843,37.60244,127.011688
성북구,1314, 정릉꿈에그린1단지 201동 앞,202004,456,439,895,37.60244,127.011688
성북구,1314, 정릉꿈에그린1단지 201동 앞,202005,531,528,1059,37.60244,127.011688
성북구,1314, 정릉꿈에그린1단지 201동 앞,202006,504,493,997,37.60244,127.011688
성북구,1315, 고려사대부속중고 정문,201901,68,48,116,37.607761,127.003281
성북구,1315, 고려사대부속중고 정문,201902,72,59,131,37.607761,127.003281
성북구,1315, 고려사대부속중고 정문,201903,262,168,430,37.607761,127.003281
성북구,1315, 고려사대부속중고 정문,201904,458,295,753,37.607761,127.003281
성북구,1315, 고려사대부속중고 정문,201905,697,463,1160,37.607761,127.003281
성북구,1315, 고려사대부속중고 정문,201906,591,477,1068,37.607761,127.003281
성북구,1315, 고려사대부속중고 정문,201907,650,514,1164,37.607761,127.003281
성북구,1315, 고려사대부속중고 정문,201908,545,418,963,37.607761,127.003281
성북구,1315, 고려사대부속중고 정문,201909,447,422,869,37.607761,127.003281
성북구,1315, 고려사대부속중고 정문,201910,488,355,843,37.607761,127.003281
성북구,1315, 고려사대부속중고 정문,201911,306,240,546,37.607761,127.003281
성북구,1315, 고려사대부속중고 정문,201912,202,137,339,37.607761,127.003281
성북구,1315, 고려사대부속중고 정문,202001,131,109,240,37.607761,127.003281
성북구,1315, 고려사대부속중고 정문,202002,175,147,322,37.607761,127.003281
성북구,1315, 고려사대부속중고 정문,202003,383,325,708,37.607761,127.003281
성북구,1315, 고려사대부속중고 정문,202004,599,586,1185,37.607761,127.003281
성북구,1315, 고려사대부속중고 정문,202005,505,491,996,37.607761,127.003281
성북구,1315, 고려사대부속중고 정문,202006,541,494,1035,37.607761,127.003281
성북구,1316, 고려사대부속중고 건너편,201901,88,71,159,37.607262,127.002838
성북구,1316, 고려사대부속중고 건너편,201902,109,74,183,37.607262,127.002838
성북구,1316, 고려사대부속중고 건너편,201903,305,150,455,37.607262,127.002838
성북구,1316, 고려사대부속중고 건너편,201904,353,173,526,37.607262,127.002838
성북구,1316, 고려사대부속중고 건너편,201905,591,361,952,37.607262,127.002838
성북구,1316, 고려사대부속중고 건너편,201906,584,308,892,37.607262,127.002838
성북구,1316, 고려사대부속중고 건너편,201907,481,271,752,37.607262,127.002838
성북구,1316, 고려사대부속중고 건너편,201908,494,250,744,37.607262,127.002838
성북구,1316, 고려사대부속중고 건너편,201909,498,320,818,37.607262,127.002838
성북구,1316, 고려사대부속중고 건너편,201910,517,293,810,37.607262,127.002838
성북구,1316, 고려사대부속중고 건너편,201911,416,230,646,37.607262,127.002838
성북구,1316, 고려사대부속중고 건너편,201912,260,163,423,37.607262,127.002838
성북구,1316, 고려사대부속중고 건너편,202001,127,142,269,37.607262,127.002838
성북구,1316, 고려사대부속중고 건너편,202002,146,112,258,37.607262,127.002838
성북구,1316, 고려사대부속중고 건너편,202003,225,156,381,37.607262,127.002838
성북구,1316, 고려사대부속중고 건너편,202004,171,132,303,37.607262,127.002838
성북구,1316, 고려사대부속중고 건너편,202005,412,362,774,37.607262,127.002838
성북구,1316, 고려사대부속중고 건너편,202006,517,420,937,37.607262,127.002838
성북구,1317, 정릉동 교통광장,201901,22,3,25,#N/A,#N/A
성북구,1317, 정릉동 교통광장,201902,26,9,35,#N/A,#N/A
성북구,1317, 정릉동 교통광장,201903,53,10,63,#N/A,#N/A
성북구,1317, 정릉동 교통광장,201904,5,0,5,#N/A,#N/A
성북구,1318, 길음역 3번출구 뒤,201901,283,294,577,37.603085,127.024788
성북구,1318, 길음역 3번출구 뒤,201902,243,277,520,37.603085,127.024788
성북구,1318, 길음역 3번출구 뒤,201903,630,680,1310,37.603085,127.024788
성북구,1318, 길음역 3번출구 뒤,201904,1032,1095,2127,37.603085,127.024788
성북구,1318, 길음역 3번출구 뒤,201905,1441,1546,2987,37.603085,127.024788
성북구,1318, 길음역 3번출구 뒤,201906,1522,1519,3041,37.603085,127.024788
성북구,1318, 길음역 3번출구 뒤,201907,1510,1492,3002,37.603085,127.024788
성북구,1318, 길음역 3번출구 뒤,201908,1288,1215,2503,37.603085,127.024788
성북구,1318, 길음역 3번출구 뒤,201909,1222,1250,2472,37.603085,127.024788
성북구,1318, 길음역 3번출구 뒤,201910,1642,1663,3305,37.603085,127.024788
성북구,1318, 길음역 3번출구 뒤,201911,1039,1036,2075,37.603085,127.024788
성북구,1318, 길음역 3번출구 뒤,201912,601,628,1229,37.603085,127.024788
성북구,1318, 길음역 3번출구 뒤,202001,444,443,887,37.603085,127.024788
성북구,1318, 길음역 3번출구 뒤,202002,428,430,858,37.603085,127.024788
성북구,1318, 길음역 3번출구 뒤,202003,731,737,1468,37.603085,127.024788
성북구,1318, 길음역 3번출구 뒤,202004,1190,1200,2390,37.603085,127.024788
성북구,1318, 길음역 3번출구 뒤,202005,1320,1316,2636,37.603085,127.024788
성북구,1318, 길음역 3번출구 뒤,202006,1248,1230,2478,37.603085,127.024788
성북구,1319, 종암사거리 분수대,201901,409,458,867,37.603043,127.033272
성북구,1319, 종암사거리 분수대,201902,351,383,734,37.603043,127.033272
성북구,1319, 종암사거리 분수대,201903,742,746,1488,37.603043,127.033272
성북구,1319, 종암사거리 분수대,201904,1232,1262,2494,37.603043,127.033272
성북구,1319, 종암사거리 분수대,201905,1999,2026,4025,37.603043,127.033272
성북구,1319, 종암사거리 분수대,201906,2293,2394,4687,37.603043,127.033272
성북구,1319, 종암사거리 분수대,201907,2161,2256,4417,37.603043,127.033272
성북구,1319, 종암사거리 분수대,201908,2013,2080,4093,37.603043,127.033272
성북구,1319, 종암사거리 분수대,201909,2155,2316,4471,37.603043,127.033272
성북구,1319, 종암사거리 분수대,201910,2613,2706,5319,37.603043,127.033272
성북구,1319, 종암사거리 분수대,201911,1467,1487,2954,37.603043,127.033272
성북구,1319, 종암사거리 분수대,201912,885,872,1757,37.603043,127.033272
성북구,1319, 종암사거리 분수대,202001,805,782,1587,37.603043,127.033272
성북구,1319, 종암사거리 분수대,202002,823,825,1648,37.603043,127.033272
성북구,1319, 종암사거리 분수대,202003,1991,2002,3993,37.603043,127.033272
성북구,1319, 종암사거리 분수대,202004,2922,2958,5880,37.603043,127.033272
성북구,1319, 종암사거리 분수대,202005,2486,2555,5041,37.603043,127.033272
성북구,1319, 종암사거리 분수대,202006,4,4,8,37.603043,127.033272
성북구,1320, LG베스트샵 종암점,201901,359,432,791,37.59827,127.035027
성북구,1320, LG베스트샵 종암점,201902,343,384,727,37.59827,127.035027
성북구,1320, LG베스트샵 종암점,201903,880,976,1856,37.59827,127.035027
성북구,1320, LG베스트샵 종암점,201904,1258,1406,2664,37.59827,127.035027
성북구,1320, LG베스트샵 종암점,201905,1811,2188,3999,37.59827,127.035027
성북구,1320, LG베스트샵 종암점,201906,2220,2363,4583,37.59827,127.035027
성북구,1320, LG베스트샵 종암점,201907,1966,2147,4113,37.59827,127.035027
성북구,1320, LG베스트샵 종암점,201908,1884,2129,4013,37.59827,127.035027
성북구,1320, LG베스트샵 종암점,201909,2111,2229,4340,37.59827,127.035027
성북구,1320, LG베스트샵 종암점,201910,2347,2557,4904,37.59827,127.035027
성북구,1320, LG베스트샵 종암점,201911,1524,1688,3212,37.59827,127.035027
성북구,1320, LG베스트샵 종암점,201912,754,877,1631,37.59827,127.035027
성북구,1320, LG베스트샵 종암점,202001,656,786,1442,37.59827,127.035027
성북구,1320, LG베스트샵 종암점,202002,641,741,1382,37.59827,127.035027
성북구,1320, LG베스트샵 종암점,202003,1171,1279,2450,37.59827,127.035027
성북구,1320, LG베스트샵 종암점,202004,1991,2046,4037,37.59827,127.035027
성북구,1320, LG베스트샵 종암점,202005,2321,2491,4812,37.59827,127.035027
성북구,1320, LG베스트샵 종암점,202006,3165,3425,6590,37.59827,127.035027
성북구,1321, 국민은행 종암동지점 앞,201901,545,498,1043,37.593288,127.036667
성북구,1321, 국민은행 종암동지점 앞,201902,489,487,976,37.593288,127.036667
성북구,1321, 국민은행 종암동지점 앞,201903,1187,1111,2298,37.593288,127.036667
성북구,1321, 국민은행 종암동지점 앞,201904,1740,1578,3318,37.593288,127.036667
성북구,1321, 국민은행 종암동지점 앞,201905,2419,2178,4597,37.593288,127.036667
성북구,1321, 국민은행 종암동지점 앞,201906,2721,2596,5317,37.593288,127.036667
성북구,1321, 국민은행 종암동지점 앞,201907,2603,2662,5265,37.593288,127.036667
성북구,1321, 국민은행 종암동지점 앞,201908,2563,2607,5170,37.593288,127.036667
성북구,1321, 국민은행 종암동지점 앞,201909,2902,2852,5754,37.593288,127.036667
성북구,1321, 국민은행 종암동지점 앞,201910,3284,3169,6453,37.593288,127.036667
성북구,1321, 국민은행 종암동지점 앞,201911,2057,1982,4039,37.593288,127.036667
성북구,1321, 국민은행 종암동지점 앞,201912,1262,1342,2604,37.593288,127.036667
성북구,1321, 국민은행 종암동지점 앞,202001,896,910,1806,37.593288,127.036667
성북구,1321, 국민은행 종암동지점 앞,202002,948,914,1862,37.593288,127.036667
성북구,1321, 국민은행 종암동지점 앞,202003,1575,1527,3102,37.593288,127.036667
성북구,1321, 국민은행 종암동지점 앞,202004,2204,2154,4358,37.593288,127.036667
성북구,1321, 국민은행 종암동지점 앞,202005,2635,2683,5318,37.593288,127.036667
성북구,1321, 국민은행 종암동지점 앞,202006,3057,3065,6122,37.593288,127.036667
성북구,1322, 래미안라센트아파트 103동 앞,201901,365,364,729,37.598068,127.039276
성북구,1322, 래미안라센트아파트 103동 앞,201902,267,281,548,37.598068,127.039276
성북구,1322, 래미안라센트아파트 103동 앞,201903,448,397,845,37.598068,127.039276
성북구,1322, 래미안라센트아파트 103동 앞,201904,622,612,1234,37.598068,127.039276
성북구,1322, 래미안라센트아파트 103동 앞,201905,1003,987,1990,37.598068,127.039276
성북구,1322, 래미안라센트아파트 103동 앞,201906,1119,1123,2242,37.598068,127.039276
성북구,1322, 래미안라센트아파트 103동 앞,201907,1045,1093,2138,37.598068,127.039276
성북구,1322, 래미안라센트아파트 103동 앞,201908,1047,1142,2189,37.598068,127.039276
성북구,1322, 래미안라센트아파트 103동 앞,201909,1049,1086,2135,37.598068,127.039276
성북구,1322, 래미안라센트아파트 103동 앞,201910,1234,1262,2496,37.598068,127.039276
성북구,1322, 래미안라센트아파트 103동 앞,201911,812,798,1610,37.598068,127.039276
성북구,1322, 래미안라센트아파트 103동 앞,201912,588,590,1178,37.598068,127.039276
성북구,1322, 래미안라센트아파트 103동 앞,202001,519,494,1013,37.598068,127.039276
성북구,1322, 래미안라센트아파트 103동 앞,202002,475,477,952,37.598068,127.039276
성북구,1322, 래미안라센트아파트 103동 앞,202003,774,770,1544,37.598068,127.039276
성북구,1322, 래미안라센트아파트 103동 앞,202004,569,745,1314,37.598068,127.039276
성북구,1322, 래미안라센트아파트 103동 앞,202005,1045,1018,2063,37.598068,127.039276
성북구,1322, 래미안라센트아파트 103동 앞,202006,1293,1257,2550,37.598068,127.039276
성북구,1323, 월곡역 입구 육교 밑,201901,242,266,508,37.600433,127.040207
성북구,1323, 월곡역 입구 육교 밑,201902,203,214,417,37.600433,127.040207
성북구,1323, 월곡역 입구 육교 밑,201903,378,438,816,37.600433,127.040207
성북구,1323, 월곡역 입구 육교 밑,201904,542,557,1099,37.600433,127.040207
성북구,1323, 월곡역 입구 육교 밑,201905,778,824,1602,37.600433,127.040207
성북구,1323, 월곡역 입구 육교 밑,201906,902,979,1881,37.600433,127.040207
성북구,1323, 월곡역 입구 육교 밑,201907,849,891,1740,37.600433,127.040207
성북구,1323, 월곡역 입구 육교 밑,201908,801,817,1618,37.600433,127.040207
성북구,1323, 월곡역 입구 육교 밑,201909,807,718,1525,37.600433,127.040207
성북구,1323, 월곡역 입구 육교 밑,201910,916,877,1793,37.600433,127.040207
성북구,1323, 월곡역 입구 육교 밑,201911,577,568,1145,37.600433,127.040207
성북구,1323, 월곡역 입구 육교 밑,201912,329,326,655,37.600433,127.040207
성북구,1323, 월곡역 입구 육교 밑,202001,303,287,590,37.600433,127.040207
성북구,1323, 월곡역 입구 육교 밑,202002,276,313,589,37.600433,127.040207
성북구,1323, 월곡역 입구 육교 밑,202003,670,671,1341,37.600433,127.040207
성북구,1323, 월곡역 입구 육교 밑,202004,1022,970,1992,37.600433,127.040207
성북구,1323, 월곡역 입구 육교 밑,202005,1038,984,2022,37.600433,127.040207
성북구,1323, 월곡역 입구 육교 밑,202006,1022,932,1954,37.600433,127.040207
성북구,1325, 상월곡역 4번출구,201901,238,190,428,37.605808,127.047737
성북구,1325, 상월곡역 4번출구,201902,179,139,318,37.605808,127.047737
성북구,1325, 상월곡역 4번출구,201903,316,239,555,37.605808,127.047737
성북구,1325, 상월곡역 4번출구,201904,380,304,684,37.605808,127.047737
성북구,1325, 상월곡역 4번출구,201905,510,397,907,37.605808,127.047737
성북구,1325, 상월곡역 4번출구,201906,675,569,1244,37.605808,127.047737
성북구,1325, 상월곡역 4번출구,201907,676,566,1242,37.605808,127.047737
성북구,1325, 상월곡역 4번출구,201908,584,449,1033,37.605808,127.047737
성북구,1325, 상월곡역 4번출구,201909,567,465,1032,37.605808,127.047737
성북구,1325, 상월곡역 4번출구,201910,780,665,1445,37.605808,127.047737
성북구,1325, 상월곡역 4번출구,201911,441,335,776,37.605808,127.047737
성북구,1325, 상월곡역 4번출구,201912,313,250,563,37.605808,127.047737
성북구,1325, 상월곡역 4번출구,202001,348,290,638,37.605808,127.047737
성북구,1325, 상월곡역 4번출구,202002,240,188,428,37.605808,127.047737
성북구,1325, 상월곡역 4번출구,202003,409,358,767,37.605808,127.047737
성북구,1325, 상월곡역 4번출구,202004,584,521,1105,37.605808,127.047737
성북구,1325, 상월곡역 4번출구,202005,609,534,1143,37.605808,127.047737
성북구,1325, 상월곡역 4번출구,202006,763,630,1393,37.605808,127.047737
성북구,1326, 상월곡역 1번출구,201901,204,136,340,37.606068,127.047318
성북구,1326, 상월곡역 1번출구,201902,203,144,347,37.606068,127.047318
성북구,1326, 상월곡역 1번출구,201903,380,273,653,37.606068,127.047318
성북구,1326, 상월곡역 1번출구,201904,567,405,972,37.606068,127.047318
성북구,1326, 상월곡역 1번출구,201905,863,713,1576,37.606068,127.047318
성북구,1326, 상월곡역 1번출구,201906,783,657,1440,37.606068,127.047318
성북구,1326, 상월곡역 1번출구,201907,873,703,1576,37.606068,127.047318
성북구,1326, 상월곡역 1번출구,201908,842,672,1514,37.606068,127.047318
성북구,1326, 상월곡역 1번출구,201909,889,727,1616,37.606068,127.047318
성북구,1326, 상월곡역 1번출구,201910,896,777,1673,37.606068,127.047318
성북구,1326, 상월곡역 1번출구,201911,598,461,1059,37.606068,127.047318
성북구,1326, 상월곡역 1번출구,201912,365,243,608,37.606068,127.047318
성북구,1326, 상월곡역 1번출구,202001,324,212,536,37.606068,127.047318
성북구,1326, 상월곡역 1번출구,202002,373,252,625,37.606068,127.047318
성북구,1326, 상월곡역 1번출구,202003,575,493,1068,37.606068,127.047318
성북구,1326, 상월곡역 1번출구,202004,848,763,1611,37.606068,127.047318
성북구,1326, 상월곡역 1번출구,202005,951,849,1800,37.606068,127.047318
성북구,1326, 상월곡역 1번출구,202006,1038,943,1981,37.606068,127.047318
성북구,1327, 상월곡역 3번출구,201901,221,237,458,37.607342,127.050682
성북구,1327, 상월곡역 3번출구,201902,204,199,403,37.607342,127.050682
성북구,1327, 상월곡역 3번출구,201903,337,328,665,37.607342,127.050682
성북구,1327, 상월곡역 3번출구,201904,487,511,998,37.607342,127.050682
성북구,1327, 상월곡역 3번출구,201905,856,832,1688,37.607342,127.050682
성북구,1327, 상월곡역 3번출구,201906,1097,1075,2172,37.607342,127.050682
성북구,1327, 상월곡역 3번출구,201907,1076,1128,2204,37.607342,127.050682
성북구,1327, 상월곡역 3번출구,201908,962,1082,2044,37.607342,127.050682
성북구,1327, 상월곡역 3번출구,201909,1064,1115,2179,37.607342,127.050682
성북구,1327, 상월곡역 3번출구,201910,1334,1389,2723,37.607342,127.050682
성북구,1327, 상월곡역 3번출구,201911,905,935,1840,37.607342,127.050682
성북구,1327, 상월곡역 3번출구,201912,570,594,1164,37.607342,127.050682
성북구,1327, 상월곡역 3번출구,202001,468,470,938,37.607342,127.050682
성북구,1327, 상월곡역 3번출구,202002,386,377,763,37.607342,127.050682
성북구,1327, 상월곡역 3번출구,202003,763,781,1544,37.607342,127.050682
성북구,1327, 상월곡역 3번출구,202004,1221,1214,2435,37.607342,127.050682
성북구,1327, 상월곡역 3번출구,202005,1429,1453,2882,37.607342,127.050682
성북구,1327, 상월곡역 3번출구,202006,1662,1646,3308,37.607342,127.050682
성북구,1328, 월곡역 3번출구,201901,488,535,1023,37.602627,127.041634
성북구,1328, 월곡역 3번출구,201902,517,557,1074,37.602627,127.041634
성북구,1328, 월곡역 3번출구,201903,1027,1078,2105,37.602627,127.041634
성북구,1328, 월곡역 3번출구,201904,1544,1722,3266,37.602627,127.041634
성북구,1328, 월곡역 3번출구,201905,2364,2447,4811,37.602627,127.041634
성북구,1328, 월곡역 3번출구,201906,2569,2716,5285,37.602627,127.041634
성북구,1328, 월곡역 3번출구,201907,2388,2535,4923,37.602627,127.041634
성북구,1328, 월곡역 3번출구,201908,2254,2403,4657,37.602627,127.041634
성북구,1328, 월곡역 3번출구,201909,2551,2651,5202,37.602627,127.041634
성북구,1328, 월곡역 3번출구,201910,3038,3066,6104,37.602627,127.041634
성북구,1328, 월곡역 3번출구,201911,1905,1957,3862,37.602627,127.041634
성북구,1328, 월곡역 3번출구,201912,1164,1198,2362,37.602627,127.041634
성북구,1328, 월곡역 3번출구,202001,932,1039,1971,37.602627,127.041634
성북구,1328, 월곡역 3번출구,202002,918,1043,1961,37.602627,127.041634
성북구,1328, 월곡역 3번출구,202003,1756,1785,3541,37.602627,127.041634
성북구,1328, 월곡역 3번출구,202004,2699,2781,5480,37.602627,127.041634
성북구,1328, 월곡역 3번출구,202005,3151,3182,6333,37.602627,127.041634
성북구,1328, 월곡역 3번출구,202006,3213,3346,6559,37.602627,127.041634
성북구,1332, 석계역 5번출구 건너편,201901,346,348,694,37.613556,127.066093
성북구,1332, 석계역 5번출구 건너편,201902,346,385,731,37.613556,127.066093
성북구,1332, 석계역 5번출구 건너편,201903,705,798,1503,37.613556,127.066093
성북구,1332, 석계역 5번출구 건너편,201904,1250,1244,2494,37.613556,127.066093
성북구,1332, 석계역 5번출구 건너편,201905,1954,2117,4071,37.613556,127.066093
성북구,1332, 석계역 5번출구 건너편,201906,1980,2092,4072,37.613556,127.066093
성북구,1332, 석계역 5번출구 건너편,201907,1896,1941,3837,37.613556,127.066093
성북구,1332, 석계역 5번출구 건너편,201908,1860,1939,3799,37.613556,127.066093
성북구,1332, 석계역 5번출구 건너편,201909,2157,2201,4358,37.613556,127.066093
성북구,1332, 석계역 5번출구 건너편,201910,2298,2284,4582,37.613556,127.066093
성북구,1332, 석계역 5번출구 건너편,201911,1266,1253,2519,37.613556,127.066093
성북구,1332, 석계역 5번출구 건너편,201912,680,730,1410,37.613556,127.066093
성북구,1332, 석계역 5번출구 건너편,202001,613,633,1246,37.613556,127.066093
성북구,1332, 석계역 5번출구 건너편,202002,617,653,1270,37.613556,127.066093
성북구,1332, 석계역 5번출구 건너편,202003,1701,1874,3575,37.613556,127.066093
성북구,1332, 석계역 5번출구 건너편,202004,2559,2679,5238,37.613556,127.066093
성북구,1332, 석계역 5번출구 건너편,202005,2877,2944,5821,37.613556,127.066093
성북구,1332, 석계역 5번출구 건너편,202006,2709,2742,5451,37.613556,127.066093
성북구,1333, 석관초등학교 앞,201901,253,310,563,37.610523,127.059799
성북구,1333, 석관초등학교 앞,201902,272,383,655,37.610523,127.059799
성북구,1333, 석관초등학교 앞,201903,525,706,1231,37.610523,127.059799
성북구,1333, 석관초등학교 앞,201904,820,1005,1825,37.610523,127.059799
성북구,1333, 석관초등학교 앞,201905,1325,1612,2937,37.610523,127.059799
성북구,1333, 석관초등학교 앞,201906,1676,2020,3696,37.610523,127.059799
성북구,1333, 석관초등학교 앞,201907,1536,1958,3494,37.610523,127.059799
성북구,1333, 석관초등학교 앞,201908,1480,1841,3321,37.610523,127.059799
성북구,1333, 석관초등학교 앞,201909,1619,1843,3462,37.610523,127.059799
성북구,1333, 석관초등학교 앞,201910,2018,2311,4329,37.610523,127.059799
성북구,1333, 석관초등학교 앞,201911,1192,1461,2653,37.610523,127.059799
성북구,1333, 석관초등학교 앞,201912,632,853,1485,37.610523,127.059799
성북구,1333, 석관초등학교 앞,202001,530,718,1248,37.610523,127.059799
성북구,1333, 석관초등학교 앞,202002,574,649,1223,37.610523,127.059799
성북구,1333, 석관초등학교 앞,202003,1081,1261,2342,37.610523,127.059799
성북구,1333, 석관초등학교 앞,202004,1851,2035,3886,37.610523,127.059799
성북구,1333, 석관초등학교 앞,202005,2245,2485,4730,37.610523,127.059799
성북구,1333, 석관초등학교 앞,202006,2467,2773,5240,37.610523,127.059799
성북구,1334, 석관동주민센터 앞,201901,156,141,297,37.612999,127.06131
성북구,1334, 석관동주민센터 앞,201902,204,196,400,37.612999,127.06131
성북구,1334, 석관동주민센터 앞,201903,384,400,784,37.612999,127.06131
성북구,1334, 석관동주민센터 앞,201904,480,506,986,37.612999,127.06131
성북구,1334, 석관동주민센터 앞,201905,826,807,1633,37.612999,127.06131
성북구,1334, 석관동주민센터 앞,201906,819,851,1670,37.612999,127.06131
성북구,1334, 석관동주민센터 앞,201907,756,768,1524,37.612999,127.06131
성북구,1334, 석관동주민센터 앞,201908,843,867,1710,37.612999,127.06131
성북구,1334, 석관동주민센터 앞,201909,881,880,1761,37.612999,127.06131
성북구,1334, 석관동주민센터 앞,201910,1070,1029,2099,37.612999,127.06131
성북구,1334, 석관동주민센터 앞,201911,710,700,1410,37.612999,127.06131
성북구,1334, 석관동주민센터 앞,201912,375,348,723,37.612999,127.06131
성북구,1334, 석관동주민센터 앞,202001,318,319,637,37.612999,127.06131
성북구,1334, 석관동주민센터 앞,202002,334,336,670,37.612999,127.06131
성북구,1334, 석관동주민센터 앞,202003,721,707,1428,37.612999,127.06131
성북구,1334, 석관동주민센터 앞,202004,1047,1046,2093,37.612999,127.06131
성북구,1334, 석관동주민센터 앞,202005,1218,1216,2434,37.612999,127.06131
성북구,1334, 석관동주민센터 앞,202006,1399,1346,2745,37.612999,127.06131
성북구,1336, 성북3교 위,201901,439,377,816,37.591251,127.014008
성북구,1336, 성북3교 위,201902,384,379,763,37.591251,127.014008
성북구,1336, 성북3교 위,201903,750,703,1453,37.591251,127.014008
성북구,1336, 성북3교 위,201904,1224,1203,2427,37.591251,127.014008
성북구,1336, 성북3교 위,201905,2004,1846,3850,37.591251,127.014008
성북구,1336, 성북3교 위,201906,2058,2014,4072,37.591251,127.014008
성북구,1336, 성북3교 위,201907,1888,1900,3788,37.591251,127.014008
성북구,1336, 성북3교 위,201908,1768,1730,3498,37.591251,127.014008
성북구,1336, 성북3교 위,201909,1750,1606,3356,37.591251,127.014008
성북구,1336, 성북3교 위,201910,1979,1891,3870,37.591251,127.014008
성북구,1336, 성북3교 위,201911,1237,1162,2399,37.591251,127.014008
성북구,1336, 성북3교 위,201912,675,669,1344,37.591251,127.014008
성북구,1336, 성북3교 위,202001,676,628,1304,37.591251,127.014008
성북구,1336, 성북3교 위,202002,640,605,1245,37.591251,127.014008
성북구,1336, 성북3교 위,202003,1455,1356,2811,37.591251,127.014008
성북구,1336, 성북3교 위,202004,2269,2160,4429,37.591251,127.014008
성북구,1336, 성북3교 위,202005,2459,2407,4866,37.591251,127.014008
성북구,1336, 성북3교 위,202006,2805,2681,5486,37.591251,127.014008
성북구,1337, 돈암성당 옆,201901,731,755,1486,37.590382,127.017136
성북구,1337, 돈암성당 옆,201902,679,759,1438,37.590382,127.017136
성북구,1337, 돈암성당 옆,201903,1365,1406,2771,37.590382,127.017136
성북구,1337, 돈암성당 옆,201904,2150,2246,4396,37.590382,127.017136
성북구,1337, 돈암성당 옆,201905,3533,3664,7197,37.590382,127.017136
성북구,1337, 돈암성당 옆,201906,3873,3932,7805,37.590382,127.017136
성북구,1337, 돈암성당 옆,201907,3329,3426,6755,37.590382,127.017136
성북구,1337, 돈암성당 옆,201908,3015,3069,6084,37.590382,127.017136
성북구,1337, 돈암성당 옆,201909,3153,3167,6320,37.590382,127.017136
성북구,1337, 돈암성당 옆,201910,3608,3711,7319,37.590382,127.017136
성북구,1337, 돈암성당 옆,201911,1962,2035,3997,37.590382,127.017136
성북구,1337, 돈암성당 옆,201912,1039,1059,2098,37.590382,127.017136
성북구,1337, 돈암성당 옆,202001,925,998,1923,37.590382,127.017136
성북구,1337, 돈암성당 옆,202002,976,971,1947,37.590382,127.017136
성북구,1337, 돈암성당 옆,202003,2459,2468,4927,37.590382,127.017136
성북구,1337, 돈암성당 옆,202004,3658,3674,7332,37.590382,127.017136
성북구,1337, 돈암성당 옆,202005,4145,4147,8292,37.590382,127.017136
성북구,1337, 돈암성당 옆,202006,3668,3662,7330,37.590382,127.017136
성북구,1338, 용문2교 옆,201901,314,277,591,37.586899,127.020752
성북구,1338, 용문2교 옆,201902,275,242,517,37.586899,127.020752
성북구,1338, 용문2교 옆,201903,683,595,1278,37.586899,127.020752
성북구,1338, 용문2교 옆,201904,854,835,1689,37.586899,127.020752
성북구,1338, 용문2교 옆,201905,1203,1172,2375,37.586899,127.020752
성북구,1338, 용문2교 옆,201906,1323,1239,2562,37.586899,127.020752
성북구,1338, 용문2교 옆,201907,1088,1079,2167,37.586899,127.020752
성북구,1338, 용문2교 옆,201908,1137,1151,2288,37.586899,127.020752
성북구,1338, 용문2교 옆,201909,1170,1086,2256,37.586899,127.020752
성북구,1338, 용문2교 옆,201910,1205,1111,2316,37.586899,127.020752
성북구,1338, 용문2교 옆,201911,770,753,1523,37.586899,127.020752
성북구,1338, 용문2교 옆,201912,417,487,904,37.586899,127.020752
성북구,1338, 용문2교 옆,202001,377,351,728,37.586899,127.020752
성북구,1338, 용문2교 옆,202002,377,369,746,37.586899,127.020752
성북구,1338, 용문2교 옆,202003,766,719,1485,37.586899,127.020752
성북구,1338, 용문2교 옆,202004,1037,1027,2064,37.586899,127.020752
성북구,1338, 용문2교 옆,202005,973,947,1920,37.586899,127.020752
성북구,1338, 용문2교 옆,202006,1312,1211,2523,37.586899,127.020752
성북구,1339, 삼성전자서비스 성북센터,201901,284,308,592,37.610569,127.033508
성북구,1339, 삼성전자서비스 성북센터,201902,244,235,479,37.610569,127.033508
성북구,1339, 삼성전자서비스 성북센터,201903,454,450,904,37.610569,127.033508
성북구,1339, 삼성전자서비스 성북센터,201904,693,724,1417,37.610569,127.033508
성북구,1339, 삼성전자서비스 성북센터,201905,1093,1177,2270,37.610569,127.033508
성북구,1339, 삼성전자서비스 성북센터,201906,1280,1351,2631,37.610569,127.033508
성북구,1339, 삼성전자서비스 성북센터,201907,1180,1242,2422,37.610569,127.033508
성북구,1339, 삼성전자서비스 성북센터,201908,1207,1250,2457,37.610569,127.033508
성북구,1339, 삼성전자서비스 성북센터,201909,1217,1244,2461,37.610569,127.033508
성북구,1339, 삼성전자서비스 성북센터,201910,1420,1516,2936,37.610569,127.033508
성북구,1339, 삼성전자서비스 성북센터,201911,875,926,1801,37.610569,127.033508
성북구,1339, 삼성전자서비스 성북센터,201912,532,576,1108,37.610569,127.033508
성북구,1339, 삼성전자서비스 성북센터,202001,412,471,883,37.610569,127.033508
성북구,1339, 삼성전자서비스 성북센터,202002,372,438,810,37.610569,127.033508
성북구,1339, 삼성전자서비스 성북센터,202003,865,919,1784,37.610569,127.033508
성북구,1339, 삼성전자서비스 성북센터,202004,1300,1332,2632,37.610569,127.033508
성북구,1339, 삼성전자서비스 성북센터,202005,1518,1541,3059,37.610569,127.033508
성북구,1339, 삼성전자서비스 성북센터,202006,1611,1671,3282,37.610569,127.033508
성북구,1340, 광운초등학교 앞,201901,56,94,150,37.61956,127.053802
성북구,1340, 광운초등학교 앞,201902,72,76,148,37.61956,127.053802
성북구,1340, 광운초등학교 앞,201903,179,143,322,37.61956,127.053802
성북구,1340, 광운초등학교 앞,201904,357,333,690,37.61956,127.053802
성북구,1340, 광운초등학교 앞,201905,554,547,1101,37.61956,127.053802
성북구,1340, 광운초등학교 앞,201906,550,575,1125,37.61956,127.053802
성북구,1340, 광운초등학교 앞,201907,553,599,1152,37.61956,127.053802
성북구,1340, 광운초등학교 앞,201909,73,74,147,37.61956,127.053802
성북구,1340, 광운초등학교 앞,201910,876,846,1722,37.61956,127.053802
성북구,1340, 광운초등학교 앞,201911,694,657,1351,37.61956,127.053802
성북구,1340, 광운초등학교 앞,201912,449,397,846,37.61956,127.053802
성북구,1340, 광운초등학교 앞,202001,460,451,911,37.61956,127.053802
성북구,1340, 광운초등학교 앞,202002,456,450,906,37.61956,127.053802
성북구,1340, 광운초등학교 앞,202003,951,930,1881,37.61956,127.053802
성북구,1340, 광운초등학교 앞,202004,1559,1529,3088,37.61956,127.053802
성북구,1340, 광운초등학교 앞,202005,1962,2051,4013,37.61956,127.053802
성북구,1340, 광운초등학교 앞,202006,1561,1614,3175,37.61956,127.053802
성북구,1342, 성북쉼터 앞,201901,138,70,208,37.592617,126.997932
성북구,1342, 성북쉼터 앞,201902,136,49,185,37.592617,126.997932
성북구,1342, 성북쉼터 앞,201903,160,61,221,37.592617,126.997932
성북구,1342, 성북쉼터 앞,201904,218,111,329,37.592617,126.997932
성북구,1342, 성북쉼터 앞,201905,264,100,364,37.592617,126.997932
성북구,1342, 성북쉼터 앞,201906,231,100,331,37.592617,126.997932
성북구,1342, 성북쉼터 앞,201907,253,102,355,37.592617,126.997932
성북구,1342, 성북쉼터 앞,201908,263,133,396,37.592617,126.997932
성북구,1342, 성북쉼터 앞,201909,244,125,369,37.592617,126.997932
성북구,1342, 성북쉼터 앞,201910,215,98,313,37.592617,126.997932
성북구,1342, 성북쉼터 앞,201911,151,61,212,37.592617,126.997932
성북구,1342, 성북쉼터 앞,201912,134,42,176,37.592617,126.997932
성북구,1342, 성북쉼터 앞,202001,144,47,191,37.592617,126.997932
성북구,1342, 성북쉼터 앞,202002,145,35,180,37.592617,126.997932
성북구,1342, 성북쉼터 앞,202003,220,58,278,37.592617,126.997932
성북구,1342, 성북쉼터 앞,202004,212,96,308,37.592617,126.997932
성북구,1342, 성북쉼터 앞,202005,217,94,311,37.592617,126.997932
성북구,1342, 성북쉼터 앞,202006,305,123,428,37.592617,126.997932
성북구,1343, 한성대7번출구 앞,201901,245,158,403,37.589249,127.007378
성북구,1343, 한성대7번출구 앞,201902,231,149,380,37.589249,127.007378
성북구,1343, 한성대7번출구 앞,201903,475,346,821,37.589249,127.007378
성북구,1343, 한성대7번출구 앞,201904,619,462,1081,37.589249,127.007378
성북구,1343, 한성대7번출구 앞,201905,783,626,1409,37.589249,127.007378
성북구,1343, 한성대7번출구 앞,201906,756,636,1392,37.589249,127.007378
성북구,1343, 한성대7번출구 앞,201907,811,656,1467,37.589249,127.007378
성북구,1343, 한성대7번출구 앞,201908,829,727,1556,37.589249,127.007378
성북구,1343, 한성대7번출구 앞,201909,592,572,1164,37.589249,127.007378
성북구,1343, 한성대7번출구 앞,201910,749,711,1460,37.589249,127.007378
성북구,1343, 한성대7번출구 앞,201911,547,507,1054,37.589249,127.007378
성북구,1343, 한성대7번출구 앞,201912,429,333,762,37.589249,127.007378
성북구,1343, 한성대7번출구 앞,202001,381,330,711,37.589249,127.007378
성북구,1343, 한성대7번출구 앞,202002,374,350,724,37.589249,127.007378
성북구,1343, 한성대7번출구 앞,202003,512,479,991,37.589249,127.007378
성북구,1343, 한성대7번출구 앞,202004,752,717,1469,37.589249,127.007378
성북구,1343, 한성대7번출구 앞,202005,644,629,1273,37.589249,127.007378
성북구,1343, 한성대7번출구 앞,202006,1335,1307,2642,37.589249,127.007378
성북구,1344, 아리랑시네센터 앞,201901,298,174,472,37.600288,127.013702
성북구,1344, 아리랑시네센터 앞,201902,256,161,417,37.600288,127.013702
성북구,1344, 아리랑시네센터 앞,201903,382,237,619,37.600288,127.013702
성북구,1344, 아리랑시네센터 앞,201904,586,351,937,37.600288,127.013702
성북구,1344, 아리랑시네센터 앞,201905,659,462,1121,37.600288,127.013702
성북구,1344, 아리랑시네센터 앞,201906,696,452,1148,37.600288,127.013702
성북구,1344, 아리랑시네센터 앞,201907,701,407,1108,37.600288,127.013702
성북구,1344, 아리랑시네센터 앞,201908,660,392,1052,37.600288,127.013702
성북구,1344, 아리랑시네센터 앞,201909,549,419,968,37.600288,127.013702
성북구,1344, 아리랑시네센터 앞,201910,567,437,1004,37.600288,127.013702
성북구,1344, 아리랑시네센터 앞,201911,371,297,668,37.600288,127.013702
성북구,1344, 아리랑시네센터 앞,201912,364,172,536,37.600288,127.013702
성북구,1344, 아리랑시네센터 앞,202001,311,158,469,37.600288,127.013702
성북구,1344, 아리랑시네센터 앞,202002,370,192,562,37.600288,127.013702
성북구,1344, 아리랑시네센터 앞,202003,519,334,853,37.600288,127.013702
성북구,1344, 아리랑시네센터 앞,202004,690,478,1168,37.600288,127.013702
성북구,1344, 아리랑시네센터 앞,202005,434,346,780,37.600288,127.013702
성북구,1344, 아리랑시네센터 앞,202006,498,408,906,37.600288,127.013702
성북구,1346, 길음8골어린이공원 옆,201901,327,204,531,37.608978,127.020248
성북구,1346, 길음8골어린이공원 옆,201902,277,152,429,37.608978,127.020248
성북구,1346, 길음8골어린이공원 옆,201903,529,381,910,37.608978,127.020248
성북구,1346, 길음8골어린이공원 옆,201904,869,735,1604,37.608978,127.020248
성북구,1346, 길음8골어린이공원 옆,201905,1101,991,2092,37.608978,127.020248
성북구,1346, 길음8골어린이공원 옆,201906,1104,967,2071,37.608978,127.020248
성북구,1346, 길음8골어린이공원 옆,201907,1021,815,1836,37.608978,127.020248
성북구,1346, 길음8골어린이공원 옆,201908,906,689,1595,37.608978,127.020248
성북구,1346, 길음8골어린이공원 옆,201909,898,698,1596,37.608978,127.020248
성북구,1346, 길음8골어린이공원 옆,201910,1096,835,1931,37.608978,127.020248
성북구,1346, 길음8골어린이공원 옆,201911,827,599,1426,37.608978,127.020248
성북구,1346, 길음8골어린이공원 옆,201912,511,302,813,37.608978,127.020248
성북구,1346, 길음8골어린이공원 옆,202001,440,346,786,37.608978,127.020248
성북구,1346, 길음8골어린이공원 옆,202002,461,337,798,37.608978,127.020248
성북구,1346, 길음8골어린이공원 옆,202003,665,529,1194,37.608978,127.020248
성북구,1346, 길음8골어린이공원 옆,202004,927,774,1701,37.608978,127.020248
성북구,1346, 길음8골어린이공원 옆,202005,1033,902,1935,37.608978,127.020248
성북구,1346, 길음8골어린이공원 옆,202006,1110,1004,2114,37.608978,127.020248
성북구,1347, 길음래미안아파트817동 상가 앞,201901,155,117,272,37.607105,127.0215
성북구,1347, 길음래미안아파트817동 상가 앞,201902,117,99,216,37.607105,127.0215
성북구,1347, 길음래미안아파트817동 상가 앞,201903,275,211,486,37.607105,127.0215
성북구,1347, 길음래미안아파트817동 상가 앞,201904,385,287,672,37.607105,127.0215
성북구,1347, 길음래미안아파트817동 상가 앞,201905,552,425,977,37.607105,127.0215
성북구,1347, 길음래미안아파트817동 상가 앞,201906,531,466,997,37.607105,127.0215
성북구,1347, 길음래미안아파트817동 상가 앞,201907,554,389,943,37.607105,127.0215
성북구,1347, 길음래미안아파트817동 상가 앞,201908,427,346,773,37.607105,127.0215
성북구,1347, 길음래미안아파트817동 상가 앞,201909,507,351,858,37.607105,127.0215
성북구,1347, 길음래미안아파트817동 상가 앞,201910,636,356,992,37.607105,127.0215
성북구,1347, 길음래미안아파트817동 상가 앞,201911,354,245,599,37.607105,127.0215
성북구,1347, 길음래미안아파트817동 상가 앞,201912,260,174,434,37.607105,127.0215
성북구,1347, 길음래미안아파트817동 상가 앞,202001,192,120,312,37.607105,127.0215
성북구,1347, 길음래미안아파트817동 상가 앞,202002,185,114,299,37.607105,127.0215
성북구,1347, 길음래미안아파트817동 상가 앞,202003,338,243,581,37.607105,127.0215
성북구,1347, 길음래미안아파트817동 상가 앞,202004,479,382,861,37.607105,127.0215
성북구,1347, 길음래미안아파트817동 상가 앞,202005,538,471,1009,37.607105,127.0215
성북구,1347, 길음래미안아파트817동 상가 앞,202006,577,526,1103,37.607105,127.0215
성북구,1348, 성북제일새마을금고 본점 앞,201901,144,155,299,37.604752,127.022758
성북구,1348, 성북제일새마을금고 본점 앞,201902,127,142,269,37.604752,127.022758
성북구,1348, 성북제일새마을금고 본점 앞,201903,275,274,549,37.604752,127.022758
성북구,1348, 성북제일새마을금고 본점 앞,201904,446,483,929,37.604752,127.022758
성북구,1348, 성북제일새마을금고 본점 앞,201905,651,680,1331,37.604752,127.022758
성북구,1348, 성북제일새마을금고 본점 앞,201906,614,655,1269,37.604752,127.022758
성북구,1348, 성북제일새마을금고 본점 앞,201907,558,636,1194,37.604752,127.022758
성북구,1348, 성북제일새마을금고 본점 앞,201908,472,514,986,37.604752,127.022758
성북구,1348, 성북제일새마을금고 본점 앞,201909,493,512,1005,37.604752,127.022758
성북구,1348, 성북제일새마을금고 본점 앞,201910,613,644,1257,37.604752,127.022758
성북구,1348, 성북제일새마을금고 본점 앞,201911,425,465,890,37.604752,127.022758
성북구,1348, 성북제일새마을금고 본점 앞,201912,232,272,504,37.604752,127.022758
성북구,1348, 성북제일새마을금고 본점 앞,202001,215,237,452,37.604752,127.022758
성북구,1348, 성북제일새마을금고 본점 앞,202002,194,243,437,37.604752,127.022758
성북구,1348, 성북제일새마을금고 본점 앞,202003,370,370,740,37.604752,127.022758
성북구,1348, 성북제일새마을금고 본점 앞,202004,519,509,1028,37.604752,127.022758
성북구,1348, 성북제일새마을금고 본점 앞,202005,569,564,1133,37.604752,127.022758
성북구,1348, 성북제일새마을금고 본점 앞,202006,705,725,1430,37.604752,127.022758
성북구,1349, 월계2교 버스정류장 앞,201901,42,55,97,37.623829,127.050201
성북구,1349, 월계2교 버스정류장 앞,201902,64,64,128,37.623829,127.050201
성북구,1349, 월계2교 버스정류장 앞,201903,131,145,276,37.623829,127.050201
성북구,1349, 월계2교 버스정류장 앞,201904,347,359,706,37.623829,127.050201
성북구,1349, 월계2교 버스정류장 앞,201905,539,540,1079,37.623829,127.050201
성북구,1349, 월계2교 버스정류장 앞,201906,522,555,1077,37.623829,127.050201
성북구,1349, 월계2교 버스정류장 앞,201907,439,537,976,37.623829,127.050201
성북구,1349, 월계2교 버스정류장 앞,201908,539,641,1180,37.623829,127.050201
성북구,1349, 월계2교 버스정류장 앞,201909,637,662,1299,37.623829,127.050201
성북구,1349, 월계2교 버스정류장 앞,201910,696,702,1398,37.623829,127.050201
성북구,1349, 월계2교 버스정류장 앞,201911,430,421,851,37.623829,127.050201
성북구,1349, 월계2교 버스정류장 앞,201912,266,253,519,37.623829,127.050201
성북구,1349, 월계2교 버스정류장 앞,202001,254,253,507,37.623829,127.050201
성북구,1349, 월계2교 버스정류장 앞,202002,216,209,425,37.623829,127.050201
성북구,1349, 월계2교 버스정류장 앞,202003,483,460,943,37.623829,127.050201
성북구,1349, 월계2교 버스정류장 앞,202004,770,737,1507,37.623829,127.050201
성북구,1349, 월계2교 버스정류장 앞,202005,731,714,1445,37.623829,127.050201
성북구,1349, 월계2교 버스정류장 앞,202006,701,744,1445,37.623829,127.050201
성북구,1351, 안암2교 옆,201901,510,686,1196,37.579449,127.024193
성북구,1351, 안암2교 옆,201902,417,532,949,37.579449,127.024193
성북구,1351, 안암2교 옆,201903,815,827,1642,37.579449,127.024193
성북구,1351, 안암2교 옆,201904,1174,1165,2339,37.579449,127.024193
성북구,1351, 안암2교 옆,201905,1815,1804,3619,37.579449,127.024193
성북구,1351, 안암2교 옆,201906,1980,2035,4015,37.579449,127.024193
성북구,1351, 안암2교 옆,201907,1890,1927,3817,37.579449,127.024193
성북구,1351, 안암2교 옆,201908,1854,1908,3762,37.579449,127.024193
성북구,1351, 안암2교 옆,201909,1918,1939,3857,37.579449,127.024193
성북구,1351, 안암2교 옆,201910,2179,2228,4407,37.579449,127.024193
성북구,1351, 안암2교 옆,201911,1475,1498,2973,37.579449,127.024193
성북구,1351, 안암2교 옆,201912,872,859,1731,37.579449,127.024193
성북구,1351, 안암2교 옆,202001,836,871,1707,37.579449,127.024193
성북구,1351, 안암2교 옆,202002,805,823,1628,37.579449,127.024193
성북구,1351, 안암2교 옆,202003,1540,1526,3066,37.579449,127.024193
성북구,1351, 안암2교 옆,202004,2126,2126,4252,37.579449,127.024193
성북구,1351, 안암2교 옆,202005,2209,2179,4388,37.579449,127.024193
성북구,1351, 안암2교 옆,202006,2230,2165,4395,37.579449,127.024193
성북구,1352, e 편한세상 보문아파트 내,201901,135,66,201,37.583881,127.017097
성북구,1352, e 편한세상 보문아파트 내,201902,132,81,213,37.583881,127.017097
성북구,1352, e 편한세상 보문아파트 내,201903,262,135,397,37.583881,127.017097
성북구,1352, e 편한세상 보문아파트 내,201904,321,171,492,37.583881,127.017097
성북구,1352, e 편한세상 보문아파트 내,201905,456,289,745,37.583881,127.017097
성북구,1352, e 편한세상 보문아파트 내,201906,427,318,745,37.583881,127.017097
성북구,1352, e 편한세상 보문아파트 내,201907,454,298,752,37.583881,127.017097
성북구,1352, e 편한세상 보문아파트 내,201908,399,240,639,37.583881,127.017097
성북구,1352, e 편한세상 보문아파트 내,201909,324,187,511,37.583881,127.017097
성북구,1352, e 편한세상 보문아파트 내,201910,394,204,598,37.583881,127.017097
성북구,1352, e 편한세상 보문아파트 내,201911,306,148,454,37.583881,127.017097
성북구,1352, e 편한세상 보문아파트 내,201912,238,109,347,37.583881,127.017097
성북구,1352, e 편한세상 보문아파트 내,202001,206,125,331,37.583881,127.017097
성북구,1352, e 편한세상 보문아파트 내,202002,147,101,248,37.583881,127.017097
성북구,1352, e 편한세상 보문아파트 내,202003,257,157,414,37.583881,127.017097
성북구,1352, e 편한세상 보문아파트 내,202004,278,180,458,37.583881,127.017097
성북구,1352, e 편한세상 보문아파트 내,202005,230,172,402,37.583881,127.017097
성북구,1352, e 편한세상 보문아파트 내,202006,341,148,489,37.583881,127.017097
성북구,1353, 금호어울림센터힐 내,201901,90,79,169,37.60083,127.023552
성북구,1353, 금호어울림센터힐 내,201902,76,86,162,37.60083,127.023552
성북구,1353, 금호어울림센터힐 내,201903,163,145,308,37.60083,127.023552
성북구,1353, 금호어울림센터힐 내,201904,203,159,362,37.60083,127.023552
성북구,1353, 금호어울림센터힐 내,201905,274,220,494,37.60083,127.023552
성북구,1353, 금호어울림센터힐 내,201906,360,292,652,37.60083,127.023552
성북구,1353, 금호어울림센터힐 내,201907,309,263,572,37.60083,127.023552
성북구,1353, 금호어울림센터힐 내,201908,320,233,553,37.60083,127.023552
성북구,1353, 금호어울림센터힐 내,201909,368,287,655,37.60083,127.023552
성북구,1353, 금호어울림센터힐 내,201910,426,314,740,37.60083,127.023552
성북구,1353, 금호어울림센터힐 내,201911,255,229,484,37.60083,127.023552
성북구,1353, 금호어울림센터힐 내,201912,203,160,363,37.60083,127.023552
성북구,1353, 금호어울림센터힐 내,202001,203,176,379,37.60083,127.023552
성북구,1353, 금호어울림센터힐 내,202002,192,181,373,37.60083,127.023552
성북구,1353, 금호어울림센터힐 내,202003,280,240,520,37.60083,127.023552
성북구,1353, 금호어울림센터힐 내,202004,325,315,640,37.60083,127.023552
성북구,1353, 금호어울림센터힐 내,202005,340,332,672,37.60083,127.023552
성북구,1353, 금호어울림센터힐 내,202006,408,410,818,37.60083,127.023552
성북구,1354, 고려대학교 2번출구,201901,452,462,914,37.590714,127.036194
성북구,1354, 고려대학교 2번출구,201902,417,436,853,37.590714,127.036194
성북구,1354, 고려대학교 2번출구,201903,1284,1366,2650,37.590714,127.036194
성북구,1354, 고려대학교 2번출구,201904,1775,1896,3671,37.590714,127.036194
성북구,1354, 고려대학교 2번출구,201905,2606,2632,5238,37.590714,127.036194
성북구,1354, 고려대학교 2번출구,201906,2649,2648,5297,37.590714,127.036194
성북구,1354, 고려대학교 2번출구,201907,2218,2134,4352,37.590714,127.036194
성북구,1354, 고려대학교 2번출구,201908,2131,2090,4221,37.590714,127.036194
성북구,1354, 고려대학교 2번출구,201909,2456,2488,4944,37.590714,127.036194
성북구,1354, 고려대학교 2번출구,201910,3216,3100,6316,37.590714,127.036194
성북구,1354, 고려대학교 2번출구,201911,2182,2206,4388,37.590714,127.036194
성북구,1354, 고려대학교 2번출구,201912,1237,1197,2434,37.590714,127.036194
성북구,1354, 고려대학교 2번출구,202001,831,695,1526,37.590714,127.036194
성북구,1354, 고려대학교 2번출구,202002,884,775,1659,37.590714,127.036194
성북구,1354, 고려대학교 2번출구,202003,1278,1135,2413,37.590714,127.036194
성북구,1354, 고려대학교 2번출구,202004,1991,1878,3869,37.590714,127.036194
성북구,1354, 고려대학교 2번출구,202005,2162,2101,4263,37.590714,127.036194
성북구,1354, 고려대학교 2번출구,202006,2181,2139,4320,37.590714,127.036194
성북구,1355, 보문2교,201901,472,523,995,37.588699,127.018913
성북구,1355, 보문2교,201902,387,435,822,37.588699,127.018913
성북구,1355, 보문2교,201903,902,964,1866,37.588699,127.018913
성북구,1355, 보문2교,201904,1614,1672,3286,37.588699,127.018913
성북구,1355, 보문2교,201905,2681,2808,5489,37.588699,127.018913
성북구,1355, 보문2교,201906,2694,2753,5447,37.588699,127.018913
성북구,1355, 보문2교,201907,2157,2433,4590,37.588699,127.018913
성북구,1355, 보문2교,201908,2099,2115,4214,37.588699,127.018913
성북구,1355, 보문2교,201909,2470,2487,4957,37.588699,127.018913
성북구,1355, 보문2교,201910,2692,2664,5356,37.588699,127.018913
성북구,1355, 보문2교,201911,1369,1391,2760,37.588699,127.018913
성북구,1355, 보문2교,201912,739,802,1541,37.588699,127.018913
성북구,1355, 보문2교,202001,628,647,1275,37.588699,127.018913
성북구,1355, 보문2교,202002,737,709,1446,37.588699,127.018913
성북구,1355, 보문2교,202003,2150,2212,4362,37.588699,127.018913
성북구,1355, 보문2교,202004,3369,3358,6727,37.588699,127.018913
성북구,1355, 보문2교,202005,3205,3179,6384,37.588699,127.018913
성북구,1355, 보문2교,202006,3137,3087,6224,37.588699,127.018913
성북구,1357, 북한산보국문역,201901,132,103,235,37.612072,127.008133
성북구,1357, 북한산보국문역,201902,118,94,212,37.612072,127.008133
성북구,1357, 북한산보국문역,201903,247,171,418,37.612072,127.008133
성북구,1357, 북한산보국문역,201904,483,391,874,37.612072,127.008133
성북구,1357, 북한산보국문역,201905,694,527,1221,37.612072,127.008133
성북구,1357, 북한산보국문역,201906,676,569,1245,37.612072,127.008133
성북구,1357, 북한산보국문역,201907,724,541,1265,37.612072,127.008133
성북구,1357, 북한산보국문역,201908,614,484,1098,37.612072,127.008133
성북구,1357, 북한산보국문역,201909,621,460,1081,37.612072,127.008133
성북구,1357, 북한산보국문역,201910,621,440,1061,37.612072,127.008133
성북구,1357, 북한산보국문역,201911,365,272,637,37.612072,127.008133
성북구,1357, 북한산보국문역,201912,252,201,453,37.612072,127.008133
성북구,1357, 북한산보국문역,202001,223,172,395,37.612072,127.008133
성북구,1357, 북한산보국문역,202002,253,203,456,37.612072,127.008133
성북구,1357, 북한산보국문역,202003,463,383,846,37.612072,127.008133
성북구,1357, 북한산보국문역,202004,647,587,1234,37.612072,127.008133
성북구,1357, 북한산보국문역,202005,733,656,1389,37.612072,127.008133
성북구,1357, 북한산보국문역,202006,783,695,1478,37.612072,127.008133
성북구,1358, 정릉도서관 앞,201901,185,211,396,37.60479,127.010582
성북구,1358, 정릉도서관 앞,201902,132,120,252,37.60479,127.010582
성북구,1358, 정릉도서관 앞,201903,284,301,585,37.60479,127.010582
성북구,1358, 정릉도서관 앞,201904,359,434,793,37.60479,127.010582
성북구,1358, 정릉도서관 앞,201905,569,622,1191,37.60479,127.010582
성북구,1358, 정릉도서관 앞,201906,686,766,1452,37.60479,127.010582
성북구,1358, 정릉도서관 앞,201907,522,646,1168,37.60479,127.010582
성북구,1358, 정릉도서관 앞,201908,566,666,1232,37.60479,127.010582
성북구,1358, 정릉도서관 앞,201909,611,627,1238,37.60479,127.010582
성북구,1358, 정릉도서관 앞,201910,643,681,1324,37.60479,127.010582
성북구,1358, 정릉도서관 앞,201911,429,463,892,37.60479,127.010582
성북구,1358, 정릉도서관 앞,201912,246,318,564,37.60479,127.010582
성북구,1358, 정릉도서관 앞,202001,231,266,497,37.60479,127.010582
성북구,1358, 정릉도서관 앞,202002,182,205,387,37.60479,127.010582
성북구,1358, 정릉도서관 앞,202003,440,506,946,37.60479,127.010582
성북구,1358, 정릉도서관 앞,202004,680,689,1369,37.60479,127.010582
성북구,1358, 정릉도서관 앞,202005,801,790,1591,37.60479,127.010582
성북구,1358, 정릉도서관 앞,202006,910,924,1834,37.60479,127.010582
성북구,1359, 장위뉴타운 꿈에 숲 코오롱 하늘채 앞,201901,162,129,291,37.619801,127.045097
성북구,1359, 장위뉴타운 꿈에 숲 코오롱 하늘채 앞,201902,124,117,241,37.619801,127.045097
성북구,1359, 장위뉴타운 꿈에 숲 코오롱 하늘채 앞,201903,252,238,490,37.619801,127.045097
성북구,1359, 장위뉴타운 꿈에 숲 코오롱 하늘채 앞,201904,492,405,897,37.619801,127.045097
성북구,1359, 장위뉴타운 꿈에 숲 코오롱 하늘채 앞,201905,818,753,1571,37.619801,127.045097
성북구,1359, 장위뉴타운 꿈에 숲 코오롱 하늘채 앞,201906,831,764,1595,37.619801,127.045097
성북구,1359, 장위뉴타운 꿈에 숲 코오롱 하늘채 앞,201907,816,682,1498,37.619801,127.045097
성북구,1359, 장위뉴타운 꿈에 숲 코오롱 하늘채 앞,201908,849,704,1553,37.619801,127.045097
성북구,1359, 장위뉴타운 꿈에 숲 코오롱 하늘채 앞,201909,759,701,1460,37.619801,127.045097
성북구,1359, 장위뉴타운 꿈에 숲 코오롱 하늘채 앞,201910,839,731,1570,37.619801,127.045097
성북구,1359, 장위뉴타운 꿈에 숲 코오롱 하늘채 앞,201911,508,435,943,37.619801,127.045097
성북구,1359, 장위뉴타운 꿈에 숲 코오롱 하늘채 앞,201912,265,203,468,37.619801,127.045097
성북구,1359, 장위뉴타운 꿈에 숲 코오롱 하늘채 앞,202001,245,199,444,37.619801,127.045097
성북구,1359, 장위뉴타운 꿈에 숲 코오롱 하늘채 앞,202002,239,164,403,37.619801,127.045097
성북구,1359, 장위뉴타운 꿈에 숲 코오롱 하늘채 앞,202003,622,499,1121,37.619801,127.045097
성북구,1359, 장위뉴타운 꿈에 숲 코오롱 하늘채 앞,202004,1088,995,2083,37.619801,127.045097
성북구,1359, 장위뉴타운 꿈에 숲 코오롱 하늘채 앞,202005,1235,1177,2412,37.619801,127.045097
성북구,1359, 장위뉴타운 꿈에 숲 코오롱 하늘채 앞,202006,1148,1100,2248,37.619801,127.045097
성북구,1360, 정릉역,201901,114,103,217,37.603096,127.013504
성북구,1360, 정릉역,201902,91,86,177,37.603096,127.013504
성북구,1360, 정릉역,201903,183,190,373,37.603096,127.013504
성북구,1360, 정릉역,201904,286,288,574,37.603096,127.013504
성북구,1360, 정릉역,201905,436,431,867,37.603096,127.013504
성북구,1360, 정릉역,201906,443,465,908,37.603096,127.013504
성북구,1360, 정릉역,201907,457,482,939,37.603096,127.013504
성북구,1360, 정릉역,201908,370,410,780,37.603096,127.013504
성북구,1360, 정릉역,201909,446,436,882,37.603096,127.013504
성북구,1360, 정릉역,201910,537,557,1094,37.603096,127.013504
성북구,1360, 정릉역,201911,723,738,1461,37.603096,127.013504
성북구,1360, 정릉역,201912,360,376,736,37.603096,127.013504
성북구,1360, 정릉역,202001,366,343,709,37.603096,127.013504
성북구,1360, 정릉역,202002,317,318,635,37.603096,127.013504
성북구,1360, 정릉역,202003,651,645,1296,37.603096,127.013504
성북구,1360, 정릉역,202004,904,867,1771,37.603096,127.013504
성북구,1360, 정릉역,202005,1055,1026,2081,37.603096,127.013504
성북구,1360, 정릉역,202006,1097,987,2084,37.603096,127.013504
성북구,1361, 홍익중고 입구,201901,297,254,551,37.592842,127.002121
성북구,1361, 홍익중고 입구,201902,296,232,528,37.592842,127.002121
성북구,1361, 홍익중고 입구,201903,579,522,1101,37.592842,127.002121
성북구,1361, 홍익중고 입구,201904,759,665,1424,37.592842,127.002121
성북구,1361, 홍익중고 입구,201905,1189,1157,2346,37.592842,127.002121
성북구,1361, 홍익중고 입구,201906,1337,1172,2509,37.592842,127.002121
성북구,1361, 홍익중고 입구,201907,1291,1160,2451,37.592842,127.002121
성북구,1361, 홍익중고 입구,201908,1254,1155,2409,37.592842,127.002121
성북구,1361, 홍익중고 입구,201909,765,685,1450,37.592842,127.002121
성북구,1361, 홍익중고 입구,201910,1203,1053,2256,37.592842,127.002121
성북구,1361, 홍익중고 입구,201911,711,645,1356,37.592842,127.002121
성북구,1361, 홍익중고 입구,201912,467,371,838,37.592842,127.002121
성북구,1361, 홍익중고 입구,202001,414,312,726,37.592842,127.002121
성북구,1361, 홍익중고 입구,202002,429,327,756,37.592842,127.002121
성북구,1361, 홍익중고 입구,202003,716,576,1292,37.592842,127.002121
성북구,1361, 홍익중고 입구,202004,1136,964,2100,37.592842,127.002121
성북구,1361, 홍익중고 입구,202005,1108,1048,2156,37.592842,127.002121
성북구,1361, 홍익중고 입구,202006,1182,1032,2214,37.592842,127.002121
성북구,1362, 보문역6번출구 앞,201901,260,295,555,37.585098,127.019676
성북구,1362, 보문역6번출구 앞,201902,287,306,593,37.585098,127.019676
성북구,1362, 보문역6번출구 앞,201903,572,577,1149,37.585098,127.019676
성북구,1362, 보문역6번출구 앞,201904,861,927,1788,37.585098,127.019676
성북구,1362, 보문역6번출구 앞,201905,1382,1478,2860,37.585098,127.019676
성북구,1362, 보문역6번출구 앞,201906,1666,1779,3445,37.585098,127.019676
성북구,1362, 보문역6번출구 앞,201907,1452,1610,3062,37.585098,127.019676
성북구,1362, 보문역6번출구 앞,201908,1383,1454,2837,37.585098,127.019676
성북구,1362, 보문역6번출구 앞,201909,1419,1417,2836,37.585098,127.019676
성북구,1362, 보문역6번출구 앞,201910,1647,1659,3306,37.585098,127.019676
성북구,1362, 보문역6번출구 앞,201911,940,937,1877,37.585098,127.019676
성북구,1362, 보문역6번출구 앞,201912,517,575,1092,37.585098,127.019676
성북구,1362, 보문역6번출구 앞,202001,434,467,901,37.585098,127.019676
성북구,1362, 보문역6번출구 앞,202002,519,561,1080,37.585098,127.019676
성북구,1362, 보문역6번출구 앞,202003,966,991,1957,37.585098,127.019676
성북구,1362, 보문역6번출구 앞,202004,1418,1453,2871,37.585098,127.019676
성북구,1362, 보문역6번출구 앞,202005,1430,1432,2862,37.585098,127.019676
성북구,1362, 보문역6번출구 앞,202006,1692,1700,3392,37.585098,127.019676
성북구,1363, 보문4교 인근,201901,398,359,757,37.583752,127.02195
성북구,1363, 보문4교 인근,201902,386,372,758,37.583752,127.02195
성북구,1363, 보문4교 인근,201903,788,758,1546,37.583752,127.02195
성북구,1363, 보문4교 인근,201904,1086,1011,2097,37.583752,127.02195
성북구,1363, 보문4교 인근,201905,1646,1576,3222,37.583752,127.02195
성북구,1363, 보문4교 인근,201906,2151,2123,4274,37.583752,127.02195
성북구,1363, 보문4교 인근,201907,2135,2147,4282,37.583752,127.02195
성북구,1363, 보문4교 인근,201908,1930,2006,3936,37.583752,127.02195
성북구,1363, 보문4교 인근,201909,1886,1849,3735,37.583752,127.02195
성북구,1363, 보문4교 인근,201910,2157,2298,4455,37.583752,127.02195
성북구,1363, 보문4교 인근,201911,1335,1339,2674,37.583752,127.02195
성북구,1363, 보문4교 인근,201912,860,824,1684,37.583752,127.02195
성북구,1363, 보문4교 인근,202001,797,776,1573,37.583752,127.02195
성북구,1363, 보문4교 인근,202002,786,799,1585,37.583752,127.02195
성북구,1363, 보문4교 인근,202003,1471,1354,2825,37.583752,127.02195
성북구,1363, 보문4교 인근,202004,1965,1891,3856,37.583752,127.02195
성북구,1363, 보문4교 인근,202005,2304,2205,4509,37.583752,127.02195
성북구,1363, 보문4교 인근,202006,2621,2581,5202,37.583752,127.02195
성북구,1364, 성북동 치안센터 앞,201901,167,103,270,37.590172,127.004089
성북구,1364, 성북동 치안센터 앞,201902,171,130,301,37.590172,127.004089
성북구,1364, 성북동 치안센터 앞,201903,372,312,684,37.590172,127.004089
성북구,1364, 성북동 치안센터 앞,201904,442,375,817,37.590172,127.004089
성북구,1364, 성북동 치안센터 앞,201905,646,595,1241,37.590172,127.004089
성북구,1364, 성북동 치안센터 앞,201906,641,609,1250,37.590172,127.004089
성북구,1364, 성북동 치안센터 앞,201907,650,636,1286,37.590172,127.004089
성북구,1364, 성북동 치안센터 앞,201908,672,641,1313,37.590172,127.004089
성북구,1364, 성북동 치안센터 앞,201909,716,703,1419,37.590172,127.004089
성북구,1364, 성북동 치안센터 앞,201910,779,760,1539,37.590172,127.004089
성북구,1364, 성북동 치안센터 앞,201911,563,555,1118,37.590172,127.004089
성북구,1364, 성북동 치안센터 앞,201912,462,401,863,37.590172,127.004089
성북구,1364, 성북동 치안센터 앞,202001,403,355,758,37.590172,127.004089
성북구,1364, 성북동 치안센터 앞,202002,331,301,632,37.590172,127.004089
성북구,1364, 성북동 치안센터 앞,202003,443,406,849,37.590172,127.004089
성북구,1364, 성북동 치안센터 앞,202004,664,658,1322,37.590172,127.004089
성북구,1364, 성북동 치안센터 앞,202005,713,677,1390,37.590172,127.004089
성북구,1364, 성북동 치안센터 앞,202006,687,686,1373,37.590172,127.004089
성북구,1365, 선잠단지 앞,201901,68,50,118,37.593361,126.999092
성북구,1365, 선잠단지 앞,201902,48,54,102,37.593361,126.999092
성북구,1365, 선잠단지 앞,201903,157,104,261,37.593361,126.999092
성북구,1365, 선잠단지 앞,201904,192,173,365,37.593361,126.999092
성북구,1365, 선잠단지 앞,201905,342,218,560,37.593361,126.999092
성북구,1365, 선잠단지 앞,201906,324,214,538,37.593361,126.999092
성북구,1365, 선잠단지 앞,201907,318,218,536,37.593361,126.999092
성북구,1365, 선잠단지 앞,201908,268,202,470,37.593361,126.999092
성북구,1365, 선잠단지 앞,201909,371,300,671,37.593361,126.999092
성북구,1365, 선잠단지 앞,201910,328,223,551,37.593361,126.999092
성북구,1365, 선잠단지 앞,201911,276,187,463,37.593361,126.999092
성북구,1365, 선잠단지 앞,201912,129,125,254,37.593361,126.999092
성북구,1365, 선잠단지 앞,202001,98,98,196,37.593361,126.999092
성북구,1365, 선잠단지 앞,202002,134,99,233,37.593361,126.999092
성북구,1365, 선잠단지 앞,202003,217,191,408,37.593361,126.999092
성북구,1365, 선잠단지 앞,202004,271,244,515,37.593361,126.999092
성북구,1365, 선잠단지 앞,202005,298,267,565,37.593361,126.999092
성북구,1365, 선잠단지 앞,202006,299,263,562,37.593361,126.999092
성북구,1366, 일신초등학교 옆,201901,41,52,93,37.59972,127.040382
성북구,1366, 일신초등학교 옆,201902,54,61,115,37.59972,127.040382
성북구,1366, 일신초등학교 옆,201903,151,118,269,37.59972,127.040382
성북구,1366, 일신초등학교 옆,201904,246,200,446,37.59972,127.040382
성북구,1366, 일신초등학교 옆,201905,305,260,565,37.59972,127.040382
성북구,1366, 일신초등학교 옆,201906,378,357,735,37.59972,127.040382
성북구,1366, 일신초등학교 옆,201907,334,310,644,37.59972,127.040382
성북구,1366, 일신초등학교 옆,201908,357,309,666,37.59972,127.040382
성북구,1366, 일신초등학교 옆,201909,410,369,779,37.59972,127.040382
성북구,1366, 일신초등학교 옆,201910,429,367,796,37.59972,127.040382
성북구,1366, 일신초등학교 옆,201911,265,242,507,37.59972,127.040382
성북구,1366, 일신초등학교 옆,201912,170,147,317,37.59972,127.040382
성북구,1366, 일신초등학교 옆,202001,154,117,271,37.59972,127.040382
성북구,1366, 일신초등학교 옆,202002,145,119,264,37.59972,127.040382
성북구,1366, 일신초등학교 옆,202003,238,212,450,37.59972,127.040382
성북구,1366, 일신초등학교 옆,202004,535,506,1041,37.59972,127.040382
성북구,1366, 일신초등학교 옆,202005,559,514,1073,37.59972,127.040382
성북구,1366, 일신초등학교 옆,202006,541,512,1053,37.59972,127.040382
성북구,1367, 길음문화복합미디어센터,201901,131,135,266,37.603512,127.02256
성북구,1367, 길음문화복합미디어센터,201902,67,119,186,37.603512,127.02256
성북구,1367, 길음문화복합미디어센터,201903,198,180,378,37.603512,127.02256
성북구,1367, 길음문화복합미디어센터,201904,327,354,681,37.603512,127.02256
성북구,1367, 길음문화복합미디어센터,201905,517,511,1028,37.603512,127.02256
성북구,1367, 길음문화복합미디어센터,201906,536,599,1135,37.603512,127.02256
성북구,1367, 길음문화복합미디어센터,201907,518,525,1043,37.603512,127.02256
성북구,1367, 길음문화복합미디어센터,201908,423,464,887,37.603512,127.02256
성북구,1367, 길음문화복합미디어센터,201909,472,488,960,37.603512,127.02256
성북구,1367, 길음문화복합미디어센터,201910,482,511,993,37.603512,127.02256
성북구,1367, 길음문화복합미디어센터,201911,357,363,720,37.603512,127.02256
성북구,1367, 길음문화복합미디어센터,201912,202,263,465,37.603512,127.02256
성북구,1367, 길음문화복합미디어센터,202001,231,274,505,37.603512,127.02256
성북구,1367, 길음문화복합미디어센터,202002,194,251,445,37.603512,127.02256
성북구,1367, 길음문화복합미디어센터,202003,308,263,571,37.603512,127.02256
성북구,1367, 길음문화복합미디어센터,202004,406,388,794,37.603512,127.02256
성북구,1367, 길음문화복합미디어센터,202005,407,381,788,37.603512,127.02256
성북구,1367, 길음문화복합미디어센터,202006,500,504,1004,37.603512,127.02256
성북구,1368, 성신여대입구 교차로,201901,200,216,416,37.59148,127.020103
성북구,1368, 성신여대입구 교차로,201902,202,184,386,37.59148,127.020103
성북구,1368, 성신여대입구 교차로,201903,538,535,1073,37.59148,127.020103
성북구,1368, 성신여대입구 교차로,201904,835,813,1648,37.59148,127.020103
성북구,1368, 성신여대입구 교차로,201905,1433,1375,2808,37.59148,127.020103
성북구,1368, 성신여대입구 교차로,201906,1397,1359,2756,37.59148,127.020103
성북구,1368, 성신여대입구 교차로,201907,1211,1245,2456,37.59148,127.020103
성북구,1368, 성신여대입구 교차로,201908,1137,1135,2272,37.59148,127.020103
성북구,1368, 성신여대입구 교차로,201909,1409,1387,2796,37.59148,127.020103
성북구,1368, 성신여대입구 교차로,201910,1482,1456,2938,37.59148,127.020103
성북구,1368, 성신여대입구 교차로,201911,900,918,1818,37.59148,127.020103
성북구,1368, 성신여대입구 교차로,201912,498,499,997,37.59148,127.020103
성북구,1368, 성신여대입구 교차로,202001,396,388,784,37.59148,127.020103
성북구,1368, 성신여대입구 교차로,202002,399,401,800,37.59148,127.020103
성북구,1368, 성신여대입구 교차로,202003,886,874,1760,37.59148,127.020103
성북구,1368, 성신여대입구 교차로,202004,1278,1240,2518,37.59148,127.020103
성북구,1368, 성신여대입구 교차로,202005,1453,1440,2893,37.59148,127.020103
성북구,1368, 성신여대입구 교차로,202006,1425,1411,2836,37.59148,127.020103
성북구,1369, 미아사거리,201901,196,234,430,37.609131,127.030029
성북구,1369, 미아사거리,201902,214,214,428,37.609131,127.030029
성북구,1369, 미아사거리,201903,451,510,961,37.609131,127.030029
성북구,1369, 미아사거리,201904,703,799,1502,37.609131,127.030029
성북구,1369, 미아사거리,201905,1187,1233,2420,37.609131,127.030029
성북구,1369, 미아사거리,201906,1393,1393,2786,37.609131,127.030029
성북구,1369, 미아사거리,201907,1133,1104,2237,37.609131,127.030029
성북구,1369, 미아사거리,201908,1053,1054,2107,37.609131,127.030029
성북구,1369, 미아사거리,201909,1281,1244,2525,37.609131,127.030029
성북구,1369, 미아사거리,201910,1461,1490,2951,37.609131,127.030029
성북구,1369, 미아사거리,201911,911,967,1878,37.609131,127.030029
성북구,1369, 미아사거리,201912,459,501,960,37.609131,127.030029
성북구,1369, 미아사거리,202001,473,515,988,37.609131,127.030029
성북구,1369, 미아사거리,202002,483,519,1002,37.609131,127.030029
성북구,1369, 미아사거리,202003,1017,1057,2074,37.609131,127.030029
성북구,1369, 미아사거리,202004,1642,1613,3255,37.609131,127.030029
성북구,1369, 미아사거리,202005,1834,1823,3657,37.609131,127.030029
성북구,1369, 미아사거리,202006,2093,2111,4204,37.609131,127.030029
성북구,1370, 복자사랑 피정의 집,201901,110,50,160,37.59454,126.995209
성북구,1370, 복자사랑 피정의 집,201902,97,50,147,37.59454,126.995209
성북구,1370, 복자사랑 피정의 집,201903,198,69,267,37.59454,126.995209
성북구,1370, 복자사랑 피정의 집,201904,248,93,341,37.59454,126.995209
성북구,1370, 복자사랑 피정의 집,201905,368,163,531,37.59454,126.995209
성북구,1370, 복자사랑 피정의 집,201906,417,234,651,37.59454,126.995209
성북구,1370, 복자사랑 피정의 집,201907,515,220,735,37.59454,126.995209
성북구,1370, 복자사랑 피정의 집,201908,518,201,719,37.59454,126.995209
성북구,1370, 복자사랑 피정의 집,201909,468,198,666,37.59454,126.995209
성북구,1370, 복자사랑 피정의 집,201910,601,232,833,37.59454,126.995209
성북구,1370, 복자사랑 피정의 집,201911,443,145,588,37.59454,126.995209
성북구,1370, 복자사랑 피정의 집,201912,341,135,476,37.59454,126.995209
성북구,1370, 복자사랑 피정의 집,202001,317,128,445,37.59454,126.995209
성북구,1370, 복자사랑 피정의 집,202002,285,130,415,37.59454,126.995209
성북구,1370, 복자사랑 피정의 집,202003,410,224,634,37.59454,126.995209
성북구,1370, 복자사랑 피정의 집,202004,481,282,763,37.59454,126.995209
성북구,1370, 복자사랑 피정의 집,202005,440,236,676,37.59454,126.995209
성북구,1370, 복자사랑 피정의 집,202006,570,258,828,37.59454,126.995209
성북구,1372, KEB은행 고대점,201901,611,484,1095,37.586445,127.031601
성북구,1372, KEB은행 고대점,201902,517,363,880,37.586445,127.031601
성북구,1372, KEB은행 고대점,201903,1292,1259,2551,37.586445,127.031601
성북구,1372, KEB은행 고대점,201904,1883,1764,3647,37.586445,127.031601
성북구,1372, KEB은행 고대점,201905,2815,2807,5622,37.586445,127.031601
성북구,1372, KEB은행 고대점,201906,2728,2672,5400,37.586445,127.031601
성북구,1372, KEB은행 고대점,201907,2617,2442,5059,37.586445,127.031601
성북구,1372, KEB은행 고대점,201908,2361,2250,4611,37.586445,127.031601
성북구,1372, KEB은행 고대점,201909,2704,2818,5522,37.586445,127.031601
성북구,1372, KEB은행 고대점,201910,2898,2973,5871,37.586445,127.031601
성북구,1372, KEB은행 고대점,201911,706,725,1431,37.586445,127.031601
성북구,1372, KEB은행 고대점,201912,1136,1036,2172,37.586445,127.031601
성북구,1372, KEB은행 고대점,202001,836,724,1560,37.586445,127.031601
성북구,1372, KEB은행 고대점,202002,841,794,1635,37.586445,127.031601
성북구,1372, KEB은행 고대점,202003,1608,1581,3189,37.586445,127.031601
성북구,1372, KEB은행 고대점,202004,2247,2221,4468,37.586445,127.031601
성북구,1372, KEB은행 고대점,202005,2514,2580,5094,37.586445,127.031601
성북구,1372, KEB은행 고대점,202006,2461,2503,4964,37.586445,127.031601
성북구,1373, 성북구보건소 건너편,201901,216,210,426,37.602291,127.038979
성북구,1373, 성북구보건소 건너편,201902,171,159,330,37.602291,127.038979
성북구,1373, 성북구보건소 건너편,201903,381,378,759,37.602291,127.038979
성북구,1373, 성북구보건소 건너편,201904,454,437,891,37.602291,127.038979
성북구,1373, 성북구보건소 건너편,201905,721,728,1449,37.602291,127.038979
성북구,1373, 성북구보건소 건너편,201906,810,815,1625,37.602291,127.038979
성북구,1373, 성북구보건소 건너편,201907,731,737,1468,37.602291,127.038979
성북구,1373, 성북구보건소 건너편,201908,755,729,1484,37.602291,127.038979
성북구,1373, 성북구보건소 건너편,201909,878,831,1709,37.602291,127.038979
성북구,1373, 성북구보건소 건너편,201910,917,878,1795,37.602291,127.038979
성북구,1373, 성북구보건소 건너편,201911,569,545,1114,37.602291,127.038979
성북구,1373, 성북구보건소 건너편,201912,364,335,699,37.602291,127.038979
성북구,1373, 성북구보건소 건너편,202001,350,335,685,37.602291,127.038979
성북구,1373, 성북구보건소 건너편,202002,303,308,611,37.602291,127.038979
성북구,1373, 성북구보건소 건너편,202003,706,651,1357,37.602291,127.038979
성북구,1373, 성북구보건소 건너편,202004,1038,958,1996,37.602291,127.038979
성북구,1373, 성북구보건소 건너편,202005,1249,1138,2387,37.602291,127.038979
성북구,1373, 성북구보건소 건너편,202006,1545,1461,3006,37.602291,127.038979
성북구,1375, 생명의 전화 종합복지관 앞 교차로,201901,199,210,409,37.603909,127.037376
성북구,1375, 생명의 전화 종합복지관 앞 교차로,201902,205,209,414,37.603909,127.037376
성북구,1375, 생명의 전화 종합복지관 앞 교차로,201903,418,453,871,37.603909,127.037376
성북구,1375, 생명의 전화 종합복지관 앞 교차로,201904,639,701,1340,37.603909,127.037376
성북구,1375, 생명의 전화 종합복지관 앞 교차로,201905,1160,1260,2420,37.603909,127.037376
성북구,1375, 생명의 전화 종합복지관 앞 교차로,201906,1438,1568,3006,37.603909,127.037376
성북구,1375, 생명의 전화 종합복지관 앞 교차로,201907,1346,1582,2928,37.603909,127.037376
성북구,1375, 생명의 전화 종합복지관 앞 교차로,201908,1302,1451,2753,37.603909,127.037376
성북구,1375, 생명의 전화 종합복지관 앞 교차로,201909,1433,1473,2906,37.603909,127.037376
성북구,1375, 생명의 전화 종합복지관 앞 교차로,201910,1867,1899,3766,37.603909,127.037376
성북구,1375, 생명의 전화 종합복지관 앞 교차로,201911,1074,1126,2200,37.603909,127.037376
성북구,1375, 생명의 전화 종합복지관 앞 교차로,201912,780,811,1591,37.603909,127.037376
성북구,1375, 생명의 전화 종합복지관 앞 교차로,202001,695,727,1422,37.603909,127.037376
성북구,1375, 생명의 전화 종합복지관 앞 교차로,202002,627,670,1297,37.603909,127.037376
성북구,1375, 생명의 전화 종합복지관 앞 교차로,202003,1118,1099,2217,37.603909,127.037376
성북구,1375, 생명의 전화 종합복지관 앞 교차로,202004,1837,1775,3612,37.603909,127.037376
성북구,1375, 생명의 전화 종합복지관 앞 교차로,202005,2108,2141,4249,37.603909,127.037376
성북구,1375, 생명의 전화 종합복지관 앞 교차로,202006,2506,2593,5099,37.603909,127.037376
성북구,1376, 한국과학기술연구원 중문,201905,61,48,109,37.600239,127.04538
성북구,1376, 한국과학기술연구원 중문,201906,278,267,545,37.600239,127.04538
성북구,1376, 한국과학기술연구원 중문,201907,340,312,652,37.600239,127.04538
성북구,1376, 한국과학기술연구원 중문,201908,292,250,542,37.600239,127.04538
성북구,1376, 한국과학기술연구원 중문,201909,305,326,631,37.600239,127.04538
성북구,1376, 한국과학기술연구원 중문,201910,379,392,771,37.600239,127.04538
성북구,1376, 한국과학기술연구원 중문,201911,235,224,459,37.600239,127.04538
성북구,1376, 한국과학기술연구원 중문,201912,147,110,257,37.600239,127.04538
성북구,1376, 한국과학기술연구원 중문,202001,123,78,201,37.600239,127.04538
성북구,1376, 한국과학기술연구원 중문,202002,113,82,195,37.600239,127.04538
성북구,1376, 한국과학기술연구원 중문,202003,210,168,378,37.600239,127.04538
성북구,1376, 한국과학기술연구원 중문,202004,270,270,540,37.600239,127.04538
성북구,1376, 한국과학기술연구원 중문,202005,245,253,498,37.600239,127.04538
성북구,1376, 한국과학기술연구원 중문,202006,250,260,510,37.600239,127.04538
성북구,1377, 한국과학기술연구원 북문,201905,69,47,116,37.603958,127.045341
성북구,1377, 한국과학기술연구원 북문,201906,287,231,518,37.603958,127.045341
성북구,1377, 한국과학기술연구원 북문,201907,390,314,704,37.603958,127.045341
성북구,1377, 한국과학기술연구원 북문,201908,367,334,701,37.603958,127.045341
성북구,1377, 한국과학기술연구원 북문,201909,376,318,694,37.603958,127.045341
성북구,1377, 한국과학기술연구원 북문,201910,383,373,756,37.603958,127.045341
성북구,1377, 한국과학기술연구원 북문,201911,251,250,501,37.603958,127.045341
성북구,1377, 한국과학기술연구원 북문,201912,137,129,266,37.603958,127.045341
성북구,1377, 한국과학기술연구원 북문,202001,119,94,213,37.603958,127.045341
성북구,1377, 한국과학기술연구원 북문,202002,110,91,201,37.603958,127.045341
성북구,1377, 한국과학기술연구원 북문,202003,207,179,386,37.603958,127.045341
성북구,1377, 한국과학기술연구원 북문,202004,196,166,362,37.603958,127.045341
성북구,1377, 한국과학기술연구원 북문,202005,207,176,383,37.603958,127.045341
성북구,1377, 한국과학기술연구원 북문,202006,261,214,475,37.603958,127.045341
성북구,1379,길음뉴타운푸르지오아파트 3단지,202004,0,1,1,37.60936,127.018173
성북구,1379,길음뉴타운푸르지오아파트 3단지,202006,32,20,52,37.60936,127.018173
성북구,1380,월곡역 5번출구 앞,202004,3,2,5,37.601086,127.041237
성북구,1380,월곡역 5번출구 앞,202006,464,493,957,37.601086,127.041237
성북구,1381,석계역 4번출구 뒤,202004,1,0,1,37.614784,127.067001
성북구,1381,석계역 4번출구 뒤,202006,402,395,797,37.614784,127.067001
성북구,1382,래미안월곡아파트 입구,202006,77,75,152,#N/A,#N/A
성북구,1383,성북동 주민센터 건너편,202004,4,4,8,#N/A,#N/A
성북구,1383,성북동 주민센터 건너편,202005,1,1,2,#N/A,#N/A
성북구,1383,성북동 주민센터 건너편,202006,249,213,462,#N/A,#N/A
성북구,1384,성신여대입구역 5번출구,202004,1,1,2,37.592827,127.016289
성북구,1384,성신여대입구역 5번출구,202006,723,726,1449,37.592827,127.016289
성북구,1385,성신여대입구역 3번출구 앞,202006,139,135,274,37.592365,127.016289
성북구,1386,동선고가차도 초입,202004,1,1,2,37.594158,127.018967
성북구,1386,동선고가차도 초입,202006,167,161,328,37.594158,127.018967
성북구,1388,커핀그루나루,202004,2,2,4,37.590881,127.011704
성북구,1388,커핀그루나루,202006,75,72,147,37.590881,127.011704
성북구,1390,석관래미안아트리치,202004,1,1,2,37.606461,127.061623
성북구,1390,석관래미안아트리치,202006,486,498,984,37.606461,127.061623
성북구,1391,성북청소년센터,202004,2,2,4,37.617073,127.056244
성북구,1391,성북청소년센터,202006,233,215,448,37.617073,127.056244
성북구,1392,돈암삼성풍림아파트,202004,1,1,2,37.597099,127.022629
성북구,1392,돈암삼성풍림아파트,202006,15,11,26,37.597099,127.022629
성북구,1393,돈암육교 하단,202004,1,1,2,37.597778,127.021507
성북구,1393,돈암육교 하단,202006,47,44,91,37.597778,127.021507
성북구,1394,길음뉴타운 래미안9단지,202004,36,36,72,37.602417,127.019714
성북구,1394,길음뉴타운 래미안9단지,202005,446,439,885,37.602417,127.019714
성북구,1394,길음뉴타운 래미안9단지,202006,818,828,1646,37.602417,127.019714
성북구,1395,래미안장위포레카운티(102동),202004,1,2,3,37.618179,127.051834
성북구,1395,래미안장위포레카운티(102동),202006,220,192,412,37.618179,127.051834
성북구,1396,래미안장위퍼스트하이(513동),202004,2,1,3,37.618443,127.051453
성북구,1396,래미안장위퍼스트하이(513동),202006,360,383,743,37.618443,127.051453
성북구,1397,래미안월곡아파트 (창문여고 건터편),202006,238,221,459,#N/A,#N/A
중랑구,1401, 극동늘푸른아파트,201901,419,464,883,37.614738,127.076363
중랑구,1401, 극동늘푸른아파트,201902,360,434,794,37.614738,127.076363
중랑구,1401, 극동늘푸른아파트,201903,678,781,1459,37.614738,127.076363
중랑구,1401, 극동늘푸른아파트,201904,981,1209,2190,37.614738,127.076363
중랑구,1401, 극동늘푸른아파트,201905,1632,1918,3550,37.614738,127.076363
중랑구,1401, 극동늘푸른아파트,201906,1828,2179,4007,37.614738,127.076363
중랑구,1401, 극동늘푸른아파트,201907,1817,2108,3925,37.614738,127.076363
중랑구,1401, 극동늘푸른아파트,201908,1685,1930,3615,37.614738,127.076363
중랑구,1401, 극동늘푸른아파트,201909,2038,2120,4158,37.614738,127.076363
중랑구,1401, 극동늘푸른아파트,201910,2173,2239,4412,37.614738,127.076363
중랑구,1401, 극동늘푸른아파트,201911,1321,1411,2732,37.614738,127.076363
중랑구,1401, 극동늘푸른아파트,201912,739,730,1469,37.614738,127.076363
중랑구,1401, 극동늘푸른아파트,202001,655,653,1308,37.614738,127.076363
중랑구,1401, 극동늘푸른아파트,202002,609,682,1291,37.614738,127.076363
중랑구,1401, 극동늘푸른아파트,202003,1397,1545,2942,37.614738,127.076363
중랑구,1401, 극동늘푸른아파트,202004,2151,2215,4366,37.614738,127.076363
중랑구,1401, 극동늘푸른아파트,202005,2854,3003,5857,37.614738,127.076363
중랑구,1401, 극동늘푸른아파트,202006,2784,2954,5738,37.614738,127.076363
중랑구,1402, 금란주차장 앞,201901,148,183,331,37.600071,127.102333
중랑구,1402, 금란주차장 앞,201902,128,144,272,37.600071,127.102333
중랑구,1402, 금란주차장 앞,201903,352,393,745,37.600071,127.102333
중랑구,1402, 금란주차장 앞,201904,506,535,1041,37.600071,127.102333
중랑구,1402, 금란주차장 앞,201905,744,991,1735,37.600071,127.102333
중랑구,1402, 금란주차장 앞,201906,969,1082,2051,37.600071,127.102333
중랑구,1402, 금란주차장 앞,201907,961,1033,1994,37.600071,127.102333
중랑구,1402, 금란주차장 앞,201908,1113,1167,2280,37.600071,127.102333
중랑구,1402, 금란주차장 앞,201909,1057,1107,2164,37.600071,127.102333
중랑구,1402, 금란주차장 앞,201910,1350,1427,2777,37.600071,127.102333
중랑구,1402, 금란주차장 앞,201911,860,907,1767,37.600071,127.102333
중랑구,1402, 금란주차장 앞,201912,498,502,1000,37.600071,127.102333
중랑구,1402, 금란주차장 앞,202001,443,415,858,37.600071,127.102333
중랑구,1402, 금란주차장 앞,202002,442,430,872,37.600071,127.102333
중랑구,1402, 금란주차장 앞,202003,723,763,1486,37.600071,127.102333
중랑구,1402, 금란주차장 앞,202004,1092,1139,2231,37.600071,127.102333
중랑구,1402, 금란주차장 앞,202005,1446,1524,2970,37.600071,127.102333
중랑구,1402, 금란주차장 앞,202006,1622,1715,3337,37.600071,127.102333
중랑구,1403, 중화빌딩 앞 (동부시장),201901,528,539,1067,37.59425,127.076576
중랑구,1403, 중화빌딩 앞 (동부시장),201902,504,527,1031,37.59425,127.076576
중랑구,1403, 중화빌딩 앞 (동부시장),201903,1026,1085,2111,37.59425,127.076576
중랑구,1403, 중화빌딩 앞 (동부시장),201904,1697,1783,3480,37.59425,127.076576
중랑구,1403, 중화빌딩 앞 (동부시장),201905,2893,3014,5907,37.59425,127.076576
중랑구,1403, 중화빌딩 앞 (동부시장),201906,3170,3310,6480,37.59425,127.076576
중랑구,1403, 중화빌딩 앞 (동부시장),201907,2967,3097,6064,37.59425,127.076576
중랑구,1403, 중화빌딩 앞 (동부시장),201908,2833,2916,5749,37.59425,127.076576
중랑구,1403, 중화빌딩 앞 (동부시장),201909,2793,2847,5640,37.59425,127.076576
중랑구,1403, 중화빌딩 앞 (동부시장),201910,3302,3342,6644,37.59425,127.076576
중랑구,1403, 중화빌딩 앞 (동부시장),201911,2217,2296,4513,37.59425,127.076576
중랑구,1403, 중화빌딩 앞 (동부시장),201912,1308,1321,2629,37.59425,127.076576
중랑구,1403, 중화빌딩 앞 (동부시장),202001,1097,1150,2247,37.59425,127.076576
중랑구,1403, 중화빌딩 앞 (동부시장),202002,1000,1105,2105,37.59425,127.076576
중랑구,1403, 중화빌딩 앞 (동부시장),202003,1952,2026,3978,37.59425,127.076576
중랑구,1403, 중화빌딩 앞 (동부시장),202004,3426,3715,7141,37.59425,127.076576
중랑구,1403, 중화빌딩 앞 (동부시장),202005,4007,4012,8019,37.59425,127.076576
중랑구,1403, 중화빌딩 앞 (동부시장),202006,3904,3948,7852,37.59425,127.076576
중랑구,1404, 동일로 지하차도,201901,342,333,675,37.595299,127.080032
중랑구,1404, 동일로 지하차도,201902,297,276,573,37.595299,127.080032
중랑구,1404, 동일로 지하차도,201903,649,630,1279,37.595299,127.080032
중랑구,1404, 동일로 지하차도,201904,925,935,1860,37.595299,127.080032
중랑구,1404, 동일로 지하차도,201905,1587,1509,3096,37.595299,127.080032
중랑구,1404, 동일로 지하차도,201906,1501,1499,3000,37.595299,127.080032
중랑구,1404, 동일로 지하차도,201907,1490,1490,2980,37.595299,127.080032
중랑구,1404, 동일로 지하차도,201908,1389,1378,2767,37.595299,127.080032
중랑구,1404, 동일로 지하차도,201909,1357,1355,2712,37.595299,127.080032
중랑구,1404, 동일로 지하차도,201910,1520,1509,3029,37.595299,127.080032
중랑구,1404, 동일로 지하차도,201911,987,981,1968,37.595299,127.080032
중랑구,1404, 동일로 지하차도,201912,593,584,1177,37.595299,127.080032
중랑구,1404, 동일로 지하차도,202001,505,506,1011,37.595299,127.080032
중랑구,1404, 동일로 지하차도,202002,544,529,1073,37.595299,127.080032
중랑구,1404, 동일로 지하차도,202003,792,792,1584,37.595299,127.080032
중랑구,1404, 동일로 지하차도,202004,1197,1183,2380,37.595299,127.080032
중랑구,1404, 동일로 지하차도,202005,1552,1569,3121,37.595299,127.080032
중랑구,1404, 동일로 지하차도,202006,1942,1977,3919,37.595299,127.080032
중랑구,1405, 망우역 1번출구,201901,378,366,744,37.599098,127.092949
중랑구,1405, 망우역 1번출구,201902,312,335,647,37.599098,127.092949
중랑구,1405, 망우역 1번출구,201903,584,632,1216,37.599098,127.092949
중랑구,1405, 망우역 1번출구,201904,956,991,1947,37.599098,127.092949
중랑구,1405, 망우역 1번출구,201905,1523,1560,3083,37.599098,127.092949
중랑구,1405, 망우역 1번출구,201906,1689,1728,3417,37.599098,127.092949
중랑구,1405, 망우역 1번출구,201907,1503,1524,3027,37.599098,127.092949
중랑구,1405, 망우역 1번출구,201908,1458,1517,2975,37.599098,127.092949
중랑구,1405, 망우역 1번출구,201909,1566,1597,3163,37.599098,127.092949
중랑구,1405, 망우역 1번출구,201910,1830,1840,3670,37.599098,127.092949
중랑구,1405, 망우역 1번출구,201911,1191,1249,2440,37.599098,127.092949
중랑구,1405, 망우역 1번출구,201912,704,709,1413,37.599098,127.092949
중랑구,1405, 망우역 1번출구,202001,624,668,1292,37.599098,127.092949
중랑구,1405, 망우역 1번출구,202002,565,555,1120,37.599098,127.092949
중랑구,1405, 망우역 1번출구,202003,987,991,1978,37.599098,127.092949
중랑구,1405, 망우역 1번출구,202004,1686,1678,3364,37.599098,127.092949
중랑구,1405, 망우역 1번출구,202005,2019,2041,4060,37.599098,127.092949
중랑구,1405, 망우역 1번출구,202006,1935,1953,3888,37.599098,127.092949
중랑구,1406, 망우청소년수련관,201901,35,20,55,37.606251,127.108269
중랑구,1406, 망우청소년수련관,201902,19,18,37,37.606251,127.108269
중랑구,1406, 망우청소년수련관,201903,64,52,116,37.606251,127.108269
중랑구,1406, 망우청소년수련관,201904,98,72,170,37.606251,127.108269
중랑구,1406, 망우청소년수련관,201905,171,134,305,37.606251,127.108269
중랑구,1406, 망우청소년수련관,201906,226,184,410,37.606251,127.108269
중랑구,1406, 망우청소년수련관,201907,229,180,409,37.606251,127.108269
중랑구,1406, 망우청소년수련관,201908,266,230,496,37.606251,127.108269
중랑구,1406, 망우청소년수련관,201909,259,218,477,37.606251,127.108269
중랑구,1406, 망우청소년수련관,201910,229,207,436,37.606251,127.108269
중랑구,1406, 망우청소년수련관,201911,157,106,263,37.606251,127.108269
중랑구,1406, 망우청소년수련관,201912,103,96,199,37.606251,127.108269
중랑구,1406, 망우청소년수련관,202001,81,61,142,37.606251,127.108269
중랑구,1406, 망우청소년수련관,202002,61,43,104,37.606251,127.108269
중랑구,1406, 망우청소년수련관,202003,89,57,146,37.606251,127.108269
중랑구,1406, 망우청소년수련관,202004,135,136,271,37.606251,127.108269
중랑구,1406, 망우청소년수련관,202005,136,127,263,37.606251,127.108269
중랑구,1406, 망우청소년수련관,202006,165,120,285,37.606251,127.108269
중랑구,1407, 먹골역 1번출구 뒤,201901,254,289,543,37.611511,127.077888
중랑구,1407, 먹골역 1번출구 뒤,201902,216,270,486,37.611511,127.077888
중랑구,1407, 먹골역 1번출구 뒤,201903,430,453,883,37.611511,127.077888
중랑구,1407, 먹골역 1번출구 뒤,201904,668,801,1469,37.611511,127.077888
중랑구,1407, 먹골역 1번출구 뒤,201905,1117,1394,2511,37.611511,127.077888
중랑구,1407, 먹골역 1번출구 뒤,201906,1169,1495,2664,37.611511,127.077888
중랑구,1407, 먹골역 1번출구 뒤,201907,1052,1365,2417,37.611511,127.077888
중랑구,1407, 먹골역 1번출구 뒤,201908,1048,1272,2320,37.611511,127.077888
중랑구,1407, 먹골역 1번출구 뒤,201909,1143,1299,2442,37.611511,127.077888
중랑구,1407, 먹골역 1번출구 뒤,201910,1236,1491,2727,37.611511,127.077888
중랑구,1407, 먹골역 1번출구 뒤,201911,928,1081,2009,37.611511,127.077888
중랑구,1407, 먹골역 1번출구 뒤,201912,413,502,915,37.611511,127.077888
중랑구,1407, 먹골역 1번출구 뒤,202001,456,529,985,37.611511,127.077888
중랑구,1407, 먹골역 1번출구 뒤,202002,450,549,999,37.611511,127.077888
중랑구,1407, 먹골역 1번출구 뒤,202003,842,844,1686,37.611511,127.077888
중랑구,1407, 먹골역 1번출구 뒤,202004,1397,1432,2829,37.611511,127.077888
중랑구,1407, 먹골역 1번출구 뒤,202005,1632,1661,3293,37.611511,127.077888
중랑구,1407, 먹골역 1번출구 뒤,202006,1814,2046,3860,37.611511,127.077888
중랑구,1408, 먹골역 6번출구 앞,201901,325,402,727,37.610722,127.077477
중랑구,1408, 먹골역 6번출구 앞,201902,324,367,691,37.610722,127.077477
중랑구,1408, 먹골역 6번출구 앞,201903,548,661,1209,37.610722,127.077477
중랑구,1408, 먹골역 6번출구 앞,201904,862,1090,1952,37.610722,127.077477
중랑구,1408, 먹골역 6번출구 앞,201905,1566,1898,3464,37.610722,127.077477
중랑구,1408, 먹골역 6번출구 앞,201906,1527,1996,3523,37.610722,127.077477
중랑구,1408, 먹골역 6번출구 앞,201907,1476,1865,3341,37.610722,127.077477
중랑구,1408, 먹골역 6번출구 앞,201908,1339,1681,3020,37.610722,127.077477
중랑구,1408, 먹골역 6번출구 앞,201909,1481,1693,3174,37.610722,127.077477
중랑구,1408, 먹골역 6번출구 앞,201910,1693,1903,3596,37.610722,127.077477
중랑구,1408, 먹골역 6번출구 앞,201911,821,914,1735,37.610722,127.077477
중랑구,1408, 먹골역 6번출구 앞,201912,566,667,1233,37.610722,127.077477
중랑구,1408, 먹골역 6번출구 앞,202001,499,581,1080,37.610722,127.077477
중랑구,1408, 먹골역 6번출구 앞,202002,525,591,1116,37.610722,127.077477
중랑구,1408, 먹골역 6번출구 앞,202003,1180,1252,2432,37.610722,127.077477
중랑구,1408, 먹골역 6번출구 앞,202004,1729,1898,3627,37.610722,127.077477
중랑구,1408, 먹골역 6번출구 앞,202005,2096,2235,4331,37.610722,127.077477
중랑구,1408, 먹골역 6번출구 앞,202006,1791,2074,3865,37.610722,127.077477
중랑구,1410, 면목 대원칸타빌아파트,201901,112,26,138,37.577782,127.090187
중랑구,1410, 면목 대원칸타빌아파트,201902,84,18,102,37.577782,127.090187
중랑구,1410, 면목 대원칸타빌아파트,201903,147,35,182,37.577782,127.090187
중랑구,1410, 면목 대원칸타빌아파트,201904,209,56,265,37.577782,127.090187
중랑구,1410, 면목 대원칸타빌아파트,201905,324,84,408,37.577782,127.090187
중랑구,1410, 면목 대원칸타빌아파트,201906,374,137,511,37.577782,127.090187
중랑구,1410, 면목 대원칸타빌아파트,201907,233,102,335,37.577782,127.090187
중랑구,1410, 면목 대원칸타빌아파트,201908,250,97,347,37.577782,127.090187
중랑구,1410, 면목 대원칸타빌아파트,201909,184,77,261,37.577782,127.090187
중랑구,1410, 면목 대원칸타빌아파트,201910,231,93,324,37.577782,127.090187
중랑구,1410, 면목 대원칸타빌아파트,201911,231,57,288,37.577782,127.090187
중랑구,1410, 면목 대원칸타빌아파트,201912,144,40,184,37.577782,127.090187
중랑구,1410, 면목 대원칸타빌아파트,202001,152,43,195,37.577782,127.090187
중랑구,1410, 면목 대원칸타빌아파트,202002,143,22,165,37.577782,127.090187
중랑구,1410, 면목 대원칸타빌아파트,202003,228,67,295,37.577782,127.090187
중랑구,1410, 면목 대원칸타빌아파트,202004,293,116,409,37.577782,127.090187
중랑구,1410, 면목 대원칸타빌아파트,202005,311,121,432,37.577782,127.090187
중랑구,1410, 면목 대원칸타빌아파트,202006,430,145,575,37.577782,127.090187
중랑구,1411, 상봉시장앞 교차로 한성빌딩 앞,201901,181,210,391,37.592541,127.086739
중랑구,1411, 상봉시장앞 교차로 한성빌딩 앞,201902,142,177,319,37.592541,127.086739
중랑구,1411, 상봉시장앞 교차로 한성빌딩 앞,201903,245,313,558,37.592541,127.086739
중랑구,1411, 상봉시장앞 교차로 한성빌딩 앞,201904,369,474,843,37.592541,127.086739
중랑구,1411, 상봉시장앞 교차로 한성빌딩 앞,201905,734,796,1530,37.592541,127.086739
중랑구,1411, 상봉시장앞 교차로 한성빌딩 앞,201906,832,881,1713,37.592541,127.086739
중랑구,1411, 상봉시장앞 교차로 한성빌딩 앞,201907,812,905,1717,37.592541,127.086739
중랑구,1411, 상봉시장앞 교차로 한성빌딩 앞,201908,766,764,1530,37.592541,127.086739
중랑구,1411, 상봉시장앞 교차로 한성빌딩 앞,201909,831,839,1670,37.592541,127.086739
중랑구,1411, 상봉시장앞 교차로 한성빌딩 앞,201910,1018,1032,2050,37.592541,127.086739
중랑구,1411, 상봉시장앞 교차로 한성빌딩 앞,201911,700,715,1415,37.592541,127.086739
중랑구,1411, 상봉시장앞 교차로 한성빌딩 앞,201912,421,385,806,37.592541,127.086739
중랑구,1411, 상봉시장앞 교차로 한성빌딩 앞,202001,317,293,610,37.592541,127.086739
중랑구,1411, 상봉시장앞 교차로 한성빌딩 앞,202002,273,279,552,37.592541,127.086739
중랑구,1411, 상봉시장앞 교차로 한성빌딩 앞,202003,543,553,1096,37.592541,127.086739
중랑구,1411, 상봉시장앞 교차로 한성빌딩 앞,202004,832,833,1665,37.592541,127.086739
중랑구,1411, 상봉시장앞 교차로 한성빌딩 앞,202005,961,959,1920,37.592541,127.086739
중랑구,1411, 상봉시장앞 교차로 한성빌딩 앞,202006,1139,1137,2276,37.592541,127.086739
중랑구,1412, 면목초등학교,201901,119,159,278,37.590961,127.087067
중랑구,1412, 면목초등학교,201902,109,134,243,37.590961,127.087067
중랑구,1412, 면목초등학교,201903,211,264,475,37.590961,127.087067
중랑구,1412, 면목초등학교,201904,303,337,640,37.590961,127.087067
중랑구,1412, 면목초등학교,201905,486,553,1039,37.590961,127.087067
중랑구,1412, 면목초등학교,201906,575,618,1193,37.590961,127.087067
중랑구,1412, 면목초등학교,201907,481,530,1011,37.590961,127.087067
중랑구,1412, 면목초등학교,201908,546,551,1097,37.590961,127.087067
중랑구,1412, 면목초등학교,201909,570,601,1171,37.590961,127.087067
중랑구,1412, 면목초등학교,201910,662,662,1324,37.590961,127.087067
중랑구,1412, 면목초등학교,201911,398,429,827,37.590961,127.087067
중랑구,1412, 면목초등학교,201912,245,257,502,37.590961,127.087067
중랑구,1412, 면목초등학교,202001,244,258,502,37.590961,127.087067
중랑구,1412, 면목초등학교,202002,235,237,472,37.590961,127.087067
중랑구,1412, 면목초등학교,202003,361,365,726,37.590961,127.087067
중랑구,1412, 면목초등학교,202004,616,627,1243,37.590961,127.087067
중랑구,1412, 면목초등학교,202005,801,808,1609,37.590961,127.087067
중랑구,1412, 면목초등학교,202006,793,812,1605,37.590961,127.087067
중랑구,1413, 봉화산역 5번출구 뒤,201901,178,237,415,37.617561,127.090309
중랑구,1413, 봉화산역 5번출구 뒤,201902,199,208,407,37.617561,127.090309
중랑구,1413, 봉화산역 5번출구 뒤,201903,422,509,931,37.617561,127.090309
중랑구,1413, 봉화산역 5번출구 뒤,201904,605,754,1359,37.617561,127.090309
중랑구,1413, 봉화산역 5번출구 뒤,201905,1025,1306,2331,37.617561,127.090309
중랑구,1413, 봉화산역 5번출구 뒤,201906,1178,1422,2600,37.617561,127.090309
중랑구,1413, 봉화산역 5번출구 뒤,201907,1111,1277,2388,37.617561,127.090309
중랑구,1413, 봉화산역 5번출구 뒤,201908,1127,1426,2553,37.617561,127.090309
중랑구,1413, 봉화산역 5번출구 뒤,201909,1064,1212,2276,37.617561,127.090309
중랑구,1413, 봉화산역 5번출구 뒤,201910,1138,1353,2491,37.617561,127.090309
중랑구,1413, 봉화산역 5번출구 뒤,201911,654,781,1435,37.617561,127.090309
중랑구,1413, 봉화산역 5번출구 뒤,201912,359,413,772,37.617561,127.090309
중랑구,1413, 봉화산역 5번출구 뒤,202001,303,379,682,37.617561,127.090309
중랑구,1413, 봉화산역 5번출구 뒤,202002,279,383,662,37.617561,127.090309
중랑구,1413, 봉화산역 5번출구 뒤,202003,690,710,1400,37.617561,127.090309
중랑구,1413, 봉화산역 5번출구 뒤,202004,1101,1107,2208,37.617561,127.090309
중랑구,1413, 봉화산역 5번출구 뒤,202005,1316,1345,2661,37.617561,127.090309
중랑구,1413, 봉화산역 5번출구 뒤,202006,1359,1511,2870,37.617561,127.090309
중랑구,1414, 사가정역 1번출구,201901,330,388,718,37.581646,127.088432
중랑구,1414, 사가정역 1번출구,201902,396,476,872,37.581646,127.088432
중랑구,1414, 사가정역 1번출구,201903,728,854,1582,37.581646,127.088432
중랑구,1414, 사가정역 1번출구,201904,1094,1428,2522,37.581646,127.088432
중랑구,1414, 사가정역 1번출구,201905,2024,2294,4318,37.581646,127.088432
중랑구,1414, 사가정역 1번출구,201906,2337,2595,4932,37.581646,127.088432
중랑구,1414, 사가정역 1번출구,201907,2147,2284,4431,37.581646,127.088432
중랑구,1414, 사가정역 1번출구,201908,2051,2227,4278,37.581646,127.088432
중랑구,1414, 사가정역 1번출구,201909,2297,2397,4694,37.581646,127.088432
중랑구,1414, 사가정역 1번출구,201910,2658,2816,5474,37.581646,127.088432
중랑구,1414, 사가정역 1번출구,201911,1473,1726,3199,37.581646,127.088432
중랑구,1414, 사가정역 1번출구,201912,866,1036,1902,37.581646,127.088432
중랑구,1414, 사가정역 1번출구,202001,760,877,1637,37.581646,127.088432
중랑구,1414, 사가정역 1번출구,202002,728,870,1598,37.581646,127.088432
중랑구,1414, 사가정역 1번출구,202003,1501,1828,3329,37.581646,127.088432
중랑구,1414, 사가정역 1번출구,202004,2427,2634,5061,37.581646,127.088432
중랑구,1414, 사가정역 1번출구,202005,3193,3292,6485,37.581646,127.088432
중랑구,1414, 사가정역 1번출구,202006,3181,3471,6652,37.581646,127.088432
중랑구,1416, 상봉역 3번출구,201901,222,214,436,37.595219,127.085999
중랑구,1416, 상봉역 3번출구,201902,220,186,406,37.595219,127.085999
중랑구,1416, 상봉역 3번출구,201903,352,395,747,37.595219,127.085999
중랑구,1416, 상봉역 3번출구,201904,483,530,1013,37.595219,127.085999
중랑구,1416, 상봉역 3번출구,201905,981,1009,1990,37.595219,127.085999
중랑구,1416, 상봉역 3번출구,201906,1047,1054,2101,37.595219,127.085999
중랑구,1416, 상봉역 3번출구,201907,998,948,1946,37.595219,127.085999
중랑구,1416, 상봉역 3번출구,201908,1003,964,1967,37.595219,127.085999
중랑구,1416, 상봉역 3번출구,201909,945,928,1873,37.595219,127.085999
중랑구,1416, 상봉역 3번출구,201910,1057,1072,2129,37.595219,127.085999
중랑구,1416, 상봉역 3번출구,201911,747,734,1481,37.595219,127.085999
중랑구,1416, 상봉역 3번출구,201912,447,454,901,37.595219,127.085999
중랑구,1416, 상봉역 3번출구,202001,371,395,766,37.595219,127.085999
중랑구,1416, 상봉역 3번출구,202002,398,371,769,37.595219,127.085999
중랑구,1416, 상봉역 3번출구,202003,680,684,1364,37.595219,127.085999
중랑구,1416, 상봉역 3번출구,202004,981,980,1961,37.595219,127.085999
중랑구,1416, 상봉역 3번출구,202005,1255,1250,2505,37.595219,127.085999
중랑구,1416, 상봉역 3번출구,202006,1395,1406,2801,37.595219,127.085999
중랑구,1418, 새솔초등학교,201901,149,78,227,37.617989,127.110542
중랑구,1418, 새솔초등학교,201902,108,78,186,37.617989,127.110542
중랑구,1418, 새솔초등학교,201903,229,114,343,37.617989,127.110542
중랑구,1418, 새솔초등학교,201904,347,178,525,37.617989,127.110542
중랑구,1418, 새솔초등학교,201905,484,308,792,37.617989,127.110542
중랑구,1418, 새솔초등학교,201906,534,316,850,37.617989,127.110542
중랑구,1418, 새솔초등학교,201907,544,328,872,37.617989,127.110542
중랑구,1418, 새솔초등학교,201908,462,321,783,37.617989,127.110542
중랑구,1418, 새솔초등학교,201909,554,300,854,37.617989,127.110542
중랑구,1418, 새솔초등학교,201910,699,357,1056,37.617989,127.110542
중랑구,1418, 새솔초등학교,201911,437,199,636,37.617989,127.110542
중랑구,1418, 새솔초등학교,201912,226,115,341,37.617989,127.110542
중랑구,1418, 새솔초등학교,202001,216,97,313,37.617989,127.110542
중랑구,1418, 새솔초등학교,202002,217,96,313,37.617989,127.110542
중랑구,1418, 새솔초등학교,202003,389,219,608,37.617989,127.110542
중랑구,1418, 새솔초등학교,202004,545,414,959,37.617989,127.110542
중랑구,1418, 새솔초등학교,202005,729,576,1305,37.617989,127.110542
중랑구,1418, 새솔초등학교,202006,620,416,1036,37.617989,127.110542
중랑구,1420, 신내어울공원 앞,201901,161,196,357,37.614231,127.096764
중랑구,1420, 신내어울공원 앞,201902,144,180,324,37.614231,127.096764
중랑구,1420, 신내어울공원 앞,201903,273,289,562,37.614231,127.096764
중랑구,1420, 신내어울공원 앞,201904,425,397,822,37.614231,127.096764
중랑구,1420, 신내어울공원 앞,201905,745,702,1447,37.614231,127.096764
중랑구,1420, 신내어울공원 앞,201906,688,838,1526,37.614231,127.096764
중랑구,1420, 신내어울공원 앞,201907,643,723,1366,37.614231,127.096764
중랑구,1420, 신내어울공원 앞,201908,614,671,1285,37.614231,127.096764
중랑구,1420, 신내어울공원 앞,201909,638,650,1288,37.614231,127.096764
중랑구,1420, 신내어울공원 앞,201910,696,710,1406,37.614231,127.096764
중랑구,1420, 신내어울공원 앞,201911,467,493,960,37.614231,127.096764
중랑구,1420, 신내어울공원 앞,201912,260,277,537,37.614231,127.096764
중랑구,1420, 신내어울공원 앞,202001,249,273,522,37.614231,127.096764
중랑구,1420, 신내어울공원 앞,202002,222,254,476,37.614231,127.096764
중랑구,1420, 신내어울공원 앞,202003,518,523,1041,37.614231,127.096764
중랑구,1420, 신내어울공원 앞,202004,900,875,1775,37.614231,127.096764
중랑구,1420, 신내어울공원 앞,202005,1043,1038,2081,37.614231,127.096764
중랑구,1420, 신내어울공원 앞,202006,929,961,1890,37.614231,127.096764
중랑구,1421, 신내역 4번출구,201901,135,115,250,37.612461,127.103378
중랑구,1421, 신내역 4번출구,201902,122,87,209,37.612461,127.103378
중랑구,1421, 신내역 4번출구,201903,165,168,333,37.612461,127.103378
중랑구,1421, 신내역 4번출구,201904,241,241,482,37.612461,127.103378
중랑구,1421, 신내역 4번출구,201905,319,312,631,37.612461,127.103378
중랑구,1421, 신내역 4번출구,201906,343,322,665,37.612461,127.103378
중랑구,1421, 신내역 4번출구,201907,361,341,702,37.612461,127.103378
중랑구,1421, 신내역 4번출구,201908,369,358,727,37.612461,127.103378
중랑구,1421, 신내역 4번출구,201909,391,319,710,37.612461,127.103378
중랑구,1421, 신내역 4번출구,201910,423,379,802,37.612461,127.103378
중랑구,1421, 신내역 4번출구,201911,340,272,612,37.612461,127.103378
중랑구,1421, 신내역 4번출구,201912,216,221,437,37.612461,127.103378
중랑구,1421, 신내역 4번출구,202001,148,128,276,37.612461,127.103378
중랑구,1421, 신내역 4번출구,202002,115,133,248,37.612461,127.103378
중랑구,1421, 신내역 4번출구,202003,225,206,431,37.612461,127.103378
중랑구,1421, 신내역 4번출구,202004,339,271,610,37.612461,127.103378
중랑구,1421, 신내역 4번출구,202005,378,307,685,37.612461,127.103378
중랑구,1421, 신내역 4번출구,202006,317,290,607,37.612461,127.103378
중랑구,1422, 신내우디안아파트 1단지,201901,81,20,101,37.620098,127.106461
중랑구,1422, 신내우디안아파트 1단지,201902,69,25,94,37.620098,127.106461
중랑구,1422, 신내우디안아파트 1단지,201903,123,61,184,37.620098,127.106461
중랑구,1422, 신내우디안아파트 1단지,201904,194,111,305,37.620098,127.106461
중랑구,1422, 신내우디안아파트 1단지,201905,280,123,403,37.620098,127.106461
중랑구,1422, 신내우디안아파트 1단지,201906,317,113,430,37.620098,127.106461
중랑구,1422, 신내우디안아파트 1단지,201907,295,87,382,37.620098,127.106461
중랑구,1422, 신내우디안아파트 1단지,201908,273,92,365,37.620098,127.106461
중랑구,1422, 신내우디안아파트 1단지,201909,311,125,436,37.620098,127.106461
중랑구,1422, 신내우디안아파트 1단지,201910,373,142,515,37.620098,127.106461
중랑구,1422, 신내우디안아파트 1단지,201911,298,100,398,37.620098,127.106461
중랑구,1422, 신내우디안아파트 1단지,201912,194,41,235,37.620098,127.106461
중랑구,1422, 신내우디안아파트 1단지,202001,144,25,169,37.620098,127.106461
중랑구,1422, 신내우디안아파트 1단지,202002,129,40,169,37.620098,127.106461
중랑구,1422, 신내우디안아파트 1단지,202003,200,125,325,37.620098,127.106461
중랑구,1422, 신내우디안아파트 1단지,202004,254,178,432,37.620098,127.106461
중랑구,1422, 신내우디안아파트 1단지,202005,327,229,556,37.620098,127.106461
중랑구,1422, 신내우디안아파트 1단지,202006,240,141,381,37.620098,127.106461
중랑구,1424, 양원역 2번출구,201901,25,16,41,37.606312,127.107742
중랑구,1424, 양원역 2번출구,201902,29,17,46,37.606312,127.107742
중랑구,1424, 양원역 2번출구,201903,56,69,125,37.606312,127.107742
중랑구,1424, 양원역 2번출구,201904,119,79,198,37.606312,127.107742
중랑구,1424, 양원역 2번출구,201905,182,129,311,37.606312,127.107742
중랑구,1424, 양원역 2번출구,201906,259,234,493,37.606312,127.107742
중랑구,1424, 양원역 2번출구,201907,201,159,360,37.606312,127.107742
중랑구,1424, 양원역 2번출구,201908,176,117,293,37.606312,127.107742
중랑구,1424, 양원역 2번출구,201909,161,127,288,37.606312,127.107742
중랑구,1424, 양원역 2번출구,201910,296,266,562,37.606312,127.107742
중랑구,1424, 양원역 2번출구,201911,187,169,356,37.606312,127.107742
중랑구,1424, 양원역 2번출구,201912,103,99,202,37.606312,127.107742
중랑구,1424, 양원역 2번출구,202001,67,49,116,37.606312,127.107742
중랑구,1424, 양원역 2번출구,202002,73,49,122,37.606312,127.107742
중랑구,1424, 양원역 2번출구,202003,102,83,185,37.606312,127.107742
중랑구,1424, 양원역 2번출구,202004,174,166,340,37.606312,127.107742
중랑구,1424, 양원역 2번출구,202005,176,180,356,37.606312,127.107742
중랑구,1424, 양원역 2번출구,202006,181,156,337,37.606312,127.107742
중랑구,1425, 용마문화복지센터,201901,126,77,203,37.58746,127.09597
중랑구,1425, 용마문화복지센터,201902,117,90,207,37.58746,127.09597
중랑구,1425, 용마문화복지센터,201903,287,201,488,37.58746,127.09597
중랑구,1425, 용마문화복지센터,201904,9,39,48,37.58746,127.09597
중랑구,1425, 용마문화복지센터,201905,678,600,1278,37.58746,127.09597
중랑구,1425, 용마문화복지센터,201906,725,703,1428,37.58746,127.09597
중랑구,1425, 용마문화복지센터,201907,634,595,1229,37.58746,127.09597
중랑구,1425, 용마문화복지센터,201908,575,526,1101,37.58746,127.09597
중랑구,1425, 용마문화복지센터,201909,764,755,1519,37.58746,127.09597
중랑구,1425, 용마문화복지센터,201910,806,790,1596,37.58746,127.09597
중랑구,1425, 용마문화복지센터,201911,483,456,939,37.58746,127.09597
중랑구,1425, 용마문화복지센터,201912,244,237,481,37.58746,127.09597
중랑구,1425, 용마문화복지센터,202001,242,198,440,37.58746,127.09597
중랑구,1425, 용마문화복지센터,202002,197,198,395,37.58746,127.09597
중랑구,1425, 용마문화복지센터,202003,391,334,725,37.58746,127.09597
중랑구,1425, 용마문화복지센터,202004,513,480,993,37.58746,127.09597
중랑구,1425, 용마문화복지센터,202005,654,643,1297,37.58746,127.09597
중랑구,1425, 용마문화복지센터,202006,833,796,1629,37.58746,127.09597
중랑구,1426, 면목도시개발아파트 1동 앞,201901,128,47,175,37.573589,127.086823
중랑구,1426, 면목도시개발아파트 1동 앞,201902,152,42,194,37.573589,127.086823
중랑구,1426, 면목도시개발아파트 1동 앞,201903,222,78,300,37.573589,127.086823
중랑구,1426, 면목도시개발아파트 1동 앞,201904,281,91,372,37.573589,127.086823
중랑구,1426, 면목도시개발아파트 1동 앞,201905,421,198,619,37.573589,127.086823
중랑구,1426, 면목도시개발아파트 1동 앞,201906,433,180,613,37.573589,127.086823
중랑구,1426, 면목도시개발아파트 1동 앞,201907,455,198,653,37.573589,127.086823
중랑구,1426, 면목도시개발아파트 1동 앞,201908,414,175,589,37.573589,127.086823
중랑구,1426, 면목도시개발아파트 1동 앞,201909,319,149,468,37.573589,127.086823
중랑구,1426, 면목도시개발아파트 1동 앞,201910,371,184,555,37.573589,127.086823
중랑구,1426, 면목도시개발아파트 1동 앞,201911,239,86,325,37.573589,127.086823
중랑구,1426, 면목도시개발아파트 1동 앞,201912,169,47,216,37.573589,127.086823
중랑구,1426, 면목도시개발아파트 1동 앞,202001,139,61,200,37.573589,127.086823
중랑구,1426, 면목도시개발아파트 1동 앞,202002,254,93,347,37.573589,127.086823
중랑구,1426, 면목도시개발아파트 1동 앞,202003,305,104,409,37.573589,127.086823
중랑구,1426, 면목도시개발아파트 1동 앞,202004,202,165,367,37.573589,127.086823
중랑구,1426, 면목도시개발아파트 1동 앞,202005,279,243,522,37.573589,127.086823
중랑구,1426, 면목도시개발아파트 1동 앞,202006,481,181,662,37.573589,127.086823
중랑구,1427, 용마산역 1번출구,201901,218,31,249,37.574299,127.086914
중랑구,1427, 용마산역 1번출구,201902,178,49,227,37.574299,127.086914
중랑구,1427, 용마산역 1번출구,201903,283,92,375,37.574299,127.086914
중랑구,1427, 용마산역 1번출구,201904,388,136,524,37.574299,127.086914
중랑구,1427, 용마산역 1번출구,201905,520,253,773,37.574299,127.086914
중랑구,1427, 용마산역 1번출구,201906,510,285,795,37.574299,127.086914
중랑구,1427, 용마산역 1번출구,201907,390,239,629,37.574299,127.086914
중랑구,1427, 용마산역 1번출구,201908,347,189,536,37.574299,127.086914
중랑구,1427, 용마산역 1번출구,201909,268,205,473,37.574299,127.086914
중랑구,1427, 용마산역 1번출구,201910,346,259,605,37.574299,127.086914
중랑구,1427, 용마산역 1번출구,201911,246,164,410,37.574299,127.086914
중랑구,1427, 용마산역 1번출구,201912,176,109,285,37.574299,127.086914
중랑구,1427, 용마산역 1번출구,202001,169,88,257,37.574299,127.086914
중랑구,1427, 용마산역 1번출구,202002,92,103,195,37.574299,127.086914
중랑구,1427, 용마산역 1번출구,202003,235,163,398,37.574299,127.086914
중랑구,1427, 용마산역 1번출구,202004,349,322,671,37.574299,127.086914
중랑구,1427, 용마산역 1번출구,202005,339,317,656,37.574299,127.086914
중랑구,1427, 용마산역 1번출구,202006,372,312,684,37.574299,127.086914
중랑구,1428, 원묵고등학교,201901,341,189,530,37.616024,127.085968
중랑구,1428, 원묵고등학교,201902,286,160,446,37.616024,127.085968
중랑구,1428, 원묵고등학교,201903,604,406,1010,37.616024,127.085968
중랑구,1428, 원묵고등학교,201904,809,609,1418,37.616024,127.085968
중랑구,1428, 원묵고등학교,201905,967,700,1667,37.616024,127.085968
중랑구,1428, 원묵고등학교,201906,1197,871,2068,37.616024,127.085968
중랑구,1428, 원묵고등학교,201907,1153,847,2000,37.616024,127.085968
중랑구,1428, 원묵고등학교,201908,1195,814,2009,37.616024,127.085968
중랑구,1428, 원묵고등학교,201909,922,652,1574,37.616024,127.085968
중랑구,1428, 원묵고등학교,201910,1210,819,2029,37.616024,127.085968
중랑구,1428, 원묵고등학교,201911,693,522,1215,37.616024,127.085968
중랑구,1428, 원묵고등학교,201912,317,208,525,37.616024,127.085968
중랑구,1428, 원묵고등학교,202001,268,162,430,37.616024,127.085968
중랑구,1428, 원묵고등학교,202002,251,164,415,37.616024,127.085968
중랑구,1428, 원묵고등학교,202003,429,282,711,37.616024,127.085968
중랑구,1428, 원묵고등학교,202004,494,396,890,37.616024,127.085968
중랑구,1428, 원묵고등학교,202005,602,483,1085,37.616024,127.085968
중랑구,1428, 원묵고등학교,202006,740,498,1238,37.616024,127.085968
중랑구,1429, 장안중학교,201901,215,257,472,37.599957,127.080002
중랑구,1429, 장안중학교,201902,197,211,408,37.599957,127.080002
중랑구,1429, 장안중학교,201903,387,437,824,37.599957,127.080002
중랑구,1429, 장안중학교,201904,529,595,1124,37.599957,127.080002
중랑구,1429, 장안중학교,201905,877,1081,1958,37.599957,127.080002
중랑구,1429, 장안중학교,201906,875,1043,1918,37.599957,127.080002
중랑구,1429, 장안중학교,201907,757,905,1662,37.599957,127.080002
중랑구,1429, 장안중학교,201908,832,967,1799,37.599957,127.080002
중랑구,1429, 장안중학교,201909,937,1052,1989,37.599957,127.080002
중랑구,1429, 장안중학교,201910,1141,1283,2424,37.599957,127.080002
중랑구,1429, 장안중학교,201911,674,745,1419,37.599957,127.080002
중랑구,1429, 장안중학교,201912,332,393,725,37.599957,127.080002
중랑구,1429, 장안중학교,202001,306,363,669,37.599957,127.080002
중랑구,1429, 장안중학교,202002,280,318,598,37.599957,127.080002
중랑구,1429, 장안중학교,202003,588,573,1161,37.599957,127.080002
중랑구,1429, 장안중학교,202004,813,850,1663,37.599957,127.080002
중랑구,1429, 장안중학교,202005,981,1027,2008,37.599957,127.080002
중랑구,1429, 장안중학교,202006,446,528,974,37.599957,127.080002
중랑구,1430, 중랑구청,201901,365,226,591,37.606152,127.092598
중랑구,1430, 중랑구청,201902,304,184,488,37.606152,127.092598
중랑구,1430, 중랑구청,201903,636,398,1034,37.606152,127.092598
중랑구,1430, 중랑구청,201904,548,379,927,37.606152,127.092598
중랑구,1430, 중랑구청,201905,1304,903,2207,37.606152,127.092598
중랑구,1430, 중랑구청,201906,1417,979,2396,37.606152,127.092598
중랑구,1430, 중랑구청,201907,1261,819,2080,37.606152,127.092598
중랑구,1430, 중랑구청,201908,1347,926,2273,37.606152,127.092598
중랑구,1430, 중랑구청,201909,1136,863,1999,37.606152,127.092598
중랑구,1430, 중랑구청,201910,1310,959,2269,37.606152,127.092598
중랑구,1430, 중랑구청,201911,836,509,1345,37.606152,127.092598
중랑구,1430, 중랑구청,201912,484,299,783,37.606152,127.092598
중랑구,1430, 중랑구청,202001,564,387,951,37.606152,127.092598
중랑구,1430, 중랑구청,202002,453,289,742,37.606152,127.092598
중랑구,1430, 중랑구청,202003,709,569,1278,37.606152,127.092598
중랑구,1430, 중랑구청,202004,1023,843,1866,37.606152,127.092598
중랑구,1430, 중랑구청,202005,1248,1026,2274,37.606152,127.092598
중랑구,1430, 중랑구청,202006,1399,1018,2417,37.606152,127.092598
중랑구,1431, 중랑구청 사거리,201901,361,334,695,37.606499,127.095451
중랑구,1431, 중랑구청 사거리,201902,323,320,643,37.606499,127.095451
중랑구,1431, 중랑구청 사거리,201903,636,652,1288,37.606499,127.095451
중랑구,1431, 중랑구청 사거리,201904,1096,1079,2175,37.606499,127.095451
중랑구,1431, 중랑구청 사거리,201905,1629,1663,3292,37.606499,127.095451
중랑구,1431, 중랑구청 사거리,201906,1721,1757,3478,37.606499,127.095451
중랑구,1431, 중랑구청 사거리,201907,1702,1730,3432,37.606499,127.095451
중랑구,1431, 중랑구청 사거리,201908,1691,1690,3381,37.606499,127.095451
중랑구,1431, 중랑구청 사거리,201909,1604,1597,3201,37.606499,127.095451
중랑구,1431, 중랑구청 사거리,201910,1884,1884,3768,37.606499,127.095451
중랑구,1431, 중랑구청 사거리,201911,1197,1198,2395,37.606499,127.095451
중랑구,1431, 중랑구청 사거리,201912,732,734,1466,37.606499,127.095451
중랑구,1431, 중랑구청 사거리,202001,685,671,1356,37.606499,127.095451
중랑구,1431, 중랑구청 사거리,202002,672,677,1349,37.606499,127.095451
중랑구,1431, 중랑구청 사거리,202003,1235,1142,2377,37.606499,127.095451
중랑구,1431, 중랑구청 사거리,202004,1739,1683,3422,37.606499,127.095451
중랑구,1431, 중랑구청 사거리,202005,2286,2296,4582,37.606499,127.095451
중랑구,1431, 중랑구청 사거리,202006,2393,2366,4759,37.606499,127.095451
중랑구,1433, 중화역 2번출구,201901,398,554,952,37.602077,127.079582
중랑구,1433, 중화역 2번출구,201902,409,502,911,37.602077,127.079582
중랑구,1433, 중화역 2번출구,201903,757,958,1715,37.602077,127.079582
중랑구,1433, 중화역 2번출구,201904,1104,1356,2460,37.602077,127.079582
중랑구,1433, 중화역 2번출구,201905,1822,2432,4254,37.602077,127.079582
중랑구,1433, 중화역 2번출구,201906,2104,2701,4805,37.602077,127.079582
중랑구,1433, 중화역 2번출구,201907,2044,2406,4450,37.602077,127.079582
중랑구,1433, 중화역 2번출구,201908,1951,2387,4338,37.602077,127.079582
중랑구,1433, 중화역 2번출구,201909,2186,2624,4810,37.602077,127.079582
중랑구,1433, 중화역 2번출구,201910,2476,2767,5243,37.602077,127.079582
중랑구,1433, 중화역 2번출구,201911,1459,1760,3219,37.602077,127.079582
중랑구,1433, 중화역 2번출구,201912,805,971,1776,37.602077,127.079582
중랑구,1433, 중화역 2번출구,202001,818,968,1786,37.602077,127.079582
중랑구,1433, 중화역 2번출구,202002,770,965,1735,37.602077,127.079582
중랑구,1433, 중화역 2번출구,202003,1487,1749,3236,37.602077,127.079582
중랑구,1433, 중화역 2번출구,202004,2478,2774,5252,37.602077,127.079582
중랑구,1433, 중화역 2번출구,202005,2880,3277,6157,37.602077,127.079582
중랑구,1433, 중화역 2번출구,202006,2898,3430,6328,37.602077,127.079582
중랑구,1434, 홈플러스 면목동점,201901,147,146,293,37.579868,127.082367
중랑구,1434, 홈플러스 면목동점,201902,155,160,315,37.579868,127.082367
중랑구,1434, 홈플러스 면목동점,201903,324,310,634,37.579868,127.082367
중랑구,1434, 홈플러스 면목동점,201904,520,546,1066,37.579868,127.082367
중랑구,1434, 홈플러스 면목동점,201905,708,860,1568,37.579868,127.082367
중랑구,1434, 홈플러스 면목동점,201906,940,1158,2098,37.579868,127.082367
중랑구,1434, 홈플러스 면목동점,201907,906,1072,1978,37.579868,127.082367
중랑구,1434, 홈플러스 면목동점,201908,893,1004,1897,37.579868,127.082367
중랑구,1434, 홈플러스 면목동점,201909,962,988,1950,37.579868,127.082367
중랑구,1434, 홈플러스 면목동점,201910,1033,1124,2157,37.579868,127.082367
중랑구,1434, 홈플러스 면목동점,201911,563,605,1168,37.579868,127.082367
중랑구,1434, 홈플러스 면목동점,201912,376,370,746,37.579868,127.082367
중랑구,1434, 홈플러스 면목동점,202001,335,300,635,37.579868,127.082367
중랑구,1434, 홈플러스 면목동점,202002,385,329,714,37.579868,127.082367
중랑구,1434, 홈플러스 면목동점,202003,716,750,1466,37.579868,127.082367
중랑구,1434, 홈플러스 면목동점,202004,1200,1200,2400,37.579868,127.082367
중랑구,1434, 홈플러스 면목동점,202005,1362,1427,2789,37.579868,127.082367
중랑구,1434, 홈플러스 면목동점,202006,1311,1382,2693,37.579868,127.082367
중랑구,1435, 능산삼거리,201901,61,39,100,37.608681,127.100792
중랑구,1435, 능산삼거리,201902,51,37,88,37.608681,127.100792
중랑구,1435, 능산삼거리,201903,68,65,133,37.608681,127.100792
중랑구,1435, 능산삼거리,201904,154,126,280,37.608681,127.100792
중랑구,1435, 능산삼거리,201905,217,183,400,37.608681,127.100792
중랑구,1435, 능산삼거리,201906,323,255,578,37.608681,127.100792
중랑구,1435, 능산삼거리,201907,305,230,535,37.608681,127.100792
중랑구,1435, 능산삼거리,201908,278,228,506,37.608681,127.100792
중랑구,1435, 능산삼거리,201909,243,220,463,37.608681,127.100792
중랑구,1435, 능산삼거리,201910,310,255,565,37.608681,127.100792
중랑구,1435, 능산삼거리,201911,218,162,380,37.608681,127.100792
중랑구,1435, 능산삼거리,201912,130,123,253,37.608681,127.100792
중랑구,1435, 능산삼거리,202001,120,105,225,37.608681,127.100792
중랑구,1435, 능산삼거리,202002,128,102,230,37.608681,127.100792
중랑구,1435, 능산삼거리,202003,214,194,408,37.608681,127.100792
중랑구,1435, 능산삼거리,202004,221,203,424,37.608681,127.100792
중랑구,1435, 능산삼거리,202005,289,256,545,37.608681,127.100792
중랑구,1435, 능산삼거리,202006,392,273,665,37.608681,127.100792
중랑구,1436, 영풍마드레빌,201901,152,133,285,37.605881,127.100632
중랑구,1436, 영풍마드레빌,201902,110,119,229,37.605881,127.100632
중랑구,1436, 영풍마드레빌,201903,226,212,438,37.605881,127.100632
중랑구,1436, 영풍마드레빌,201904,335,295,630,37.605881,127.100632
중랑구,1436, 영풍마드레빌,201905,621,631,1252,37.605881,127.100632
중랑구,1436, 영풍마드레빌,201906,588,590,1178,37.605881,127.100632
중랑구,1436, 영풍마드레빌,201907,632,595,1227,37.605881,127.100632
중랑구,1436, 영풍마드레빌,201908,667,628,1295,37.605881,127.100632
중랑구,1436, 영풍마드레빌,201909,628,581,1209,37.605881,127.100632
중랑구,1436, 영풍마드레빌,201910,578,572,1150,37.605881,127.100632
중랑구,1436, 영풍마드레빌,201911,415,400,815,37.605881,127.100632
중랑구,1436, 영풍마드레빌,201912,229,195,424,37.605881,127.100632
중랑구,1436, 영풍마드레빌,202001,227,205,432,37.605881,127.100632
중랑구,1436, 영풍마드레빌,202002,217,192,409,37.605881,127.100632
중랑구,1436, 영풍마드레빌,202003,451,418,869,37.605881,127.100632
중랑구,1436, 영풍마드레빌,202004,690,686,1376,37.605881,127.100632
중랑구,1436, 영풍마드레빌,202005,816,813,1629,37.605881,127.100632
중랑구,1436, 영풍마드레빌,202006,928,887,1815,37.605881,127.100632
중랑구,1437, 늘푸른공원 앞,201901,124,109,233,37.58342,127.079926
중랑구,1437, 늘푸른공원 앞,201902,151,131,282,37.58342,127.079926
중랑구,1437, 늘푸른공원 앞,201903,196,258,454,37.58342,127.079926
중랑구,1437, 늘푸른공원 앞,201904,309,378,687,37.58342,127.079926
중랑구,1437, 늘푸른공원 앞,201905,519,539,1058,37.58342,127.079926
중랑구,1437, 늘푸른공원 앞,201906,625,649,1274,37.58342,127.079926
중랑구,1437, 늘푸른공원 앞,201907,569,675,1244,37.58342,127.079926
중랑구,1437, 늘푸른공원 앞,201908,543,659,1202,37.58342,127.079926
중랑구,1437, 늘푸른공원 앞,201909,613,671,1284,37.58342,127.079926
중랑구,1437, 늘푸른공원 앞,201910,670,733,1403,37.58342,127.079926
중랑구,1437, 늘푸른공원 앞,201911,361,421,782,37.58342,127.079926
중랑구,1437, 늘푸른공원 앞,201912,228,225,453,37.58342,127.079926
중랑구,1437, 늘푸른공원 앞,202001,204,203,407,37.58342,127.079926
중랑구,1437, 늘푸른공원 앞,202002,191,209,400,37.58342,127.079926
중랑구,1437, 늘푸른공원 앞,202003,491,464,955,37.58342,127.079926
중랑구,1437, 늘푸른공원 앞,202004,254,297,551,37.58342,127.079926
중랑구,1437, 늘푸른공원 앞,202005,889,913,1802,37.58342,127.079926
중랑구,1437, 늘푸른공원 앞,202006,95,115,210,37.58342,127.079926
중랑구,1438, 홈플러스 신내점 앞,201901,397,505,902,37.616169,127.093483
중랑구,1438, 홈플러스 신내점 앞,201902,319,394,713,37.616169,127.093483
중랑구,1438, 홈플러스 신내점 앞,201903,672,901,1573,37.616169,127.093483
중랑구,1438, 홈플러스 신내점 앞,201904,1071,1511,2582,37.616169,127.093483
중랑구,1438, 홈플러스 신내점 앞,201905,1618,2103,3721,37.616169,127.093483
중랑구,1438, 홈플러스 신내점 앞,201906,1704,2149,3853,37.616169,127.093483
중랑구,1438, 홈플러스 신내점 앞,201907,1678,2094,3772,37.616169,127.093483
중랑구,1438, 홈플러스 신내점 앞,201908,1649,2053,3702,37.616169,127.093483
중랑구,1438, 홈플러스 신내점 앞,201909,1734,1944,3678,37.616169,127.093483
중랑구,1438, 홈플러스 신내점 앞,201910,1850,2315,4165,37.616169,127.093483
중랑구,1438, 홈플러스 신내점 앞,201911,1182,1520,2702,37.616169,127.093483
중랑구,1438, 홈플러스 신내점 앞,201912,701,883,1584,37.616169,127.093483
중랑구,1438, 홈플러스 신내점 앞,202001,612,718,1330,37.616169,127.093483
중랑구,1438, 홈플러스 신내점 앞,202002,563,687,1250,37.616169,127.093483
중랑구,1438, 홈플러스 신내점 앞,202003,1263,1429,2692,37.616169,127.093483
중랑구,1438, 홈플러스 신내점 앞,202004,1896,1961,3857,37.616169,127.093483
중랑구,1438, 홈플러스 신내점 앞,202005,2376,2498,4874,37.616169,127.093483
중랑구,1438, 홈플러스 신내점 앞,202006,2213,2517,4730,37.616169,127.093483
중랑구,1440, 하나은행 면목지점,201901,199,215,414,37.586372,127.08007
중랑구,1440, 하나은행 면목지점,201902,195,204,399,37.586372,127.08007
중랑구,1440, 하나은행 면목지점,201903,361,393,754,37.586372,127.08007
중랑구,1440, 하나은행 면목지점,201904,548,589,1137,37.586372,127.08007
중랑구,1440, 하나은행 면목지점,201905,894,965,1859,37.586372,127.08007
중랑구,1440, 하나은행 면목지점,201906,983,1056,2039,37.586372,127.08007
중랑구,1440, 하나은행 면목지점,201907,894,1050,1944,37.586372,127.08007
중랑구,1440, 하나은행 면목지점,201908,966,1138,2104,37.586372,127.08007
중랑구,1440, 하나은행 면목지점,201909,1026,1203,2229,37.586372,127.08007
중랑구,1440, 하나은행 면목지점,201910,1213,1381,2594,37.586372,127.08007
중랑구,1440, 하나은행 면목지점,201911,737,881,1618,37.586372,127.08007
중랑구,1440, 하나은행 면목지점,201912,409,421,830,37.586372,127.08007
중랑구,1440, 하나은행 면목지점,202001,394,401,795,37.586372,127.08007
중랑구,1440, 하나은행 면목지점,202002,284,302,586,37.586372,127.08007
중랑구,1440, 하나은행 면목지점,202003,628,628,1256,37.586372,127.08007
중랑구,1440, 하나은행 면목지점,202004,1204,1249,2453,37.586372,127.08007
중랑구,1440, 하나은행 면목지점,202005,1380,1455,2835,37.586372,127.08007
중랑구,1440, 하나은행 면목지점,202006,1706,1991,3697,37.586372,127.08007
중랑구,1441, 신내능말공원,201901,275,128,403,37.616711,127.110733
중랑구,1441, 신내능말공원,201902,215,116,331,37.616711,127.110733
중랑구,1441, 신내능말공원,201903,480,233,713,37.616711,127.110733
중랑구,1441, 신내능말공원,201904,811,496,1307,37.616711,127.110733
중랑구,1441, 신내능말공원,201905,1026,719,1745,37.616711,127.110733
중랑구,1441, 신내능말공원,201906,1014,697,1711,37.616711,127.110733
중랑구,1441, 신내능말공원,201907,960,600,1560,37.616711,127.110733
중랑구,1441, 신내능말공원,201908,961,602,1563,37.616711,127.110733
중랑구,1441, 신내능말공원,201909,834,568,1402,37.616711,127.110733
중랑구,1441, 신내능말공원,201910,947,608,1555,37.616711,127.110733
중랑구,1441, 신내능말공원,201911,666,385,1051,37.616711,127.110733
중랑구,1441, 신내능말공원,201912,442,251,693,37.616711,127.110733
중랑구,1441, 신내능말공원,202001,382,239,621,37.616711,127.110733
중랑구,1441, 신내능말공원,202002,339,203,542,37.616711,127.110733
중랑구,1441, 신내능말공원,202003,574,399,973,37.616711,127.110733
중랑구,1441, 신내능말공원,202004,774,541,1315,37.616711,127.110733
중랑구,1441, 신내능말공원,202005,744,592,1336,37.616711,127.110733
중랑구,1441, 신내능말공원,202006,698,469,1167,37.616711,127.110733
중랑구,1442, (구)신한은행 중랑교지점,201901,208,315,523,37.598591,127.079819
중랑구,1442, (구)신한은행 중랑교지점,201902,180,279,459,37.598591,127.079819
중랑구,1442, (구)신한은행 중랑교지점,201903,385,569,954,37.598591,127.079819
중랑구,1442, (구)신한은행 중랑교지점,201904,691,853,1544,37.598591,127.079819
중랑구,1442, (구)신한은행 중랑교지점,201905,1022,1304,2326,37.598591,127.079819
중랑구,1442, (구)신한은행 중랑교지점,201906,1254,1407,2661,37.598591,127.079819
중랑구,1442, (구)신한은행 중랑교지점,201907,1210,1408,2618,37.598591,127.079819
중랑구,1442, (구)신한은행 중랑교지점,201908,1175,1315,2490,37.598591,127.079819
중랑구,1442, (구)신한은행 중랑교지점,201909,1227,1312,2539,37.598591,127.079819
중랑구,1442, (구)신한은행 중랑교지점,201910,1431,1488,2919,37.598591,127.079819
중랑구,1442, (구)신한은행 중랑교지점,201911,933,1017,1950,37.598591,127.079819
중랑구,1442, (구)신한은행 중랑교지점,201912,544,601,1145,37.598591,127.079819
중랑구,1442, (구)신한은행 중랑교지점,202001,509,581,1090,37.598591,127.079819
중랑구,1442, (구)신한은행 중랑교지점,202002,480,565,1045,37.598591,127.079819
중랑구,1442, (구)신한은행 중랑교지점,202003,856,867,1723,37.598591,127.079819
중랑구,1442, (구)신한은행 중랑교지점,202004,1359,1447,2806,37.598591,127.079819
중랑구,1442, (구)신한은행 중랑교지점,202005,1627,1702,3329,37.598591,127.079819
중랑구,1442, (구)신한은행 중랑교지점,202006,2110,2384,4494,37.598591,127.079819
중랑구,1443, 구립망우청소년독서실,201901,147,152,299,37.59552,127.098778
중랑구,1443, 구립망우청소년독서실,201902,166,161,327,37.59552,127.098778
중랑구,1443, 구립망우청소년독서실,201903,285,267,552,37.59552,127.098778
중랑구,1443, 구립망우청소년독서실,201904,349,322,671,37.59552,127.098778
중랑구,1443, 구립망우청소년독서실,201905,507,511,1018,37.59552,127.098778
중랑구,1443, 구립망우청소년독서실,201906,489,492,981,37.59552,127.098778
중랑구,1443, 구립망우청소년독서실,201907,393,378,771,37.59552,127.098778
중랑구,1443, 구립망우청소년독서실,201908,425,447,872,37.59552,127.098778
중랑구,1443, 구립망우청소년독서실,201909,423,422,845,37.59552,127.098778
중랑구,1443, 구립망우청소년독서실,201910,441,476,917,37.59552,127.098778
중랑구,1443, 구립망우청소년독서실,201911,244,228,472,37.59552,127.098778
중랑구,1443, 구립망우청소년독서실,201912,206,205,411,37.59552,127.098778
중랑구,1443, 구립망우청소년독서실,202001,163,164,327,37.59552,127.098778
중랑구,1443, 구립망우청소년독서실,202002,135,132,267,37.59552,127.098778
중랑구,1443, 구립망우청소년독서실,202003,216,212,428,37.59552,127.098778
중랑구,1443, 구립망우청소년독서실,202004,370,366,736,37.59552,127.098778
중랑구,1443, 구립망우청소년독서실,202005,516,515,1031,37.59552,127.098778
중랑구,1443, 구립망우청소년독서실,202006,559,558,1117,37.59552,127.098778
중랑구,1444, 면목4치안센터,201901,192,347,539,37.574028,127.080544
중랑구,1444, 면목4치안센터,201902,220,311,531,37.574028,127.080544
중랑구,1444, 면목4치안센터,201903,307,453,760,37.574028,127.080544
중랑구,1444, 면목4치안센터,201904,472,668,1140,37.574028,127.080544
중랑구,1444, 면목4치안센터,201905,714,1063,1777,37.574028,127.080544
중랑구,1444, 면목4치안센터,201906,779,1196,1975,37.574028,127.080544
중랑구,1444, 면목4치안센터,201907,797,1212,2009,37.574028,127.080544
중랑구,1444, 면목4치안센터,201908,797,1253,2050,37.574028,127.080544
중랑구,1444, 면목4치안센터,201909,891,1192,2083,37.574028,127.080544
중랑구,1444, 면목4치안센터,201910,1068,1460,2528,37.574028,127.080544
중랑구,1444, 면목4치안센터,201911,696,877,1573,37.574028,127.080544
중랑구,1444, 면목4치안센터,201912,397,521,918,37.574028,127.080544
중랑구,1444, 면목4치안센터,202001,284,414,698,37.574028,127.080544
중랑구,1444, 면목4치안센터,202002,373,460,833,37.574028,127.080544
중랑구,1444, 면목4치안센터,202003,826,1029,1855,37.574028,127.080544
중랑구,1444, 면목4치안센터,202004,1237,1351,2588,37.574028,127.080544
중랑구,1444, 면목4치안센터,202005,1328,1506,2834,37.574028,127.080544
중랑구,1444, 면목4치안센터,202006,1347,1637,2984,37.574028,127.080544
중랑구,1445, 용마지구대,201901,37,56,93,37.579941,127.079399
중랑구,1445, 용마지구대,201902,52,60,112,37.579941,127.079399
중랑구,1445, 용마지구대,201903,72,95,167,37.579941,127.079399
중랑구,1445, 용마지구대,201904,146,174,320,37.579941,127.079399
중랑구,1445, 용마지구대,201905,251,271,522,37.579941,127.079399
중랑구,1445, 용마지구대,201906,229,256,485,37.579941,127.079399
중랑구,1445, 용마지구대,201907,240,285,525,37.579941,127.079399
중랑구,1445, 용마지구대,201908,220,223,443,37.579941,127.079399
중랑구,1445, 용마지구대,201909,252,278,530,37.579941,127.079399
중랑구,1445, 용마지구대,201910,350,368,718,37.579941,127.079399
중랑구,1445, 용마지구대,201911,203,217,420,37.579941,127.079399
중랑구,1445, 용마지구대,201912,99,108,207,37.579941,127.079399
중랑구,1445, 용마지구대,202001,74,66,140,37.579941,127.079399
중랑구,1445, 용마지구대,202002,72,78,150,37.579941,127.079399
중랑구,1445, 용마지구대,202003,285,283,568,37.579941,127.079399
중랑구,1445, 용마지구대,202004,552,560,1112,37.579941,127.079399
중랑구,1445, 용마지구대,202005,319,347,666,37.579941,127.079399
중랑구,1445, 용마지구대,202006,328,367,695,37.579941,127.079399
중랑구,1446, 중랑전화국 교차로,201901,333,423,756,37.591301,127.08033
중랑구,1446, 중랑전화국 교차로,201902,284,407,691,37.591301,127.08033
중랑구,1446, 중랑전화국 교차로,201903,579,767,1346,37.591301,127.08033
중랑구,1446, 중랑전화국 교차로,201904,837,981,1818,37.591301,127.08033
중랑구,1446, 중랑전화국 교차로,201905,1291,1616,2907,37.591301,127.08033
중랑구,1446, 중랑전화국 교차로,201906,1474,1718,3192,37.591301,127.08033
중랑구,1446, 중랑전화국 교차로,201907,1504,1753,3257,37.591301,127.08033
중랑구,1446, 중랑전화국 교차로,201908,1488,1723,3211,37.591301,127.08033
중랑구,1446, 중랑전화국 교차로,201909,1399,1604,3003,37.591301,127.08033
중랑구,1446, 중랑전화국 교차로,201910,1819,1982,3801,37.591301,127.08033
중랑구,1446, 중랑전화국 교차로,201911,1202,1383,2585,37.591301,127.08033
중랑구,1446, 중랑전화국 교차로,201912,706,806,1512,37.591301,127.08033
중랑구,1446, 중랑전화국 교차로,202001,530,588,1118,37.591301,127.08033
중랑구,1446, 중랑전화국 교차로,202002,487,615,1102,37.591301,127.08033
중랑구,1446, 중랑전화국 교차로,202003,918,969,1887,37.591301,127.08033
중랑구,1446, 중랑전화국 교차로,202004,1488,1529,3017,37.591301,127.08033
중랑구,1446, 중랑전화국 교차로,202005,1709,1832,3541,37.591301,127.08033
중랑구,1446, 중랑전화국 교차로,202006,1783,2036,3819,37.591301,127.08033
중랑구,1447, 면목역 3번출구,201901,393,405,798,37.588902,127.08728
중랑구,1447, 면목역 3번출구,201902,353,396,749,37.588902,127.08728
중랑구,1447, 면목역 3번출구,201903,820,831,1651,37.588902,127.08728
중랑구,1447, 면목역 3번출구,201904,1120,1116,2236,37.588902,127.08728
중랑구,1447, 면목역 3번출구,201905,1861,1994,3855,37.588902,127.08728
중랑구,1447, 면목역 3번출구,201906,2040,2164,4204,37.588902,127.08728
중랑구,1447, 면목역 3번출구,201907,2080,2208,4288,37.588902,127.08728
중랑구,1447, 면목역 3번출구,201908,2006,2100,4106,37.588902,127.08728
중랑구,1447, 면목역 3번출구,201909,2162,2199,4361,37.588902,127.08728
중랑구,1447, 면목역 3번출구,201910,2204,2268,4472,37.588902,127.08728
중랑구,1447, 면목역 3번출구,201911,1380,1447,2827,37.588902,127.08728
중랑구,1447, 면목역 3번출구,201912,905,886,1791,37.588902,127.08728
중랑구,1447, 면목역 3번출구,202001,700,733,1433,37.588902,127.08728
중랑구,1447, 면목역 3번출구,202002,604,625,1229,37.588902,127.08728
중랑구,1447, 면목역 3번출구,202003,1143,1198,2341,37.588902,127.08728
중랑구,1447, 면목역 3번출구,202004,2053,2116,4169,37.588902,127.08728
중랑구,1447, 면목역 3번출구,202005,2330,2438,4768,37.588902,127.08728
중랑구,1447, 면목역 3번출구,202006,2529,2694,5223,37.588902,127.08728
중랑구,1448, 코스트코 상봉점,201901,531,548,1079,37.597321,127.089798
중랑구,1448, 코스트코 상봉점,201902,486,453,939,37.597321,127.089798
중랑구,1448, 코스트코 상봉점,201903,872,863,1735,37.597321,127.089798
중랑구,1448, 코스트코 상봉점,201904,1273,1193,2466,37.597321,127.089798
중랑구,1448, 코스트코 상봉점,201905,1922,1787,3709,37.597321,127.089798
중랑구,1448, 코스트코 상봉점,201906,2458,2419,4877,37.597321,127.089798
중랑구,1448, 코스트코 상봉점,201907,2283,2214,4497,37.597321,127.089798
중랑구,1448, 코스트코 상봉점,201908,2311,2250,4561,37.597321,127.089798
중랑구,1448, 코스트코 상봉점,201909,2359,2302,4661,37.597321,127.089798
중랑구,1448, 코스트코 상봉점,201910,2693,2677,5370,37.597321,127.089798
중랑구,1448, 코스트코 상봉점,201911,1657,1581,3238,37.597321,127.089798
중랑구,1448, 코스트코 상봉점,201912,887,895,1782,37.597321,127.089798
중랑구,1448, 코스트코 상봉점,202001,893,920,1813,37.597321,127.089798
중랑구,1448, 코스트코 상봉점,202002,778,792,1570,37.597321,127.089798
중랑구,1448, 코스트코 상봉점,202003,1297,1302,2599,37.597321,127.089798
중랑구,1448, 코스트코 상봉점,202004,2090,2119,4209,37.597321,127.089798
중랑구,1448, 코스트코 상봉점,202005,2271,2282,4553,37.597321,127.089798
중랑구,1448, 코스트코 상봉점,202006,2576,2594,5170,37.597321,127.089798
중랑구,1449, 상봉역 1번출구,201901,428,426,854,37.596558,127.085838
중랑구,1449, 상봉역 1번출구,201902,469,405,874,37.596558,127.085838
중랑구,1449, 상봉역 1번출구,201903,814,735,1549,37.596558,127.085838
중랑구,1449, 상봉역 1번출구,201904,1221,1058,2279,37.596558,127.085838
중랑구,1449, 상봉역 1번출구,201905,1954,1768,3722,37.596558,127.085838
중랑구,1449, 상봉역 1번출구,201906,2074,1957,4031,37.596558,127.085838
중랑구,1449, 상봉역 1번출구,201907,2170,2050,4220,37.596558,127.085838
중랑구,1449, 상봉역 1번출구,201908,2039,1865,3904,37.596558,127.085838
중랑구,1449, 상봉역 1번출구,201909,2070,1944,4014,37.596558,127.085838
중랑구,1449, 상봉역 1번출구,201910,2488,2448,4936,37.596558,127.085838
중랑구,1449, 상봉역 1번출구,201911,1684,1545,3229,37.596558,127.085838
중랑구,1449, 상봉역 1번출구,201912,807,794,1601,37.596558,127.085838
중랑구,1449, 상봉역 1번출구,202001,726,732,1458,37.596558,127.085838
중랑구,1449, 상봉역 1번출구,202002,677,678,1355,37.596558,127.085838
중랑구,1449, 상봉역 1번출구,202003,1343,1333,2676,37.596558,127.085838
중랑구,1449, 상봉역 1번출구,202004,2066,2050,4116,37.596558,127.085838
중랑구,1449, 상봉역 1번출구,202005,2545,2538,5083,37.596558,127.085838
중랑구,1449, 상봉역 1번출구,202006,2925,2957,5882,37.596558,127.085838
중랑구,1450, 화랑대역 7번출구,201901,119,156,275,37.619625,127.085014
중랑구,1450, 화랑대역 7번출구,201902,103,138,241,37.619625,127.085014
중랑구,1450, 화랑대역 7번출구,201903,363,418,781,37.619625,127.085014
중랑구,1450, 화랑대역 7번출구,201904,650,709,1359,37.619625,127.085014
중랑구,1450, 화랑대역 7번출구,201905,1013,1016,2029,37.619625,127.085014
중랑구,1450, 화랑대역 7번출구,201906,1046,1077,2123,37.619625,127.085014
중랑구,1450, 화랑대역 7번출구,201907,1004,1184,2188,37.619625,127.085014
중랑구,1450, 화랑대역 7번출구,201908,995,1158,2153,37.619625,127.085014
중랑구,1450, 화랑대역 7번출구,201909,1210,1303,2513,37.619625,127.085014
중랑구,1450, 화랑대역 7번출구,201910,1340,1400,2740,37.619625,127.085014
중랑구,1450, 화랑대역 7번출구,201911,711,737,1448,37.619625,127.085014
중랑구,1450, 화랑대역 7번출구,201912,308,323,631,37.619625,127.085014
중랑구,1450, 화랑대역 7번출구,202001,266,283,549,37.619625,127.085014
중랑구,1450, 화랑대역 7번출구,202002,340,380,720,37.619625,127.085014
중랑구,1450, 화랑대역 7번출구,202003,975,1015,1990,37.619625,127.085014
중랑구,1450, 화랑대역 7번출구,202004,1524,1531,3055,37.619625,127.085014
중랑구,1450, 화랑대역 7번출구,202005,1999,2088,4087,37.619625,127.085014
중랑구,1450, 화랑대역 7번출구,202006,1871,1941,3812,37.619625,127.085014
중랑구,1451, 중랑세무서,201901,280,357,637,37.592758,127.07267
중랑구,1451, 중랑세무서,201902,316,395,711,37.592758,127.07267
중랑구,1451, 중랑세무서,201903,659,836,1495,37.592758,127.07267
중랑구,1451, 중랑세무서,201904,1185,1479,2664,37.592758,127.07267
중랑구,1451, 중랑세무서,201905,2097,2575,4672,37.592758,127.07267
중랑구,1451, 중랑세무서,201906,2113,2410,4523,37.592758,127.07267
중랑구,1451, 중랑세무서,201907,2029,2392,4421,37.592758,127.07267
중랑구,1451, 중랑세무서,201908,2044,2315,4359,37.592758,127.07267
중랑구,1451, 중랑세무서,201909,2124,2400,4524,37.592758,127.07267
중랑구,1451, 중랑세무서,201910,2510,2757,5267,37.592758,127.07267
중랑구,1451, 중랑세무서,201911,1306,1561,2867,37.592758,127.07267
중랑구,1451, 중랑세무서,201912,709,781,1490,37.592758,127.07267
중랑구,1451, 중랑세무서,202001,659,716,1375,37.592758,127.07267
중랑구,1451, 중랑세무서,202002,657,719,1376,37.592758,127.07267
중랑구,1451, 중랑세무서,202003,1934,2093,4027,37.592758,127.07267
중랑구,1451, 중랑세무서,202004,2428,2752,5180,37.592758,127.07267
중랑구,1451, 중랑세무서,202005,3571,3731,7302,37.592758,127.07267
중랑구,1451, 중랑세무서,202006,3582,3794,7376,37.592758,127.07267
중랑구,1452, 겸재교 진입부,201901,362,356,718,37.585655,127.07505
중랑구,1452, 겸재교 진입부,201902,332,357,689,37.585655,127.07505
중랑구,1452, 겸재교 진입부,201903,614,614,1228,37.585655,127.07505
중랑구,1452, 겸재교 진입부,201904,931,977,1908,37.585655,127.07505
중랑구,1452, 겸재교 진입부,201905,1743,1984,3727,37.585655,127.07505
중랑구,1452, 겸재교 진입부,201906,1707,1991,3698,37.585655,127.07505
중랑구,1452, 겸재교 진입부,201907,1581,1850,3431,37.585655,127.07505
중랑구,1452, 겸재교 진입부,201908,1585,1951,3536,37.585655,127.07505
중랑구,1452, 겸재교 진입부,201909,1775,2063,3838,37.585655,127.07505
중랑구,1452, 겸재교 진입부,201910,1917,2019,3936,37.585655,127.07505
중랑구,1452, 겸재교 진입부,201911,1065,1117,2182,37.585655,127.07505
중랑구,1452, 겸재교 진입부,201912,577,656,1233,37.585655,127.07505
중랑구,1452, 겸재교 진입부,202001,588,595,1183,37.585655,127.07505
중랑구,1452, 겸재교 진입부,202002,628,610,1238,37.585655,127.07505
중랑구,1452, 겸재교 진입부,202003,1920,2026,3946,37.585655,127.07505
중랑구,1452, 겸재교 진입부,202004,2895,3137,6032,37.585655,127.07505
중랑구,1452, 겸재교 진입부,202005,3142,3348,6490,37.585655,127.07505
중랑구,1452, 겸재교 진입부,202006,2907,3517,6424,37.585655,127.07505
중랑구,1453, 중랑캠핑숲,201901,42,41,83,37.604603,127.109253
중랑구,1453, 중랑캠핑숲,201902,45,52,97,37.604603,127.109253
중랑구,1453, 중랑캠핑숲,201903,87,67,154,37.604603,127.109253
중랑구,1453, 중랑캠핑숲,201904,132,128,260,37.604603,127.109253
중랑구,1453, 중랑캠핑숲,201905,218,230,448,37.604603,127.109253
중랑구,1453, 중랑캠핑숲,201906,199,203,402,37.604603,127.109253
중랑구,1453, 중랑캠핑숲,201907,186,160,346,37.604603,127.109253
중랑구,1453, 중랑캠핑숲,201908,230,214,444,37.604603,127.109253
중랑구,1453, 중랑캠핑숲,201909,266,245,511,37.604603,127.109253
중랑구,1453, 중랑캠핑숲,201910,295,273,568,37.604603,127.109253
중랑구,1453, 중랑캠핑숲,201911,206,172,378,37.604603,127.109253
중랑구,1453, 중랑캠핑숲,201912,78,83,161,37.604603,127.109253
중랑구,1453, 중랑캠핑숲,202001,38,86,124,37.604603,127.109253
중랑구,1453, 중랑캠핑숲,202002,102,99,201,37.604603,127.109253
중랑구,1453, 중랑캠핑숲,202003,208,204,412,37.604603,127.109253
중랑구,1453, 중랑캠핑숲,202004,322,336,658,37.604603,127.109253
중랑구,1453, 중랑캠핑숲,202005,356,369,725,37.604603,127.109253
중랑구,1453, 중랑캠핑숲,202006,342,333,675,37.604603,127.109253
중랑구,1454, 한국전력공사(동대문 중랑지사),201901,226,290,516,37.607349,127.07859
중랑구,1454, 한국전력공사(동대문 중랑지사),201902,217,308,525,37.607349,127.07859
중랑구,1454, 한국전력공사(동대문 중랑지사),201903,404,511,915,37.607349,127.07859
중랑구,1454, 한국전력공사(동대문 중랑지사),201904,705,910,1615,37.607349,127.07859
중랑구,1454, 한국전력공사(동대문 중랑지사),201905,1141,1421,2562,37.607349,127.07859
중랑구,1454, 한국전력공사(동대문 중랑지사),201906,1222,1586,2808,37.607349,127.07859
중랑구,1454, 한국전력공사(동대문 중랑지사),201907,1031,1389,2420,37.607349,127.07859
중랑구,1454, 한국전력공사(동대문 중랑지사),201908,1069,1380,2449,37.607349,127.07859
중랑구,1454, 한국전력공사(동대문 중랑지사),201909,1079,1348,2427,37.607349,127.07859
중랑구,1454, 한국전력공사(동대문 중랑지사),201910,1166,1481,2647,37.607349,127.07859
중랑구,1454, 한국전력공사(동대문 중랑지사),201911,804,1048,1852,37.607349,127.07859
중랑구,1454, 한국전력공사(동대문 중랑지사),201912,425,596,1021,37.607349,127.07859
중랑구,1454, 한국전력공사(동대문 중랑지사),202001,468,524,992,37.607349,127.07859
중랑구,1454, 한국전력공사(동대문 중랑지사),202002,475,544,1019,37.607349,127.07859
중랑구,1454, 한국전력공사(동대문 중랑지사),202003,953,1005,1958,37.607349,127.07859
중랑구,1454, 한국전력공사(동대문 중랑지사),202004,1315,1429,2744,37.607349,127.07859
중랑구,1454, 한국전력공사(동대문 중랑지사),202005,1654,1863,3517,37.607349,127.07859
중랑구,1454, 한국전력공사(동대문 중랑지사),202006,1617,1962,3579,37.607349,127.07859
중랑구,1455, 상봉역 2번 출구,201901,260,255,515,37.596329,127.085899
중랑구,1455, 상봉역 2번 출구,201902,223,202,425,37.596329,127.085899
중랑구,1455, 상봉역 2번 출구,201903,539,546,1085,37.596329,127.085899
중랑구,1455, 상봉역 2번 출구,201904,796,801,1597,37.596329,127.085899
중랑구,1455, 상봉역 2번 출구,201905,1362,1300,2662,37.596329,127.085899
중랑구,1455, 상봉역 2번 출구,201906,1597,1564,3161,37.596329,127.085899
중랑구,1455, 상봉역 2번 출구,201907,1741,1677,3418,37.596329,127.085899
중랑구,1455, 상봉역 2번 출구,201908,1737,1720,3457,37.596329,127.085899
중랑구,1455, 상봉역 2번 출구,201909,1652,1634,3286,37.596329,127.085899
중랑구,1455, 상봉역 2번 출구,201910,2006,2022,4028,37.596329,127.085899
중랑구,1455, 상봉역 2번 출구,201911,1205,1193,2398,37.596329,127.085899
중랑구,1455, 상봉역 2번 출구,201912,644,656,1300,37.596329,127.085899
중랑구,1455, 상봉역 2번 출구,202001,609,617,1226,37.596329,127.085899
중랑구,1455, 상봉역 2번 출구,202002,551,556,1107,37.596329,127.085899
중랑구,1455, 상봉역 2번 출구,202003,1020,1023,2043,37.596329,127.085899
중랑구,1455, 상봉역 2번 출구,202004,1580,1578,3158,37.596329,127.085899
중랑구,1455, 상봉역 2번 출구,202005,1802,1823,3625,37.596329,127.085899
중랑구,1455, 상봉역 2번 출구,202006,2040,2075,4115,37.596329,127.085899
중랑구,1456, 상아빌딩(우림시장 교차로),201901,181,180,361,37.595112,127.100327
중랑구,1456, 상아빌딩(우림시장 교차로),201902,152,145,297,37.595112,127.100327
중랑구,1456, 상아빌딩(우림시장 교차로),201903,283,255,538,37.595112,127.100327
중랑구,1456, 상아빌딩(우림시장 교차로),201904,415,367,782,37.595112,127.100327
중랑구,1456, 상아빌딩(우림시장 교차로),201905,826,867,1693,37.595112,127.100327
중랑구,1456, 상아빌딩(우림시장 교차로),201906,914,959,1873,37.595112,127.100327
중랑구,1456, 상아빌딩(우림시장 교차로),201907,891,929,1820,37.595112,127.100327
중랑구,1456, 상아빌딩(우림시장 교차로),201908,916,1012,1928,37.595112,127.100327
중랑구,1456, 상아빌딩(우림시장 교차로),201909,805,886,1691,37.595112,127.100327
중랑구,1456, 상아빌딩(우림시장 교차로),201910,1171,1247,2418,37.595112,127.100327
중랑구,1456, 상아빌딩(우림시장 교차로),201911,764,860,1624,37.595112,127.100327
중랑구,1456, 상아빌딩(우림시장 교차로),201912,417,430,847,37.595112,127.100327
중랑구,1456, 상아빌딩(우림시장 교차로),202001,382,392,774,37.595112,127.100327
중랑구,1456, 상아빌딩(우림시장 교차로),202002,343,348,691,37.595112,127.100327
중랑구,1456, 상아빌딩(우림시장 교차로),202003,596,601,1197,37.595112,127.100327
중랑구,1456, 상아빌딩(우림시장 교차로),202004,851,883,1734,37.595112,127.100327
중랑구,1456, 상아빌딩(우림시장 교차로),202005,1113,1179,2292,37.595112,127.100327
중랑구,1456, 상아빌딩(우림시장 교차로),202006,1269,1343,2612,37.595112,127.100327
중랑구,1457, 동원사거리,201901,135,108,243,37.58976,127.093239
중랑구,1457, 동원사거리,201902,126,103,229,37.58976,127.093239
중랑구,1457, 동원사거리,201903,284,199,483,37.58976,127.093239
중랑구,1457, 동원사거리,201904,552,473,1025,37.58976,127.093239
중랑구,1457, 동원사거리,201905,827,749,1576,37.58976,127.093239
중랑구,1457, 동원사거리,201906,817,820,1637,37.58976,127.093239
중랑구,1457, 동원사거리,201907,787,808,1595,37.58976,127.093239
중랑구,1457, 동원사거리,201908,687,710,1397,37.58976,127.093239
중랑구,1457, 동원사거리,201909,668,672,1340,37.58976,127.093239
중랑구,1457, 동원사거리,201910,833,818,1651,37.58976,127.093239
중랑구,1457, 동원사거리,201911,577,572,1149,37.58976,127.093239
중랑구,1457, 동원사거리,201912,284,261,545,37.58976,127.093239
중랑구,1457, 동원사거리,202001,309,287,596,37.58976,127.093239
중랑구,1457, 동원사거리,202002,217,193,410,37.58976,127.093239
중랑구,1457, 동원사거리,202003,495,487,982,37.58976,127.093239
중랑구,1457, 동원사거리,202004,742,703,1445,37.58976,127.093239
중랑구,1457, 동원사거리,202005,883,863,1746,37.58976,127.093239
중랑구,1457, 동원사거리,202006,1083,1072,2155,37.58976,127.093239
중랑구,1458, 상봉터미널2,201901,270,289,559,37.59734,127.093086
중랑구,1458, 상봉터미널2,201902,264,279,543,37.59734,127.093086
중랑구,1458, 상봉터미널2,201903,467,512,979,37.59734,127.093086
중랑구,1458, 상봉터미널2,201904,724,782,1506,37.59734,127.093086
중랑구,1458, 상봉터미널2,201905,1421,1492,2913,37.59734,127.093086
중랑구,1458, 상봉터미널2,201906,1694,1886,3580,37.59734,127.093086
중랑구,1458, 상봉터미널2,201907,1732,1804,3536,37.59734,127.093086
중랑구,1458, 상봉터미널2,201908,1707,1745,3452,37.59734,127.093086
중랑구,1458, 상봉터미널2,201909,1672,1720,3392,37.59734,127.093086
중랑구,1458, 상봉터미널2,201910,2042,2096,4138,37.59734,127.093086
중랑구,1458, 상봉터미널2,201911,1243,1305,2548,37.59734,127.093086
중랑구,1458, 상봉터미널2,201912,688,709,1397,37.59734,127.093086
중랑구,1458, 상봉터미널2,202001,581,574,1155,37.59734,127.093086
중랑구,1458, 상봉터미널2,202002,536,540,1076,37.59734,127.093086
중랑구,1458, 상봉터미널2,202003,1007,1000,2007,37.59734,127.093086
중랑구,1458, 상봉터미널2,202004,1684,1717,3401,37.59734,127.093086
중랑구,1458, 상봉터미널2,202005,2128,2162,4290,37.59734,127.093086
중랑구,1458, 상봉터미널2,202006,2481,2555,5036,37.59734,127.093086
중랑구,1459, 용마한신아파트사거리,201901,102,64,166,37.59734,127.093086
중랑구,1459, 용마한신아파트사거리,201902,90,61,151,37.59734,127.093086
중랑구,1459, 용마한신아파트사거리,201903,203,119,322,37.59734,127.093086
중랑구,1459, 용마한신아파트사거리,201904,335,205,540,37.59734,127.093086
중랑구,1459, 용마한신아파트사거리,201905,447,320,767,37.59734,127.093086
중랑구,1459, 용마한신아파트사거리,201906,454,382,836,37.59734,127.093086
중랑구,1459, 용마한신아파트사거리,201907,508,391,899,37.59734,127.093086
중랑구,1459, 용마한신아파트사거리,201908,405,329,734,37.59734,127.093086
중랑구,1459, 용마한신아파트사거리,201909,364,349,713,37.59734,127.093086
중랑구,1459, 용마한신아파트사거리,201910,493,472,965,37.59734,127.093086
중랑구,1459, 용마한신아파트사거리,201911,339,316,655,37.59734,127.093086
중랑구,1459, 용마한신아파트사거리,201912,197,167,364,37.59734,127.093086
중랑구,1459, 용마한신아파트사거리,202001,180,145,325,37.59734,127.093086
중랑구,1459, 용마한신아파트사거리,202002,162,154,316,37.59734,127.093086
중랑구,1459, 용마한신아파트사거리,202003,270,246,516,37.59734,127.093086
중랑구,1459, 용마한신아파트사거리,202004,424,398,822,37.59734,127.093086
중랑구,1459, 용마한신아파트사거리,202005,432,433,865,37.59734,127.093086
중랑구,1459, 용마한신아파트사거리,202006,547,508,1055,37.59734,127.093086
중랑구,1461,동양엔파트 앞,202004,3,3,6,37.593853,127.075073
중랑구,1461,동양엔파트 앞,202006,360,359,719,37.593853,127.075073
중랑구,1462,동부시장 북문 앞,202006,178,185,363,37.593868,127.076523
중랑구,1463,중랑구민회관,202004,1,1,2,37.573887,127.084831
중랑구,1463,중랑구민회관,202006,12,10,22,37.573887,127.084831
중랑구,1464,중화역 4번출구,202006,91,90,181,37.603054,127.079002
중랑구,1465,중랑공영차고지 옆,202004,1,1,2,37.613148,127.105148
중랑구,1465,중랑공영차고지 옆,202006,195,231,426,37.613148,127.105148
중랑구,1466,두산대림아파트 삼거리,202004,1,1,2,37.618824,127.08757
중랑구,1466,두산대림아파트 삼거리,202006,103,100,203,37.618824,127.08757
중랑구,1467,sk신내 주유소앞(용마산로),202004,1,1,2,37.613621,127.101151
중랑구,1467,sk신내 주유소앞(용마산로),202006,19,19,38,37.613621,127.101151
중랑구,1468,먹골역 7번 출구,202004,0,1,1,37.611477,127.077393
중랑구,1468,먹골역 7번 출구,202006,452,414,866,37.611477,127.077393
중랑구,1469,먹골역 4번출구,202006,9,6,15,37.609821,127.078133
중랑구,1470,중화동 우리은행 앞,202006,154,159,313,37.605202,127.078583
중랑구,1472,영성빌딩(PAT),202006,221,241,462,37.604084,127.079231
중랑구,1473,중랑역 1번 출구(중화문화복지센터),202006,85,83,168,37.594891,127.074951
중랑구,1474,서울중랑우체국,202004,5,6,11,37.595814,127.08284
중랑구,1475,보도 육교(타이어뱅크앞),202004,6,6,12,#N/A,#N/A
중랑구,1476,중목초등학교 앞 육교,202004,2,2,4,#N/A,#N/A
중랑구,1477,면목삼익아파트 앞,202004,1,1,2,37.575985,127.079605
중랑구,1477,면목삼익아파트 앞,202006,85,82,167,37.575985,127.079605
중랑구,1478,홈플러스 상봉점 앞,202004,1,1,2,37.597885,127.091263
중랑구,1478,홈플러스 상봉점 앞,202006,322,329,651,37.597885,127.091263
중랑구,1479,면목 홈플러스 2,202004,1,1,2,37.581055,127.082092
중랑구,1479,면목 홈플러스 2,202006,150,166,316,37.581055,127.082092
중랑구,1480, 용마지구대 옆,202004,1,1,2,37.581112,127.080101
중랑구,1480, 용마지구대 옆,202006,235,243,478,37.581112,127.080101
강북구,1501," 미아역 3번,4번 출구 사이",201901,283,303,586,37.62608,127.026482
강북구,1501," 미아역 3번,4번 출구 사이",201902,280,315,595,37.62608,127.026482
강북구,1501," 미아역 3번,4번 출구 사이",201903,655,656,1311,37.62608,127.026482
강북구,1501," 미아역 3번,4번 출구 사이",201904,943,970,1913,37.62608,127.026482
강북구,1501," 미아역 3번,4번 출구 사이",201905,1496,1555,3051,37.62608,127.026482
강북구,1501," 미아역 3번,4번 출구 사이",201906,1861,1875,3736,37.62608,127.026482
강북구,1501," 미아역 3번,4번 출구 사이",201907,1779,1804,3583,37.62608,127.026482
강북구,1501," 미아역 3번,4번 출구 사이",201908,1684,1713,3397,37.62608,127.026482
강북구,1501," 미아역 3번,4번 출구 사이",201909,1692,1719,3411,37.62608,127.026482
강북구,1501," 미아역 3번,4번 출구 사이",201910,1806,1857,3663,37.62608,127.026482
강북구,1501," 미아역 3번,4번 출구 사이",201911,1117,1188,2305,37.62608,127.026482
강북구,1501," 미아역 3번,4번 출구 사이",201912,663,701,1364,37.62608,127.026482
강북구,1501," 미아역 3번,4번 출구 사이",202001,547,586,1133,37.62608,127.026482
강북구,1501," 미아역 3번,4번 출구 사이",202002,511,497,1008,37.62608,127.026482
강북구,1501," 미아역 3번,4번 출구 사이",202003,923,930,1853,37.62608,127.026482
강북구,1501," 미아역 3번,4번 출구 사이",202004,1431,1435,2866,37.62608,127.026482
강북구,1501," 미아역 3번,4번 출구 사이",202005,1677,1660,3337,37.62608,127.026482
강북구,1501," 미아역 3번,4번 출구 사이",202006,2075,2083,4158,37.62608,127.026482
강북구,1503, 이디야 커피 수유역점 앞,201901,710,793,1503,37.639278,127.026756
강북구,1503, 이디야 커피 수유역점 앞,201902,735,818,1553,37.639278,127.026756
강북구,1503, 이디야 커피 수유역점 앞,201903,1393,1570,2963,37.639278,127.026756
강북구,1503, 이디야 커피 수유역점 앞,201904,2330,2545,4875,37.639278,127.026756
강북구,1503, 이디야 커피 수유역점 앞,201905,3560,3720,7280,37.639278,127.026756
강북구,1503, 이디야 커피 수유역점 앞,201906,3883,4079,7962,37.639278,127.026756
강북구,1503, 이디야 커피 수유역점 앞,201907,3503,3761,7264,37.639278,127.026756
강북구,1503, 이디야 커피 수유역점 앞,201908,3458,3573,7031,37.639278,127.026756
강북구,1503, 이디야 커피 수유역점 앞,201909,3464,3674,7138,37.639278,127.026756
강북구,1503, 이디야 커피 수유역점 앞,201910,3844,4054,7898,37.639278,127.026756
강북구,1503, 이디야 커피 수유역점 앞,201911,2387,2573,4960,37.639278,127.026756
강북구,1503, 이디야 커피 수유역점 앞,201912,1356,1413,2769,37.639278,127.026756
강북구,1503, 이디야 커피 수유역점 앞,202001,1223,1300,2523,37.639278,127.026756
강북구,1503, 이디야 커피 수유역점 앞,202002,1160,1344,2504,37.639278,127.026756
강북구,1503, 이디야 커피 수유역점 앞,202003,2303,2484,4787,37.639278,127.026756
강북구,1503, 이디야 커피 수유역점 앞,202004,3357,3451,6808,37.639278,127.026756
강북구,1503, 이디야 커피 수유역점 앞,202005,4067,4135,8202,37.639278,127.026756
강북구,1503, 이디야 커피 수유역점 앞,202006,4193,4473,8666,37.639278,127.026756
강북구,1504, 다이소 삼양시장점,201901,113,108,221,37.624157,127.018623
강북구,1504, 다이소 삼양시장점,201902,99,97,196,37.624157,127.018623
강북구,1504, 다이소 삼양시장점,201903,176,157,333,37.624157,127.018623
강북구,1504, 다이소 삼양시장점,201904,291,252,543,37.624157,127.018623
강북구,1504, 다이소 삼양시장점,201905,455,392,847,37.624157,127.018623
강북구,1504, 다이소 삼양시장점,201906,628,624,1252,37.624157,127.018623
강북구,1504, 다이소 삼양시장점,201907,618,612,1230,37.624157,127.018623
강북구,1504, 다이소 삼양시장점,201908,631,622,1253,37.624157,127.018623
강북구,1504, 다이소 삼양시장점,201909,646,662,1308,37.624157,127.018623
강북구,1504, 다이소 삼양시장점,201910,686,709,1395,37.624157,127.018623
강북구,1504, 다이소 삼양시장점,201911,445,426,871,37.624157,127.018623
강북구,1504, 다이소 삼양시장점,201912,230,215,445,37.624157,127.018623
강북구,1504, 다이소 삼양시장점,202001,192,154,346,37.624157,127.018623
강북구,1504, 다이소 삼양시장점,202002,187,164,351,37.624157,127.018623
강북구,1504, 다이소 삼양시장점,202003,346,326,672,37.624157,127.018623
강북구,1504, 다이소 삼양시장점,202004,410,399,809,37.624157,127.018623
강북구,1504, 다이소 삼양시장점,202005,502,502,1004,37.624157,127.018623
강북구,1504, 다이소 삼양시장점,202006,601,607,1208,37.624157,127.018623
강북구,1506, 강북문화예술회관,201901,296,293,589,37.640327,127.013359
강북구,1506, 강북문화예술회관,201902,316,254,570,37.640327,127.013359
강북구,1506, 강북문화예술회관,201903,527,481,1008,37.640327,127.013359
강북구,1506, 강북문화예술회관,201904,709,710,1419,37.640327,127.013359
강북구,1506, 강북문화예술회관,201905,1075,1101,2176,37.640327,127.013359
강북구,1506, 강북문화예술회관,201906,1164,1133,2297,37.640327,127.013359
강북구,1506, 강북문화예술회관,201907,1091,1067,2158,37.640327,127.013359
강북구,1506, 강북문화예술회관,201908,1153,1074,2227,37.640327,127.013359
강북구,1506, 강북문화예술회관,201909,1063,1028,2091,37.640327,127.013359
강북구,1506, 강북문화예술회관,201910,1123,1118,2241,37.640327,127.013359
강북구,1506, 강북문화예술회관,201911,788,774,1562,37.640327,127.013359
강북구,1506, 강북문화예술회관,201912,531,514,1045,37.640327,127.013359
강북구,1506, 강북문화예술회관,202001,509,477,986,37.640327,127.013359
강북구,1506, 강북문화예술회관,202002,475,404,879,37.640327,127.013359
강북구,1506, 강북문화예술회관,202003,759,724,1483,37.640327,127.013359
강북구,1506, 강북문화예술회관,202004,887,866,1753,37.640327,127.013359
강북구,1506, 강북문화예술회관,202005,984,979,1963,37.640327,127.013359
강북구,1506, 강북문화예술회관,202006,1179,1178,2357,37.640327,127.013359
강북구,1509, 서울북부수도사업소,201901,228,270,498,37.634377,127.035751
강북구,1509, 서울북부수도사업소,201902,147,217,364,37.634377,127.035751
강북구,1509, 서울북부수도사업소,201903,295,344,639,37.634377,127.035751
강북구,1509, 서울북부수도사업소,201904,460,522,982,37.634377,127.035751
강북구,1509, 서울북부수도사업소,201905,687,797,1484,37.634377,127.035751
강북구,1509, 서울북부수도사업소,201906,900,993,1893,37.634377,127.035751
강북구,1509, 서울북부수도사업소,201907,949,1029,1978,37.634377,127.035751
강북구,1509, 서울북부수도사업소,201908,942,1004,1946,37.634377,127.035751
강북구,1509, 서울북부수도사업소,201909,1070,1155,2225,37.634377,127.035751
강북구,1509, 서울북부수도사업소,201910,1132,1162,2294,37.634377,127.035751
강북구,1509, 서울북부수도사업소,201911,750,793,1543,37.634377,127.035751
강북구,1509, 서울북부수도사업소,201912,443,458,901,37.634377,127.035751
강북구,1509, 서울북부수도사업소,202001,365,368,733,37.634377,127.035751
강북구,1509, 서울북부수도사업소,202002,434,432,866,37.634377,127.035751
강북구,1509, 서울북부수도사업소,202003,826,819,1645,37.634377,127.035751
강북구,1509, 서울북부수도사업소,202004,1213,1195,2408,37.634377,127.035751
강북구,1509, 서울북부수도사업소,202005,1242,1254,2496,37.634377,127.035751
강북구,1509, 서울북부수도사업소,202006,1244,1331,2575,37.634377,127.035751
강북구,1510, 번동주공5단지 관리사무소 앞,201901,114,102,216,37.633717,127.035515
강북구,1510, 번동주공5단지 관리사무소 앞,201902,105,100,205,37.633717,127.035515
강북구,1510, 번동주공5단지 관리사무소 앞,201903,156,174,330,37.633717,127.035515
강북구,1510, 번동주공5단지 관리사무소 앞,201904,228,207,435,37.633717,127.035515
강북구,1510, 번동주공5단지 관리사무소 앞,201905,300,331,631,37.633717,127.035515
강북구,1510, 번동주공5단지 관리사무소 앞,201906,307,334,641,37.633717,127.035515
강북구,1510, 번동주공5단지 관리사무소 앞,201907,309,347,656,37.633717,127.035515
강북구,1510, 번동주공5단지 관리사무소 앞,201908,296,353,649,37.633717,127.035515
강북구,1510, 번동주공5단지 관리사무소 앞,201909,267,275,542,37.633717,127.035515
강북구,1510, 번동주공5단지 관리사무소 앞,201910,274,279,553,37.633717,127.035515
강북구,1510, 번동주공5단지 관리사무소 앞,201911,209,211,420,37.633717,127.035515
강북구,1510, 번동주공5단지 관리사무소 앞,201912,168,196,364,37.633717,127.035515
강북구,1510, 번동주공5단지 관리사무소 앞,202001,128,132,260,37.633717,127.035515
강북구,1510, 번동주공5단지 관리사무소 앞,202002,122,144,266,37.633717,127.035515
강북구,1510, 번동주공5단지 관리사무소 앞,202003,222,220,442,37.633717,127.035515
강북구,1510, 번동주공5단지 관리사무소 앞,202004,282,252,534,37.633717,127.035515
강북구,1510, 번동주공5단지 관리사무소 앞,202005,383,369,752,37.633717,127.035515
강북구,1510, 번동주공5단지 관리사무소 앞,202006,391,367,758,37.633717,127.035515
강북구,1511, 번동 금호어울림아파트102동앞,201901,59,66,125,37.631123,127.036034
강북구,1511, 번동 금호어울림아파트102동앞,201902,63,63,126,37.631123,127.036034
강북구,1511, 번동 금호어울림아파트102동앞,201903,111,120,231,37.631123,127.036034
강북구,1511, 번동 금호어울림아파트102동앞,201904,181,204,385,37.631123,127.036034
강북구,1511, 번동 금호어울림아파트102동앞,201905,235,297,532,37.631123,127.036034
강북구,1511, 번동 금호어울림아파트102동앞,201906,264,334,598,37.631123,127.036034
강북구,1511, 번동 금호어울림아파트102동앞,201907,303,372,675,37.631123,127.036034
강북구,1511, 번동 금호어울림아파트102동앞,201908,307,381,688,37.631123,127.036034
강북구,1511, 번동 금호어울림아파트102동앞,201909,293,378,671,37.631123,127.036034
강북구,1511, 번동 금호어울림아파트102동앞,201910,292,327,619,37.631123,127.036034
강북구,1511, 번동 금호어울림아파트102동앞,201911,267,300,567,37.631123,127.036034
강북구,1511, 번동 금호어울림아파트102동앞,201912,113,146,259,37.631123,127.036034
강북구,1511, 번동 금호어울림아파트102동앞,202001,105,118,223,37.631123,127.036034
강북구,1511, 번동 금호어울림아파트102동앞,202002,102,108,210,37.631123,127.036034
강북구,1511, 번동 금호어울림아파트102동앞,202003,179,182,361,37.631123,127.036034
강북구,1511, 번동 금호어울림아파트102동앞,202004,260,261,521,37.631123,127.036034
강북구,1511, 번동 금호어울림아파트102동앞,202005,306,310,616,37.631123,127.036034
강북구,1511, 번동 금호어울림아파트102동앞,202006,404,441,845,37.631123,127.036034
강북구,1512, 강북중학교 앞,201901,257,278,535,37.644737,127.026566
강북구,1512, 강북중학교 앞,201902,349,313,662,37.644737,127.026566
강북구,1512, 강북중학교 앞,201903,460,481,941,37.644737,127.026566
강북구,1512, 강북중학교 앞,201904,788,890,1678,37.644737,127.026566
강북구,1512, 강북중학교 앞,201905,1174,1285,2459,37.644737,127.026566
강북구,1512, 강북중학교 앞,201906,1283,1345,2628,37.644737,127.026566
강북구,1512, 강북중학교 앞,201907,1243,1277,2520,37.644737,127.026566
강북구,1512, 강북중학교 앞,201908,1186,1203,2389,37.644737,127.026566
강북구,1512, 강북중학교 앞,201909,1391,1406,2797,37.644737,127.026566
강북구,1512, 강북중학교 앞,201910,1520,1525,3045,37.644737,127.026566
강북구,1512, 강북중학교 앞,201911,749,722,1471,37.644737,127.026566
강북구,1512, 강북중학교 앞,201912,362,306,668,37.644737,127.026566
강북구,1512, 강북중학교 앞,202001,355,383,738,37.644737,127.026566
강북구,1512, 강북중학교 앞,202002,412,413,825,37.644737,127.026566
강북구,1512, 강북중학교 앞,202003,1260,1267,2527,37.644737,127.026566
강북구,1512, 강북중학교 앞,202004,2098,2103,4201,37.644737,127.026566
강북구,1512, 강북중학교 앞,202005,2001,1980,3981,37.644737,127.026566
강북구,1512, 강북중학교 앞,202006,2223,2231,4454,37.644737,127.026566
강북구,1513, 강북구청 뒷편,201901,95,95,190,37.639648,127.025124
강북구,1513, 강북구청 뒷편,201902,125,111,236,37.639648,127.025124
강북구,1513, 강북구청 뒷편,201903,205,231,436,37.639648,127.025124
강북구,1513, 강북구청 뒷편,201904,383,303,686,37.639648,127.025124
강북구,1513, 강북구청 뒷편,201905,637,441,1078,37.639648,127.025124
강북구,1513, 강북구청 뒷편,201906,555,446,1001,37.639648,127.025124
강북구,1513, 강북구청 뒷편,201907,470,456,926,37.639648,127.025124
강북구,1513, 강북구청 뒷편,201908,443,424,867,37.639648,127.025124
강북구,1513, 강북구청 뒷편,201909,409,406,815,37.639648,127.025124
강북구,1513, 강북구청 뒷편,201910,422,423,845,37.639648,127.025124
강북구,1513, 강북구청 뒷편,201911,303,302,605,37.639648,127.025124
강북구,1513, 강북구청 뒷편,201912,189,187,376,37.639648,127.025124
강북구,1513, 강북구청 뒷편,202001,211,204,415,37.639648,127.025124
강북구,1513, 강북구청 뒷편,202002,181,182,363,37.639648,127.025124
강북구,1513, 강북구청 뒷편,202003,370,374,744,37.639648,127.025124
강북구,1513, 강북구청 뒷편,202004,431,428,859,37.639648,127.025124
강북구,1513, 강북구청 뒷편,202005,419,421,840,37.639648,127.025124
강북구,1513, 강북구청 뒷편,202006,374,372,746,37.639648,127.025124
강북구,1514, 강북구청 사거리 버스정류소 앞,201901,352,392,744,37.638805,127.028358
강북구,1514, 강북구청 사거리 버스정류소 앞,201902,315,374,689,37.638805,127.028358
강북구,1514, 강북구청 사거리 버스정류소 앞,201903,766,814,1580,37.638805,127.028358
강북구,1514, 강북구청 사거리 버스정류소 앞,201904,1196,1210,2406,37.638805,127.028358
강북구,1514, 강북구청 사거리 버스정류소 앞,201905,1904,1910,3814,37.638805,127.028358
강북구,1514, 강북구청 사거리 버스정류소 앞,201906,1945,1994,3939,37.638805,127.028358
강북구,1514, 강북구청 사거리 버스정류소 앞,201907,1847,1862,3709,37.638805,127.028358
강북구,1514, 강북구청 사거리 버스정류소 앞,201908,1799,1827,3626,37.638805,127.028358
강북구,1514, 강북구청 사거리 버스정류소 앞,201909,1745,1729,3474,37.638805,127.028358
강북구,1514, 강북구청 사거리 버스정류소 앞,201910,2014,2025,4039,37.638805,127.028358
강북구,1514, 강북구청 사거리 버스정류소 앞,201911,1438,1426,2864,37.638805,127.028358
강북구,1514, 강북구청 사거리 버스정류소 앞,201912,851,852,1703,37.638805,127.028358
강북구,1514, 강북구청 사거리 버스정류소 앞,202001,722,731,1453,37.638805,127.028358
강북구,1514, 강북구청 사거리 버스정류소 앞,202002,757,776,1533,37.638805,127.028358
강북구,1514, 강북구청 사거리 버스정류소 앞,202003,1526,1570,3096,37.638805,127.028358
강북구,1514, 강북구청 사거리 버스정류소 앞,202004,2109,2097,4206,37.638805,127.028358
강북구,1514, 강북구청 사거리 버스정류소 앞,202005,2445,2453,4898,37.638805,127.028358
강북구,1514, 강북구청 사거리 버스정류소 앞,202006,2753,2796,5549,37.638805,127.028358
강북구,1515, 송천동 주민센터,201901,170,151,321,37.618286,127.024048
강북구,1515, 송천동 주민센터,201902,166,135,301,37.618286,127.024048
강북구,1515, 송천동 주민센터,201903,336,289,625,37.618286,127.024048
강북구,1515, 송천동 주민센터,201904,442,399,841,37.618286,127.024048
강북구,1515, 송천동 주민센터,201905,582,663,1245,37.618286,127.024048
강북구,1515, 송천동 주민센터,201906,720,762,1482,37.618286,127.024048
강북구,1515, 송천동 주민센터,201907,648,664,1312,37.618286,127.024048
강북구,1515, 송천동 주민센터,201908,690,713,1403,37.618286,127.024048
강북구,1515, 송천동 주민센터,201909,643,651,1294,37.618286,127.024048
강북구,1515, 송천동 주민센터,201910,712,728,1440,37.618286,127.024048
강북구,1515, 송천동 주민센터,201911,538,513,1051,37.618286,127.024048
강북구,1515, 송천동 주민센터,201912,334,329,663,37.618286,127.024048
강북구,1515, 송천동 주민센터,202001,276,284,560,37.618286,127.024048
강북구,1515, 송천동 주민센터,202002,313,288,601,37.618286,127.024048
강북구,1515, 송천동 주민센터,202003,556,553,1109,37.618286,127.024048
강북구,1515, 송천동 주민센터,202004,854,857,1711,37.618286,127.024048
강북구,1515, 송천동 주민센터,202005,1000,1015,2015,37.618286,127.024048
강북구,1515, 송천동 주민센터,202006,1058,1044,2102,37.618286,127.024048
강북구,1516, 우이초등학교 후문 옆,201901,167,125,292,37.638706,127.015907
강북구,1516, 우이초등학교 후문 옆,201902,144,91,235,37.638706,127.015907
강북구,1516, 우이초등학교 후문 옆,201903,248,200,448,37.638706,127.015907
강북구,1516, 우이초등학교 후문 옆,201904,400,323,723,37.638706,127.015907
강북구,1516, 우이초등학교 후문 옆,201905,687,657,1344,37.638706,127.015907
강북구,1516, 우이초등학교 후문 옆,201906,722,663,1385,37.638706,127.015907
강북구,1516, 우이초등학교 후문 옆,201907,678,629,1307,37.638706,127.015907
강북구,1516, 우이초등학교 후문 옆,201908,677,589,1266,37.638706,127.015907
강북구,1516, 우이초등학교 후문 옆,201909,631,587,1218,37.638706,127.015907
강북구,1516, 우이초등학교 후문 옆,201910,696,638,1334,37.638706,127.015907
강북구,1516, 우이초등학교 후문 옆,201911,489,455,944,37.638706,127.015907
강북구,1516, 우이초등학교 후문 옆,201912,275,240,515,37.638706,127.015907
강북구,1516, 우이초등학교 후문 옆,202001,239,215,454,37.638706,127.015907
강북구,1516, 우이초등학교 후문 옆,202002,231,211,442,37.638706,127.015907
강북구,1516, 우이초등학교 후문 옆,202003,430,424,854,37.638706,127.015907
강북구,1516, 우이초등학교 후문 옆,202004,607,609,1216,37.638706,127.015907
강북구,1516, 우이초등학교 후문 옆,202005,732,709,1441,37.638706,127.015907
강북구,1516, 우이초등학교 후문 옆,202006,933,905,1838,37.638706,127.015907
강북구,1518, SK telecom(수유직영점) 앞,201901,200,222,422,37.643085,127.016167
강북구,1518, SK telecom(수유직영점) 앞,201902,117,138,255,37.643085,127.016167
강북구,1518, SK telecom(수유직영점) 앞,201903,252,239,491,37.643085,127.016167
강북구,1518, SK telecom(수유직영점) 앞,201904,385,357,742,37.643085,127.016167
강북구,1518, SK telecom(수유직영점) 앞,201905,548,512,1060,37.643085,127.016167
강북구,1518, SK telecom(수유직영점) 앞,201906,702,678,1380,37.643085,127.016167
강북구,1518, SK telecom(수유직영점) 앞,201907,681,680,1361,37.643085,127.016167
강북구,1518, SK telecom(수유직영점) 앞,201908,673,669,1342,37.643085,127.016167
강북구,1518, SK telecom(수유직영점) 앞,201909,608,585,1193,37.643085,127.016167
강북구,1518, SK telecom(수유직영점) 앞,201910,593,585,1178,37.643085,127.016167
강북구,1518, SK telecom(수유직영점) 앞,201911,409,392,801,37.643085,127.016167
강북구,1518, SK telecom(수유직영점) 앞,201912,324,326,650,37.643085,127.016167
강북구,1518, SK telecom(수유직영점) 앞,202001,352,327,679,37.643085,127.016167
강북구,1518, SK telecom(수유직영점) 앞,202002,305,264,569,37.643085,127.016167
강북구,1518, SK telecom(수유직영점) 앞,202003,413,373,786,37.643085,127.016167
강북구,1518, SK telecom(수유직영점) 앞,202004,479,462,941,37.643085,127.016167
강북구,1518, SK telecom(수유직영점) 앞,202005,632,617,1249,37.643085,127.016167
강북구,1518, SK telecom(수유직영점) 앞,202006,755,737,1492,37.643085,127.016167
강북구,1519, 세븐일레븐 수유장미원점 앞,201901,122,97,219,37.645451,127.015617
강북구,1519, 세븐일레븐 수유장미원점 앞,201902,99,119,218,37.645451,127.015617
강북구,1519, 세븐일레븐 수유장미원점 앞,201903,254,253,507,37.645451,127.015617
강북구,1519, 세븐일레븐 수유장미원점 앞,201904,353,357,710,37.645451,127.015617
강북구,1519, 세븐일레븐 수유장미원점 앞,201905,618,668,1286,37.645451,127.015617
강북구,1519, 세븐일레븐 수유장미원점 앞,201906,713,794,1507,37.645451,127.015617
강북구,1519, 세븐일레븐 수유장미원점 앞,201907,740,780,1520,37.645451,127.015617
강북구,1519, 세븐일레븐 수유장미원점 앞,201908,705,771,1476,37.645451,127.015617
강북구,1519, 세븐일레븐 수유장미원점 앞,201909,801,823,1624,37.645451,127.015617
강북구,1519, 세븐일레븐 수유장미원점 앞,201910,832,881,1713,37.645451,127.015617
강북구,1519, 세븐일레븐 수유장미원점 앞,201911,549,568,1117,37.645451,127.015617
강북구,1519, 세븐일레븐 수유장미원점 앞,201912,363,388,751,37.645451,127.015617
강북구,1519, 세븐일레븐 수유장미원점 앞,202001,361,339,700,37.645451,127.015617
강북구,1519, 세븐일레븐 수유장미원점 앞,202002,341,335,676,37.645451,127.015617
강북구,1519, 세븐일레븐 수유장미원점 앞,202003,482,495,977,37.645451,127.015617
강북구,1519, 세븐일레븐 수유장미원점 앞,202004,720,720,1440,37.645451,127.015617
강북구,1519, 세븐일레븐 수유장미원점 앞,202005,910,891,1801,37.645451,127.015617
강북구,1519, 세븐일레븐 수유장미원점 앞,202006,928,950,1878,37.645451,127.015617
강북구,1520, 성실교회,201901,187,211,398,37.639862,127.022789
강북구,1520, 성실교회,201902,171,259,430,37.639862,127.022789
강북구,1520, 성실교회,201903,394,440,834,37.639862,127.022789
강북구,1520, 성실교회,201904,601,587,1188,37.639862,127.022789
강북구,1520, 성실교회,201905,1111,1100,2211,37.639862,127.022789
강북구,1520, 성실교회,201906,1265,1269,2534,37.639862,127.022789
강북구,1520, 성실교회,201907,1196,1157,2353,37.639862,127.022789
강북구,1520, 성실교회,201908,1061,1044,2105,37.639862,127.022789
강북구,1520, 성실교회,201909,1071,1031,2102,37.639862,127.022789
강북구,1520, 성실교회,201910,1126,1090,2216,37.639862,127.022789
강북구,1520, 성실교회,201911,715,653,1368,37.639862,127.022789
강북구,1520, 성실교회,201912,392,408,800,37.639862,127.022789
강북구,1520, 성실교회,202001,387,381,768,37.639862,127.022789
강북구,1520, 성실교회,202002,304,330,634,37.639862,127.022789
강북구,1520, 성실교회,202003,542,534,1076,37.639862,127.022789
강북구,1520, 성실교회,202004,917,892,1809,37.639862,127.022789
강북구,1520, 성실교회,202005,1097,1060,2157,37.639862,127.022789
강북구,1520, 성실교회,202006,1315,1294,2609,37.639862,127.022789
강북구,1522, 월드전기조명인테리어(우이동),201901,90,71,161,37.654472,127.012756
강북구,1522, 월드전기조명인테리어(우이동),201902,81,72,153,37.654472,127.012756
강북구,1522, 월드전기조명인테리어(우이동),201903,176,128,304,37.654472,127.012756
강북구,1522, 월드전기조명인테리어(우이동),201904,235,210,445,37.654472,127.012756
강북구,1522, 월드전기조명인테리어(우이동),201905,277,312,589,37.654472,127.012756
강북구,1522, 월드전기조명인테리어(우이동),201906,400,361,761,37.654472,127.012756
강북구,1522, 월드전기조명인테리어(우이동),201907,383,346,729,37.654472,127.012756
강북구,1522, 월드전기조명인테리어(우이동),201908,378,346,724,37.654472,127.012756
강북구,1522, 월드전기조명인테리어(우이동),201909,476,457,933,37.654472,127.012756
강북구,1522, 월드전기조명인테리어(우이동),201910,461,400,861,37.654472,127.012756
강북구,1522, 월드전기조명인테리어(우이동),201911,297,224,521,37.654472,127.012756
강북구,1522, 월드전기조명인테리어(우이동),201912,182,143,325,37.654472,127.012756
강북구,1522, 월드전기조명인테리어(우이동),202001,196,136,332,37.654472,127.012756
강북구,1522, 월드전기조명인테리어(우이동),202002,205,166,371,37.654472,127.012756
강북구,1522, 월드전기조명인테리어(우이동),202003,378,282,660,37.654472,127.012756
강북구,1522, 월드전기조명인테리어(우이동),202004,475,396,871,37.654472,127.012756
강북구,1522, 월드전기조명인테리어(우이동),202005,590,534,1124,37.654472,127.012756
강북구,1522, 월드전기조명인테리어(우이동),202006,580,492,1072,37.654472,127.012756
강북구,1525, 미아동 복합청사,201901,145,114,259,37.62714,127.026695
강북구,1525, 미아동 복합청사,201902,99,94,193,37.62714,127.026695
강북구,1525, 미아동 복합청사,201903,264,206,470,37.62714,127.026695
강북구,1525, 미아동 복합청사,201904,389,368,757,37.62714,127.026695
강북구,1525, 미아동 복합청사,201905,567,456,1023,37.62714,127.026695
강북구,1525, 미아동 복합청사,201906,597,513,1110,37.62714,127.026695
강북구,1525, 미아동 복합청사,201907,489,460,949,37.62714,127.026695
강북구,1525, 미아동 복합청사,201908,572,519,1091,37.62714,127.026695
강북구,1525, 미아동 복합청사,201909,392,376,768,37.62714,127.026695
강북구,1525, 미아동 복합청사,201910,452,424,876,37.62714,127.026695
강북구,1525, 미아동 복합청사,201911,327,299,626,37.62714,127.026695
강북구,1525, 미아동 복합청사,201912,218,172,390,37.62714,127.026695
강북구,1525, 미아동 복합청사,202001,194,157,351,37.62714,127.026695
강북구,1525, 미아동 복합청사,202002,189,145,334,37.62714,127.026695
강북구,1525, 미아동 복합청사,202003,348,304,652,37.62714,127.026695
강북구,1525, 미아동 복합청사,202004,536,522,1058,37.62714,127.026695
강북구,1525, 미아동 복합청사,202005,498,459,957,37.62714,127.026695
강북구,1525, 미아동 복합청사,202006,601,567,1168,37.62714,127.026695
강북구,1526, 수유동 채선당앞,201901,162,172,334,37.641739,127.024628
강북구,1526, 수유동 채선당앞,201902,145,146,291,37.641739,127.024628
강북구,1526, 수유동 채선당앞,201903,237,223,460,37.641739,127.024628
강북구,1526, 수유동 채선당앞,201904,397,386,783,37.641739,127.024628
강북구,1526, 수유동 채선당앞,201905,786,704,1490,37.641739,127.024628
강북구,1526, 수유동 채선당앞,201906,790,722,1512,37.641739,127.024628
강북구,1526, 수유동 채선당앞,201907,679,638,1317,37.641739,127.024628
강북구,1526, 수유동 채선당앞,201908,730,701,1431,37.641739,127.024628
강북구,1526, 수유동 채선당앞,201909,805,763,1568,37.641739,127.024628
강북구,1526, 수유동 채선당앞,201910,720,728,1448,37.641739,127.024628
강북구,1526, 수유동 채선당앞,201911,541,523,1064,37.641739,127.024628
강북구,1526, 수유동 채선당앞,201912,350,346,696,37.641739,127.024628
강북구,1526, 수유동 채선당앞,202001,335,320,655,37.641739,127.024628
강북구,1526, 수유동 채선당앞,202002,269,271,540,37.641739,127.024628
강북구,1526, 수유동 채선당앞,202003,427,425,852,37.641739,127.024628
강북구,1526, 수유동 채선당앞,202004,599,568,1167,37.641739,127.024628
강북구,1526, 수유동 채선당앞,202005,678,662,1340,37.641739,127.024628
강북구,1526, 수유동 채선당앞,202006,952,939,1891,37.641739,127.024628
강북구,1527, 미아역 1번 출구 뒤,201901,140,154,294,37.627335,127.026054
강북구,1527, 미아역 1번 출구 뒤,201902,151,147,298,37.627335,127.026054
강북구,1527, 미아역 1번 출구 뒤,201903,307,302,609,37.627335,127.026054
강북구,1527, 미아역 1번 출구 뒤,201904,526,457,983,37.627335,127.026054
강북구,1527, 미아역 1번 출구 뒤,201905,829,850,1679,37.627335,127.026054
강북구,1527, 미아역 1번 출구 뒤,201906,995,985,1980,37.627335,127.026054
강북구,1527, 미아역 1번 출구 뒤,201907,979,909,1888,37.627335,127.026054
강북구,1527, 미아역 1번 출구 뒤,201908,940,905,1845,37.627335,127.026054
강북구,1527, 미아역 1번 출구 뒤,201909,786,781,1567,37.627335,127.026054
강북구,1527, 미아역 1번 출구 뒤,201910,876,871,1747,37.627335,127.026054
강북구,1527, 미아역 1번 출구 뒤,201911,690,668,1358,37.627335,127.026054
강북구,1527, 미아역 1번 출구 뒤,201912,414,408,822,37.627335,127.026054
강북구,1527, 미아역 1번 출구 뒤,202001,394,347,741,37.627335,127.026054
강북구,1527, 미아역 1번 출구 뒤,202002,347,308,655,37.627335,127.026054
강북구,1527, 미아역 1번 출구 뒤,202003,573,575,1148,37.627335,127.026054
강북구,1527, 미아역 1번 출구 뒤,202004,751,724,1475,37.627335,127.026054
강북구,1527, 미아역 1번 출구 뒤,202005,842,821,1663,37.627335,127.026054
강북구,1527, 미아역 1번 출구 뒤,202006,945,914,1859,37.627335,127.026054
강북구,1528, 삼각산동 주민센터,201901,250,85,335,37.615036,127.020699
강북구,1528, 삼각산동 주민센터,201902,187,70,257,37.615036,127.020699
강북구,1528, 삼각산동 주민센터,201903,357,191,548,37.615036,127.020699
강북구,1528, 삼각산동 주민센터,201904,486,239,725,37.615036,127.020699
강북구,1528, 삼각산동 주민센터,201905,690,373,1063,37.615036,127.020699
강북구,1528, 삼각산동 주민센터,201906,750,362,1112,37.615036,127.020699
강북구,1528, 삼각산동 주민센터,201907,613,323,936,37.615036,127.020699
강북구,1528, 삼각산동 주민센터,201908,554,274,828,37.615036,127.020699
강북구,1528, 삼각산동 주민센터,201909,517,277,794,37.615036,127.020699
강북구,1528, 삼각산동 주민센터,201910,653,362,1015,37.615036,127.020699
강북구,1528, 삼각산동 주민센터,201911,499,256,755,37.615036,127.020699
강북구,1528, 삼각산동 주민센터,201912,344,132,476,37.615036,127.020699
강북구,1528, 삼각산동 주민센터,202001,338,138,476,37.615036,127.020699
강북구,1528, 삼각산동 주민센터,202002,348,164,512,37.615036,127.020699
강북구,1528, 삼각산동 주민센터,202003,497,278,775,37.615036,127.020699
강북구,1528, 삼각산동 주민센터,202004,550,447,997,37.615036,127.020699
강북구,1528, 삼각산동 주민센터,202005,525,442,967,37.615036,127.020699
강북구,1528, 삼각산동 주민센터,202006,580,366,946,37.615036,127.020699
강북구,1529, 미아동 한국전력공사,201901,304,394,698,37.63018,127.02491
강북구,1529, 미아동 한국전력공사,201902,277,289,566,37.63018,127.02491
강북구,1529, 미아동 한국전력공사,201903,636,727,1363,37.63018,127.02491
강북구,1529, 미아동 한국전력공사,201904,910,999,1909,37.63018,127.02491
강북구,1529, 미아동 한국전력공사,201905,1476,1483,2959,37.63018,127.02491
강북구,1529, 미아동 한국전력공사,201906,1691,1657,3348,37.63018,127.02491
강북구,1529, 미아동 한국전력공사,201907,1694,1654,3348,37.63018,127.02491
강북구,1529, 미아동 한국전력공사,201908,1671,1667,3338,37.63018,127.02491
강북구,1529, 미아동 한국전력공사,201909,1592,1580,3172,37.63018,127.02491
강북구,1529, 미아동 한국전력공사,201910,1904,1935,3839,37.63018,127.02491
강북구,1529, 미아동 한국전력공사,201911,1297,1320,2617,37.63018,127.02491
강북구,1529, 미아동 한국전력공사,201912,725,767,1492,37.63018,127.02491
강북구,1529, 미아동 한국전력공사,202001,595,612,1207,37.63018,127.02491
강북구,1529, 미아동 한국전력공사,202002,564,545,1109,37.63018,127.02491
강북구,1529, 미아동 한국전력공사,202003,1225,1206,2431,37.63018,127.02491
강북구,1529, 미아동 한국전력공사,202004,1522,1493,3015,37.63018,127.02491
강북구,1529, 미아동 한국전력공사,202005,1661,1637,3298,37.63018,127.02491
강북구,1529, 미아동 한국전력공사,202006,2006,1995,4001,37.63018,127.02491
강북구,1530, 광산사거리,201901,220,283,503,37.643551,127.022346
강북구,1530, 광산사거리,201902,214,260,474,37.643551,127.022346
강북구,1530, 광산사거리,201903,492,489,981,37.643551,127.022346
강북구,1530, 광산사거리,201904,730,711,1441,37.643551,127.022346
강북구,1530, 광산사거리,201905,1282,1190,2472,37.643551,127.022346
강북구,1530, 광산사거리,201906,1474,1407,2881,37.643551,127.022346
강북구,1530, 광산사거리,201907,1484,1382,2866,37.643551,127.022346
강북구,1530, 광산사거리,201908,1472,1394,2866,37.643551,127.022346
강북구,1530, 광산사거리,201909,1435,1339,2774,37.643551,127.022346
강북구,1530, 광산사거리,201910,1513,1471,2984,37.643551,127.022346
강북구,1530, 광산사거리,201911,965,912,1877,37.643551,127.022346
강북구,1530, 광산사거리,201912,564,556,1120,37.643551,127.022346
강북구,1530, 광산사거리,202001,474,473,947,37.643551,127.022346
강북구,1530, 광산사거리,202002,474,465,939,37.643551,127.022346
강북구,1530, 광산사거리,202003,976,997,1973,37.643551,127.022346
강북구,1530, 광산사거리,202004,1332,1331,2663,37.643551,127.022346
강북구,1530, 광산사거리,202005,1759,1728,3487,37.643551,127.022346
강북구,1530, 광산사거리,202006,2017,2017,4034,37.643551,127.022346
강북구,1531, 미아사거리 1번 출구,201901,460,621,1081,37.613956,127.030251
강북구,1531, 미아사거리 1번 출구,201902,417,514,931,37.613956,127.030251
강북구,1531, 미아사거리 1번 출구,201903,898,1095,1993,37.613956,127.030251
강북구,1531, 미아사거리 1번 출구,201904,1535,1710,3245,37.613956,127.030251
강북구,1531, 미아사거리 1번 출구,201905,2615,2800,5415,37.613956,127.030251
강북구,1531, 미아사거리 1번 출구,201906,2822,3049,5871,37.613956,127.030251
강북구,1531, 미아사거리 1번 출구,201907,2539,2712,5251,37.613956,127.030251
강북구,1531, 미아사거리 1번 출구,201908,2298,2447,4745,37.613956,127.030251
강북구,1531, 미아사거리 1번 출구,201909,2387,2547,4934,37.613956,127.030251
강북구,1531, 미아사거리 1번 출구,201910,2889,3034,5923,37.613956,127.030251
강북구,1531, 미아사거리 1번 출구,201911,1718,1858,3576,37.613956,127.030251
강북구,1531, 미아사거리 1번 출구,201912,923,1041,1964,37.613956,127.030251
강북구,1531, 미아사거리 1번 출구,202001,759,881,1640,37.613956,127.030251
강북구,1531, 미아사거리 1번 출구,202002,776,869,1645,37.613956,127.030251
강북구,1531, 미아사거리 1번 출구,202003,1620,1732,3352,37.613956,127.030251
강북구,1531, 미아사거리 1번 출구,202004,2380,2473,4853,37.613956,127.030251
강북구,1531, 미아사거리 1번 출구,202005,2860,2900,5760,37.613956,127.030251
강북구,1531, 미아사거리 1번 출구,202006,3232,3293,6525,37.613956,127.030251
강북구,1532, 번3동 주민센터 교차로,201901,187,190,377,37.626354,127.047447
강북구,1532, 번3동 주민센터 교차로,201902,142,130,272,37.626354,127.047447
강북구,1532, 번3동 주민센터 교차로,201903,282,304,586,37.626354,127.047447
강북구,1532, 번3동 주민센터 교차로,201904,429,505,934,37.626354,127.047447
강북구,1532, 번3동 주민센터 교차로,201905,630,787,1417,37.626354,127.047447
강북구,1532, 번3동 주민센터 교차로,201906,813,954,1767,37.626354,127.047447
강북구,1532, 번3동 주민센터 교차로,201907,734,960,1694,37.626354,127.047447
강북구,1532, 번3동 주민센터 교차로,201908,740,920,1660,37.626354,127.047447
강북구,1532, 번3동 주민센터 교차로,201909,753,827,1580,37.626354,127.047447
강북구,1532, 번3동 주민센터 교차로,201910,867,976,1843,37.626354,127.047447
강북구,1532, 번3동 주민센터 교차로,201911,553,632,1185,37.626354,127.047447
강북구,1532, 번3동 주민센터 교차로,201912,345,398,743,37.626354,127.047447
강북구,1532, 번3동 주민센터 교차로,202001,318,381,699,37.626354,127.047447
강북구,1532, 번3동 주민센터 교차로,202002,347,395,742,37.626354,127.047447
강북구,1532, 번3동 주민센터 교차로,202003,714,728,1442,37.626354,127.047447
강북구,1532, 번3동 주민센터 교차로,202004,901,942,1843,37.626354,127.047447
강북구,1532, 번3동 주민센터 교차로,202005,1089,1118,2207,37.626354,127.047447
강북구,1532, 번3동 주민센터 교차로,202006,1268,1441,2709,37.626354,127.047447
강북구,1533," 번동 주공3, 4단지 교차로",201901,359,390,749,37.629917,127.040916
강북구,1533," 번동 주공3, 4단지 교차로",201902,332,376,708,37.629917,127.040916
강북구,1533," 번동 주공3, 4단지 교차로",201903,637,687,1324,37.629917,127.040916
강북구,1533," 번동 주공3, 4단지 교차로",201904,866,1170,2036,37.629917,127.040916
강북구,1533," 번동 주공3, 4단지 교차로",201905,1301,1853,3154,37.629917,127.040916
강북구,1533," 번동 주공3, 4단지 교차로",201906,1467,2026,3493,37.629917,127.040916
강북구,1533," 번동 주공3, 4단지 교차로",201907,1401,1838,3239,37.629917,127.040916
강북구,1533," 번동 주공3, 4단지 교차로",201908,1366,1852,3218,37.629917,127.040916
강북구,1533," 번동 주공3, 4단지 교차로",201909,1364,1777,3141,37.629917,127.040916
강북구,1533," 번동 주공3, 4단지 교차로",201910,1456,1994,3450,37.629917,127.040916
강북구,1533," 번동 주공3, 4단지 교차로",201911,921,1256,2177,37.629917,127.040916
강북구,1533," 번동 주공3, 4단지 교차로",201912,603,764,1367,37.629917,127.040916
강북구,1533," 번동 주공3, 4단지 교차로",202001,555,738,1293,37.629917,127.040916
강북구,1533," 번동 주공3, 4단지 교차로",202002,582,738,1320,37.629917,127.040916
강북구,1533," 번동 주공3, 4단지 교차로",202003,1271,1549,2820,37.629917,127.040916
강북구,1533," 번동 주공3, 4단지 교차로",202004,2091,2370,4461,37.629917,127.040916
강북구,1533," 번동 주공3, 4단지 교차로",202005,2488,2757,5245,37.629917,127.040916
강북구,1533," 번동 주공3, 4단지 교차로",202006,2405,2798,5203,37.629917,127.040916
강북구,1534, 북서울 꿈의 숲 동문,201901,103,96,199,37.619637,127.044533
강북구,1534, 북서울 꿈의 숲 동문,201902,153,160,313,37.619637,127.044533
강북구,1534, 북서울 꿈의 숲 동문,201903,292,356,648,37.619637,127.044533
강북구,1534, 북서울 꿈의 숲 동문,201904,781,936,1717,37.619637,127.044533
강북구,1534, 북서울 꿈의 숲 동문,201905,1081,1277,2358,37.619637,127.044533
강북구,1534, 북서울 꿈의 숲 동문,201906,796,1059,1855,37.619637,127.044533
강북구,1534, 북서울 꿈의 숲 동문,201907,677,742,1419,37.619637,127.044533
강북구,1534, 북서울 꿈의 숲 동문,201908,686,747,1433,37.619637,127.044533
강북구,1534, 북서울 꿈의 숲 동문,201909,827,908,1735,37.619637,127.044533
강북구,1534, 북서울 꿈의 숲 동문,201910,846,901,1747,37.619637,127.044533
강북구,1534, 북서울 꿈의 숲 동문,201911,392,451,843,37.619637,127.044533
강북구,1534, 북서울 꿈의 숲 동문,201912,168,206,374,37.619637,127.044533
강북구,1534, 북서울 꿈의 숲 동문,202001,188,216,404,37.619637,127.044533
강북구,1534, 북서울 꿈의 숲 동문,202002,251,325,576,37.619637,127.044533
강북구,1534, 북서울 꿈의 숲 동문,202003,1146,1172,2318,37.619637,127.044533
강북구,1534, 북서울 꿈의 숲 동문,202004,1863,1883,3746,37.619637,127.044533
강북구,1534, 북서울 꿈의 숲 동문,202005,1741,1776,3517,37.619637,127.044533
강북구,1534, 북서울 꿈의 숲 동문,202006,1538,1618,3156,37.619637,127.044533
강북구,1535, 효성인텔리안 앞,201901,479,578,1057,37.636292,127.023376
강북구,1535, 효성인텔리안 앞,201902,482,534,1016,37.636292,127.023376
강북구,1535, 효성인텔리안 앞,201903,1022,1128,2150,37.636292,127.023376
강북구,1535, 효성인텔리안 앞,201904,1509,1605,3114,37.636292,127.023376
강북구,1535, 효성인텔리안 앞,201905,2655,2831,5486,37.636292,127.023376
강북구,1535, 효성인텔리안 앞,201906,2890,3005,5895,37.636292,127.023376
강북구,1535, 효성인텔리안 앞,201907,2775,2809,5584,37.636292,127.023376
강북구,1535, 효성인텔리안 앞,201908,2730,2780,5510,37.636292,127.023376
강북구,1535, 효성인텔리안 앞,201909,2617,2726,5343,37.636292,127.023376
강북구,1535, 효성인텔리안 앞,201910,3105,3231,6336,37.636292,127.023376
강북구,1535, 효성인텔리안 앞,201911,1900,2080,3980,37.636292,127.023376
강북구,1535, 효성인텔리안 앞,201912,1077,1273,2350,37.636292,127.023376
강북구,1535, 효성인텔리안 앞,202001,950,1106,2056,37.636292,127.023376
강북구,1535, 효성인텔리안 앞,202002,921,1068,1989,37.636292,127.023376
강북구,1535, 효성인텔리안 앞,202003,1604,1618,3222,37.636292,127.023376
강북구,1535, 효성인텔리안 앞,202004,2342,2402,4744,37.636292,127.023376
강북구,1535, 효성인텔리안 앞,202005,2811,2871,5682,37.636292,127.023376
강북구,1535, 효성인텔리안 앞,202006,3111,3213,6324,37.636292,127.023376
강북구,1536, 번동 두산위브 101동 옆,201901,163,143,306,37.636261,127.032173
강북구,1536, 번동 두산위브 101동 옆,201902,108,121,229,37.636261,127.032173
강북구,1536, 번동 두산위브 101동 옆,201903,311,301,612,37.636261,127.032173
강북구,1536, 번동 두산위브 101동 옆,201904,552,595,1147,37.636261,127.032173
강북구,1536, 번동 두산위브 101동 옆,201905,1067,1040,2107,37.636261,127.032173
강북구,1536, 번동 두산위브 101동 옆,201906,1164,1149,2313,37.636261,127.032173
강북구,1536, 번동 두산위브 101동 옆,201907,1333,1222,2555,37.636261,127.032173
강북구,1536, 번동 두산위브 101동 옆,201908,1238,1175,2413,37.636261,127.032173
강북구,1536, 번동 두산위브 101동 옆,201909,1274,1262,2536,37.636261,127.032173
강북구,1536, 번동 두산위브 101동 옆,201910,1350,1344,2694,37.636261,127.032173
강북구,1536, 번동 두산위브 101동 옆,201911,848,792,1640,37.636261,127.032173
강북구,1536, 번동 두산위브 101동 옆,201912,510,477,987,37.636261,127.032173
강북구,1536, 번동 두산위브 101동 옆,202001,481,445,926,37.636261,127.032173
강북구,1536, 번동 두산위브 101동 옆,202002,432,405,837,37.636261,127.032173
강북구,1536, 번동 두산위브 101동 옆,202003,828,808,1636,37.636261,127.032173
강북구,1536, 번동 두산위브 101동 옆,202004,1301,1255,2556,37.636261,127.032173
강북구,1536, 번동 두산위브 101동 옆,202005,1385,1273,2658,37.636261,127.032173
강북구,1536, 번동 두산위브 101동 옆,202006,1566,1463,3029,37.636261,127.032173
강북구,1537, 북한산 우이역,201901,112,92,204,37.663666,127.012428
강북구,1537, 북한산 우이역,201902,113,96,209,37.663666,127.012428
강북구,1537, 북한산 우이역,201903,212,192,404,37.663666,127.012428
강북구,1537, 북한산 우이역,201904,307,271,578,37.663666,127.012428
강북구,1537, 북한산 우이역,201905,475,483,958,37.663666,127.012428
강북구,1537, 북한산 우이역,201906,595,617,1212,37.663666,127.012428
강북구,1537, 북한산 우이역,201907,613,649,1262,37.663666,127.012428
강북구,1537, 북한산 우이역,201908,599,631,1230,37.663666,127.012428
강북구,1537, 북한산 우이역,201909,555,608,1163,37.663666,127.012428
강북구,1537, 북한산 우이역,201910,641,665,1306,37.663666,127.012428
강북구,1537, 북한산 우이역,201911,389,359,748,37.663666,127.012428
강북구,1537, 북한산 우이역,201912,254,213,467,37.663666,127.012428
강북구,1537, 북한산 우이역,202001,224,189,413,37.663666,127.012428
강북구,1537, 북한산 우이역,202002,201,170,371,37.663666,127.012428
강북구,1537, 북한산 우이역,202003,402,385,787,37.663666,127.012428
강북구,1537, 북한산 우이역,202004,675,673,1348,37.663666,127.012428
강북구,1537, 북한산 우이역,202005,846,852,1698,37.663666,127.012428
강북구,1537, 북한산 우이역,202006,995,985,1980,37.663666,127.012428
강북구,1538, 솔밭공원역,201901,201,148,349,37.656158,127.013138
강북구,1538, 솔밭공원역,201902,179,163,342,37.656158,127.013138
강북구,1538, 솔밭공원역,201903,279,245,524,37.656158,127.013138
강북구,1538, 솔밭공원역,201904,400,371,771,37.656158,127.013138
강북구,1538, 솔밭공원역,201905,568,590,1158,37.656158,127.013138
강북구,1538, 솔밭공원역,201906,662,664,1326,37.656158,127.013138
강북구,1538, 솔밭공원역,201907,643,637,1280,37.656158,127.013138
강북구,1538, 솔밭공원역,201908,555,579,1134,37.656158,127.013138
강북구,1538, 솔밭공원역,201909,499,529,1028,37.656158,127.013138
강북구,1538, 솔밭공원역,201910,619,602,1221,37.656158,127.013138
강북구,1538, 솔밭공원역,201911,425,376,801,37.656158,127.013138
강북구,1538, 솔밭공원역,201912,253,211,464,37.656158,127.013138
강북구,1538, 솔밭공원역,202001,268,234,502,37.656158,127.013138
강북구,1538, 솔밭공원역,202002,270,225,495,37.656158,127.013138
강북구,1538, 솔밭공원역,202003,477,457,934,37.656158,127.013138
강북구,1538, 솔밭공원역,202004,610,570,1180,37.656158,127.013138
강북구,1538, 솔밭공원역,202005,799,760,1559,37.656158,127.013138
강북구,1538, 솔밭공원역,202006,833,766,1599,37.656158,127.013138
강북구,1539,4,201901,233,238,471,37.649673,127.013451
강북구,1539,4,201902,218,212,430,37.649673,127.013451
강북구,1539,4,201903,530,558,1088,37.649673,127.013451
강북구,1539,4,201904,892,976,1868,37.649673,127.013451
강북구,1539,4,201905,1560,1712,3272,37.649673,127.013451
강북구,1539,4,201906,1522,1567,3089,37.649673,127.013451
강북구,1539,4,201907,1374,1409,2783,37.649673,127.013451
강북구,1539,4,201908,1481,1548,3029,37.649673,127.013451
강북구,1539,4,201909,1595,1630,3225,37.649673,127.013451
강북구,1539,4,201910,1635,1677,3312,37.649673,127.013451
강북구,1539,4,201911,859,881,1740,37.649673,127.013451
강북구,1539,4,201912,439,439,878,37.649673,127.013451
강북구,1539,4,202001,512,516,1028,37.649673,127.013451
강북구,1539,4,202002,477,480,957,37.649673,127.013451
강북구,1539,4,202003,1056,1067,2123,37.649673,127.013451
강북구,1539,4,202004,1644,1634,3278,37.649673,127.013451
강북구,1539,4,202005,1949,1948,3897,37.649673,127.013451
강북구,1539,4,202006,1949,1896,3845,37.649673,127.013451
강북구,1540, 가오리역,201901,219,184,403,37.64167,127.016884
강북구,1540, 가오리역,201902,172,187,359,37.64167,127.016884
강북구,1540, 가오리역,201903,368,370,738,37.64167,127.016884
강북구,1540, 가오리역,201904,469,477,946,37.64167,127.016884
강북구,1540, 가오리역,201905,742,796,1538,37.64167,127.016884
강북구,1540, 가오리역,201906,867,865,1732,37.64167,127.016884
강북구,1540, 가오리역,201907,950,955,1905,37.64167,127.016884
강북구,1540, 가오리역,201908,899,891,1790,37.64167,127.016884
강북구,1540, 가오리역,201909,868,851,1719,37.64167,127.016884
강북구,1540, 가오리역,201910,1015,979,1994,37.64167,127.016884
강북구,1540, 가오리역,201911,625,629,1254,37.64167,127.016884
강북구,1540, 가오리역,201912,419,415,834,37.64167,127.016884
강북구,1540, 가오리역,202001,393,379,772,37.64167,127.016884
강북구,1540, 가오리역,202002,344,323,667,37.64167,127.016884
강북구,1540, 가오리역,202003,639,602,1241,37.64167,127.016884
강북구,1540, 가오리역,202004,829,824,1653,37.64167,127.016884
강북구,1540, 가오리역,202005,1069,1041,2110,37.64167,127.016884
강북구,1540, 가오리역,202006,1188,1171,2359,37.64167,127.016884
강북구,1541, 삼양역,201901,75,45,120,37.62653,127.018059
강북구,1541, 삼양역,201902,86,66,152,37.62653,127.018059
강북구,1541, 삼양역,201903,191,117,308,37.62653,127.018059
강북구,1541, 삼양역,201904,269,188,457,37.62653,127.018059
강북구,1541, 삼양역,201905,544,401,945,37.62653,127.018059
강북구,1541, 삼양역,201906,495,330,825,37.62653,127.018059
강북구,1541, 삼양역,201907,407,297,704,37.62653,127.018059
강북구,1541, 삼양역,201908,354,245,599,37.62653,127.018059
강북구,1541, 삼양역,201909,312,229,541,37.62653,127.018059
강북구,1541, 삼양역,201910,307,225,532,37.62653,127.018059
강북구,1541, 삼양역,201911,251,159,410,37.62653,127.018059
강북구,1541, 삼양역,201912,214,113,327,37.62653,127.018059
강북구,1541, 삼양역,202001,181,88,269,37.62653,127.018059
강북구,1541, 삼양역,202002,174,72,246,37.62653,127.018059
강북구,1541, 삼양역,202003,234,142,376,37.62653,127.018059
강북구,1541, 삼양역,202004,229,211,440,37.62653,127.018059
강북구,1541, 삼양역,202005,234,218,452,37.62653,127.018059
강북구,1541, 삼양역,202006,293,218,511,37.62653,127.018059
강북구,1542, 삼양사거리역,201901,113,74,187,37.621552,127.02037
강북구,1542, 삼양사거리역,201902,122,97,219,37.621552,127.02037
강북구,1542, 삼양사거리역,201903,177,132,309,37.621552,127.02037
강북구,1542, 삼양사거리역,201904,315,216,531,37.621552,127.02037
강북구,1542, 삼양사거리역,201905,535,493,1028,37.621552,127.02037
강북구,1542, 삼양사거리역,201906,578,530,1108,37.621552,127.02037
강북구,1542, 삼양사거리역,201907,489,450,939,37.621552,127.02037
강북구,1542, 삼양사거리역,201908,451,412,863,37.621552,127.02037
강북구,1542, 삼양사거리역,201909,409,388,797,37.621552,127.02037
강북구,1542, 삼양사거리역,201910,492,489,981,37.621552,127.02037
강북구,1542, 삼양사거리역,201911,347,318,665,37.621552,127.02037
강북구,1542, 삼양사거리역,201912,196,171,367,37.621552,127.02037
강북구,1542, 삼양사거리역,202001,187,149,336,37.621552,127.02037
강북구,1542, 삼양사거리역,202002,178,151,329,37.621552,127.02037
강북구,1542, 삼양사거리역,202003,377,338,715,37.621552,127.02037
강북구,1542, 삼양사거리역,202004,479,475,954,37.621552,127.02037
강북구,1542, 삼양사거리역,202005,486,481,967,37.621552,127.02037
강북구,1542, 삼양사거리역,202006,592,553,1145,37.621552,127.02037
강북구,1543, 수유1동 주민센터,201901,137,140,277,37.630188,127.017738
강북구,1543, 수유1동 주민센터,201902,168,140,308,37.630188,127.017738
강북구,1543, 수유1동 주민센터,201903,296,269,565,37.630188,127.017738
강북구,1543, 수유1동 주민센터,201904,375,392,767,37.630188,127.017738
강북구,1543, 수유1동 주민센터,201905,768,767,1535,37.630188,127.017738
강북구,1543, 수유1동 주민센터,201906,809,752,1561,37.630188,127.017738
강북구,1543, 수유1동 주민센터,201907,753,740,1493,37.630188,127.017738
강북구,1543, 수유1동 주민센터,201908,742,714,1456,37.630188,127.017738
강북구,1543, 수유1동 주민센터,201909,660,636,1296,37.630188,127.017738
강북구,1543, 수유1동 주민센터,201910,840,840,1680,37.630188,127.017738
강북구,1543, 수유1동 주민센터,201911,513,482,995,37.630188,127.017738
강북구,1543, 수유1동 주민센터,201912,338,330,668,37.630188,127.017738
강북구,1543, 수유1동 주민센터,202001,268,284,552,37.630188,127.017738
강북구,1543, 수유1동 주민센터,202002,224,212,436,37.630188,127.017738
강북구,1543, 수유1동 주민센터,202003,479,472,951,37.630188,127.017738
강북구,1543, 수유1동 주민센터,202004,770,764,1534,37.630188,127.017738
강북구,1543, 수유1동 주민센터,202005,814,823,1637,37.630188,127.017738
강북구,1543, 수유1동 주민센터,202006,911,917,1828,37.630188,127.017738
강북구,1545, 솔샘역 2번 출구,201901,176,71,247,37.62038,127.01368
강북구,1545, 솔샘역 2번 출구,201902,150,85,235,37.62038,127.01368
강북구,1545, 솔샘역 2번 출구,201903,281,131,412,37.62038,127.01368
강북구,1545, 솔샘역 2번 출구,201904,388,209,597,37.62038,127.01368
강북구,1545, 솔샘역 2번 출구,201905,519,256,775,37.62038,127.01368
강북구,1545, 솔샘역 2번 출구,201906,506,277,783,37.62038,127.01368
강북구,1545, 솔샘역 2번 출구,201907,415,214,629,37.62038,127.01368
강북구,1545, 솔샘역 2번 출구,201908,372,166,538,37.62038,127.01368
강북구,1545, 솔샘역 2번 출구,201909,320,155,475,37.62038,127.01368
강북구,1545, 솔샘역 2번 출구,201910,410,196,606,37.62038,127.01368
강북구,1545, 솔샘역 2번 출구,201911,292,123,415,37.62038,127.01368
강북구,1545, 솔샘역 2번 출구,201912,201,63,264,37.62038,127.01368
강북구,1545, 솔샘역 2번 출구,202001,158,53,211,37.62038,127.01368
강북구,1545, 솔샘역 2번 출구,202002,125,37,162,37.62038,127.01368
강북구,1545, 솔샘역 2번 출구,202003,257,145,402,37.62038,127.01368
강북구,1545, 솔샘역 2번 출구,202004,349,260,609,37.62038,127.01368
강북구,1545, 솔샘역 2번 출구,202005,302,244,546,37.62038,127.01368
강북구,1545, 솔샘역 2번 출구,202006,330,249,579,37.62038,127.01368
강북구,1546, 송천동우체국,201901,102,131,233,37.615459,127.029701
강북구,1546, 송천동우체국,201902,111,121,232,37.615459,127.029701
강북구,1546, 송천동우체국,201903,249,297,546,37.615459,127.029701
강북구,1546, 송천동우체국,201904,418,466,884,37.615459,127.029701
강북구,1546, 송천동우체국,201905,853,885,1738,37.615459,127.029701
강북구,1546, 송천동우체국,201906,966,986,1952,37.615459,127.029701
강북구,1546, 송천동우체국,201907,799,815,1614,37.615459,127.029701
강북구,1546, 송천동우체국,201908,755,750,1505,37.615459,127.029701
강북구,1546, 송천동우체국,201909,693,704,1397,37.615459,127.029701
강북구,1546, 송천동우체국,201910,931,948,1879,37.615459,127.029701
강북구,1546, 송천동우체국,201911,621,715,1336,37.615459,127.029701
강북구,1546, 송천동우체국,201912,303,400,703,37.615459,127.029701
강북구,1546, 송천동우체국,202001,258,346,604,37.615459,127.029701
강북구,1546, 송천동우체국,202002,252,338,590,37.615459,127.029701
강북구,1546, 송천동우체국,202003,475,493,968,37.615459,127.029701
강북구,1546, 송천동우체국,202004,798,805,1603,37.615459,127.029701
강북구,1546, 송천동우체국,202005,964,960,1924,37.615459,127.029701
강북구,1546, 송천동우체국,202006,982,980,1962,37.615459,127.029701
강북구,1547, 꿈의숲 롯데캐슬,201901,79,57,136,37.618641,127.03624
강북구,1547, 꿈의숲 롯데캐슬,201902,85,43,128,37.618641,127.03624
강북구,1547, 꿈의숲 롯데캐슬,201903,154,93,247,37.618641,127.03624
강북구,1547, 꿈의숲 롯데캐슬,201904,264,176,440,37.618641,127.03624
강북구,1547, 꿈의숲 롯데캐슬,201905,384,233,617,37.618641,127.03624
강북구,1547, 꿈의숲 롯데캐슬,201906,425,263,688,37.618641,127.03624
강북구,1547, 꿈의숲 롯데캐슬,201907,372,245,617,37.618641,127.03624
강북구,1547, 꿈의숲 롯데캐슬,201908,402,239,641,37.618641,127.03624
강북구,1547, 꿈의숲 롯데캐슬,201909,326,198,524,37.618641,127.03624
강북구,1547, 꿈의숲 롯데캐슬,201910,461,305,766,37.618641,127.03624
강북구,1547, 꿈의숲 롯데캐슬,201911,313,201,514,37.618641,127.03624
강북구,1547, 꿈의숲 롯데캐슬,201912,212,137,349,37.618641,127.03624
강북구,1547, 꿈의숲 롯데캐슬,202001,218,129,347,37.618641,127.03624
강북구,1547, 꿈의숲 롯데캐슬,202002,167,106,273,37.618641,127.03624
강북구,1547, 꿈의숲 롯데캐슬,202003,380,285,665,37.618641,127.03624
강북구,1547, 꿈의숲 롯데캐슬,202004,446,340,786,37.618641,127.03624
강북구,1547, 꿈의숲 롯데캐슬,202005,505,407,912,37.618641,127.03624
강북구,1547, 꿈의숲 롯데캐슬,202006,546,403,949,37.618641,127.03624
강북구,1548, 북서울 꿈의숲 서문,201901,168,81,249,37.622688,127.037811
강북구,1548, 북서울 꿈의숲 서문,201902,160,115,275,37.622688,127.037811
강북구,1548, 북서울 꿈의숲 서문,201903,341,244,585,37.622688,127.037811
강북구,1548, 북서울 꿈의숲 서문,201904,611,388,999,37.622688,127.037811
강북구,1548, 북서울 꿈의숲 서문,201905,892,552,1444,37.622688,127.037811
강북구,1548, 북서울 꿈의숲 서문,201906,779,438,1217,37.622688,127.037811
강북구,1548, 북서울 꿈의숲 서문,201907,511,313,824,37.622688,127.037811
강북구,1548, 북서울 꿈의숲 서문,201908,524,312,836,37.622688,127.037811
강북구,1548, 북서울 꿈의숲 서문,201909,629,415,1044,37.622688,127.037811
강북구,1548, 북서울 꿈의숲 서문,201910,814,579,1393,37.622688,127.037811
강북구,1548, 북서울 꿈의숲 서문,201911,384,233,617,37.622688,127.037811
강북구,1548, 북서울 꿈의숲 서문,201912,204,91,295,37.622688,127.037811
강북구,1548, 북서울 꿈의숲 서문,202001,267,130,397,37.622688,127.037811
강북구,1548, 북서울 꿈의숲 서문,202002,290,153,443,37.622688,127.037811
강북구,1548, 북서울 꿈의숲 서문,202003,844,708,1552,37.622688,127.037811
강북구,1548, 북서울 꿈의숲 서문,202004,1012,885,1897,37.622688,127.037811
강북구,1548, 북서울 꿈의숲 서문,202005,1116,980,2096,37.622688,127.037811
강북구,1548, 북서울 꿈의숲 서문,202006,912,720,1632,37.622688,127.037811
강북구,1550,삼각산아이원아파트(105동 옆),202004,1,1,2,37.615223,127.018509
강북구,1550,삼각산아이원아파트(105동 옆),202006,28,7,35,37.615223,127.018509
강북구,1551,4,202004,2,2,4,37.646862,127.008812
강북구,1551,4,202006,291,264,555,37.646862,127.008812
강북구,1552, 강북구청사거리(던킨도너츠 앞),202004,2,2,4,37.639202,127.027237
강북구,1552, 강북구청사거리(던킨도너츠 앞),202005,1,1,2,37.639202,127.027237
강북구,1552, 강북구청사거리(던킨도너츠 앞),202006,576,577,1153,37.639202,127.027237
강북구,1553,예수그리스도후기성도교회 앞,202004,3,3,6,37.635204,127.033966
강북구,1553,예수그리스도후기성도교회 앞,202005,18,19,37,37.635204,127.033966
강북구,1553,예수그리스도후기성도교회 앞,202006,131,132,263,37.635204,127.033966
강북구,1554,번동사거리,202004,1,1,2,37.635391,127.034554
강북구,1554,번동사거리,202006,295,270,565,37.635391,127.034554
강북구,1557,신창교,202004,2,2,4,37.632381,127.039307
강북구,1557,신창교,202006,370,372,742,37.632381,127.039307
강북구,1558,강북문화정보도서관,202004,1,1,2,37.625526,127.037323
강북구,1558,강북문화정보도서관,202006,241,221,462,37.625526,127.037323
강북구,1560, 도봉세무서 앞,202004,2,2,4,37.619808,127.028526
강북구,1560, 도봉세무서 앞,202006,383,382,765,37.619808,127.028526
강북구,1564,4,202004,6,6,12,37.649597,127.013847
강북구,1565,대한병원앞,202004,1,1,2,37.635612,127.022995
강북구,1565,대한병원앞,202006,343,351,694,37.635612,127.022995
강북구,1566,삼각산 아이언APT앞,202004,1,1,2,#N/A,#N/A
강북구,1566,삼각산 아이언APT앞,202006,80,50,130,#N/A,#N/A
강북구,1568,4,202004,4,4,8,37.647934,127.014572
강북구,1568,4,202006,342,338,680,37.647934,127.014572
강북구,1569,수유역2번출구,202004,4,3,7,37.63797,127.025902
강북구,1569,수유역2번출구,202006,219,217,436,37.63797,127.025902
강북구,1573,현대성우아파트 옆,202006,39,34,73,#N/A,#N/A
강북구,1574,송중초등학교 옆,202006,83,76,159,#N/A,#N/A
노원구,1601, 석계역 문화광장 내 자전거 보관소,201901,609,559,1168,37.615299,127.064468
노원구,1601, 석계역 문화광장 내 자전거 보관소,201902,540,555,1095,37.615299,127.064468
노원구,1601, 석계역 문화광장 내 자전거 보관소,201903,1289,1290,2579,37.615299,127.064468
노원구,1601, 석계역 문화광장 내 자전거 보관소,201904,2062,2077,4139,37.615299,127.064468
노원구,1601, 석계역 문화광장 내 자전거 보관소,201905,3426,3308,6734,37.615299,127.064468
노원구,1601, 석계역 문화광장 내 자전거 보관소,201906,3580,3444,7024,37.615299,127.064468
노원구,1601, 석계역 문화광장 내 자전거 보관소,201907,3180,3076,6256,37.615299,127.064468
노원구,1601, 석계역 문화광장 내 자전거 보관소,201908,3098,3069,6167,37.615299,127.064468
노원구,1601, 석계역 문화광장 내 자전거 보관소,201909,3308,3218,6526,37.615299,127.064468
노원구,1601, 석계역 문화광장 내 자전거 보관소,201910,3931,3890,7821,37.615299,127.064468
노원구,1601, 석계역 문화광장 내 자전거 보관소,201911,2532,2493,5025,37.615299,127.064468
노원구,1601, 석계역 문화광장 내 자전거 보관소,201912,1315,1423,2738,37.615299,127.064468
노원구,1601, 석계역 문화광장 내 자전거 보관소,202001,1181,1279,2460,37.615299,127.064468
노원구,1601, 석계역 문화광장 내 자전거 보관소,202002,1222,1355,2577,37.615299,127.064468
노원구,1601, 석계역 문화광장 내 자전거 보관소,202003,2687,2827,5514,37.615299,127.064468
노원구,1601, 석계역 문화광장 내 자전거 보관소,202004,4063,4107,8170,37.615299,127.064468
노원구,1601, 석계역 문화광장 내 자전거 보관소,202005,5115,5088,10203,37.615299,127.064468
노원구,1601, 석계역 문화광장 내 자전거 보관소,202006,4996,5007,10003,37.615299,127.064468
노원구,1602, 광운대역 앞,201901,251,215,466,37.622662,127.061897
노원구,1602, 광운대역 앞,201902,223,234,457,37.622662,127.061897
노원구,1602, 광운대역 앞,201903,607,548,1155,37.622662,127.061897
노원구,1602, 광운대역 앞,201904,926,849,1775,37.622662,127.061897
노원구,1602, 광운대역 앞,201905,1491,1328,2819,37.622662,127.061897
노원구,1602, 광운대역 앞,201906,1538,1435,2973,37.622662,127.061897
노원구,1602, 광운대역 앞,201907,1402,1387,2789,37.622662,127.061897
노원구,1602, 광운대역 앞,201908,1385,1304,2689,37.622662,127.061897
노원구,1602, 광운대역 앞,201909,1405,1355,2760,37.622662,127.061897
노원구,1602, 광운대역 앞,201910,1607,1576,3183,37.622662,127.061897
노원구,1602, 광운대역 앞,201911,1078,1083,2161,37.622662,127.061897
노원구,1602, 광운대역 앞,201912,606,599,1205,37.622662,127.061897
노원구,1602, 광운대역 앞,202001,459,455,914,37.622662,127.061897
노원구,1602, 광운대역 앞,202002,509,579,1088,37.622662,127.061897
노원구,1602, 광운대역 앞,202003,895,937,1832,37.622662,127.061897
노원구,1602, 광운대역 앞,202004,1326,1311,2637,37.622662,127.061897
노원구,1602, 광운대역 앞,202005,1935,2014,3949,37.622662,127.061897
노원구,1602, 광운대역 앞,202006,1912,1913,3825,37.622662,127.061897
노원구,1603, 롯데캐슬 102동 코너(월계주유소건너),201901,225,237,462,#N/A,#N/A
노원구,1603, 롯데캐슬 102동 코너(월계주유소건너),201902,255,229,484,#N/A,#N/A
노원구,1603, 롯데캐슬 102동 코너(월계주유소건너),201903,505,534,1039,#N/A,#N/A
노원구,1603, 롯데캐슬 102동 코너(월계주유소건너),201904,885,975,1860,#N/A,#N/A
노원구,1603, 롯데캐슬 102동 코너(월계주유소건너),201905,1351,1506,2857,#N/A,#N/A
노원구,1603, 롯데캐슬 102동 코너(월계주유소건너),201906,1357,1642,2999,#N/A,#N/A
노원구,1603, 롯데캐슬 102동 코너(월계주유소건너),201907,1252,1518,2770,#N/A,#N/A
노원구,1603, 롯데캐슬 102동 코너(월계주유소건너),201908,1268,1544,2812,#N/A,#N/A
노원구,1603, 롯데캐슬 102동 코너(월계주유소건너),201909,1545,1705,3250,#N/A,#N/A
노원구,1603, 롯데캐슬 102동 코너(월계주유소건너),201910,1571,1788,3359,#N/A,#N/A
노원구,1603, 롯데캐슬 102동 코너(월계주유소건너),201911,1087,1152,2239,#N/A,#N/A
노원구,1603, 롯데캐슬 102동 코너(월계주유소건너),201912,596,667,1263,#N/A,#N/A
노원구,1603, 롯데캐슬 102동 코너(월계주유소건너),202001,565,617,1182,#N/A,#N/A
노원구,1603, 롯데캐슬 102동 코너(월계주유소건너),202002,577,610,1187,#N/A,#N/A
노원구,1603, 롯데캐슬 102동 코너(월계주유소건너),202003,1615,1674,3289,#N/A,#N/A
노원구,1603, 롯데캐슬 102동 코너(월계주유소건너),202004,2677,2829,5506,#N/A,#N/A
노원구,1603, 롯데캐슬 102동 코너(월계주유소건너),202005,2944,3087,6031,#N/A,#N/A
노원구,1603, 롯데캐슬 102동 코너(월계주유소건너),202006,2464,2617,5081,#N/A,#N/A
노원구,1605, 헬스케어,201901,224,234,458,37.631622,127.061615
노원구,1605, 헬스케어,201902,228,243,471,37.631622,127.061615
노원구,1605, 헬스케어,201903,649,713,1362,37.631622,127.061615
노원구,1605, 헬스케어,201904,1125,1344,2469,37.631622,127.061615
노원구,1605, 헬스케어,201905,1797,2069,3866,37.631622,127.061615
노원구,1605, 헬스케어,201906,1790,2136,3926,37.631622,127.061615
노원구,1605, 헬스케어,201907,1516,1965,3481,37.631622,127.061615
노원구,1605, 헬스케어,201908,1417,1734,3151,37.631622,127.061615
노원구,1605, 헬스케어,201909,1683,1924,3607,37.631622,127.061615
노원구,1605, 헬스케어,201910,1628,1923,3551,37.631622,127.061615
노원구,1605, 헬스케어,201911,918,1090,2008,37.631622,127.061615
노원구,1605, 헬스케어,201912,468,566,1034,37.631622,127.061615
노원구,1605, 헬스케어,202001,452,505,957,37.631622,127.061615
노원구,1605, 헬스케어,202002,514,620,1134,37.631622,127.061615
노원구,1605, 헬스케어,202003,1333,1457,2790,37.631622,127.061615
노원구,1605, 헬스케어,202004,2157,2319,4476,37.631622,127.061615
노원구,1605, 헬스케어,202005,2665,2924,5589,37.631622,127.061615
노원구,1605, 헬스케어,202006,2523,3000,5523,37.631622,127.061615
노원구,1606, 태릉입구역 3번출구,201901,282,350,632,37.619171,127.074928
노원구,1606, 태릉입구역 3번출구,201902,239,297,536,37.619171,127.074928
노원구,1606, 태릉입구역 3번출구,201903,585,639,1224,37.619171,127.074928
노원구,1606, 태릉입구역 3번출구,201904,774,822,1596,37.619171,127.074928
노원구,1606, 태릉입구역 3번출구,201905,1229,1263,2492,37.619171,127.074928
노원구,1606, 태릉입구역 3번출구,201906,1333,1324,2657,37.619171,127.074928
노원구,1606, 태릉입구역 3번출구,201907,1354,1310,2664,37.619171,127.074928
노원구,1606, 태릉입구역 3번출구,201908,1132,1153,2285,37.619171,127.074928
노원구,1606, 태릉입구역 3번출구,201909,1339,1335,2674,37.619171,127.074928
노원구,1606, 태릉입구역 3번출구,201910,1445,1452,2897,37.619171,127.074928
노원구,1606, 태릉입구역 3번출구,201911,849,849,1698,37.619171,127.074928
노원구,1606, 태릉입구역 3번출구,201912,498,491,989,37.619171,127.074928
노원구,1606, 태릉입구역 3번출구,202001,445,447,892,37.619171,127.074928
노원구,1606, 태릉입구역 3번출구,202002,471,453,924,37.619171,127.074928
노원구,1606, 태릉입구역 3번출구,202003,880,884,1764,37.619171,127.074928
노원구,1606, 태릉입구역 3번출구,202004,1316,1331,2647,37.619171,127.074928
노원구,1606, 태릉입구역 3번출구,202005,1650,1648,3298,37.619171,127.074928
노원구,1606, 태릉입구역 3번출구,202006,1592,1676,3268,37.619171,127.074928
노원구,1608, 공릉역 1번 출구 앞,201901,735,1055,1790,37.626614,127.072754
노원구,1608, 공릉역 1번 출구 앞,201902,766,1044,1810,37.626614,127.072754
노원구,1608, 공릉역 1번 출구 앞,201903,1622,1828,3450,37.626614,127.072754
노원구,1608, 공릉역 1번 출구 앞,201904,2440,2780,5220,37.626614,127.072754
노원구,1608, 공릉역 1번 출구 앞,201905,4167,4518,8685,37.626614,127.072754
노원구,1608, 공릉역 1번 출구 앞,201906,4363,4646,9009,37.626614,127.072754
노원구,1608, 공릉역 1번 출구 앞,201907,4097,4472,8569,37.626614,127.072754
노원구,1608, 공릉역 1번 출구 앞,201908,3925,4184,8109,37.626614,127.072754
노원구,1608, 공릉역 1번 출구 앞,201909,4518,4640,9158,37.626614,127.072754
노원구,1608, 공릉역 1번 출구 앞,201910,4914,5183,10097,37.626614,127.072754
노원구,1608, 공릉역 1번 출구 앞,201911,2905,3123,6028,37.626614,127.072754
노원구,1608, 공릉역 1번 출구 앞,201912,1469,1585,3054,37.626614,127.072754
노원구,1608, 공릉역 1번 출구 앞,202001,1224,1512,2736,37.626614,127.072754
노원구,1608, 공릉역 1번 출구 앞,202002,1210,1503,2713,37.626614,127.072754
노원구,1608, 공릉역 1번 출구 앞,202003,2782,3001,5783,37.626614,127.072754
노원구,1608, 공릉역 1번 출구 앞,202004,4270,4519,8789,37.626614,127.072754
노원구,1608, 공릉역 1번 출구 앞,202005,5446,5646,11092,37.626614,127.072754
노원구,1608, 공릉역 1번 출구 앞,202006,5434,6081,11515,37.626614,127.072754
노원구,1610, 화랑대역 2번출구 앞,201901,465,470,935,37.620369,127.083641
노원구,1610, 화랑대역 2번출구 앞,201902,503,488,991,37.620369,127.083641
노원구,1610, 화랑대역 2번출구 앞,201903,1059,1068,2127,37.620369,127.083641
노원구,1610, 화랑대역 2번출구 앞,201904,1739,1820,3559,37.620369,127.083641
노원구,1610, 화랑대역 2번출구 앞,201905,3151,3173,6324,37.620369,127.083641
노원구,1610, 화랑대역 2번출구 앞,201906,3173,3204,6377,37.620369,127.083641
노원구,1610, 화랑대역 2번출구 앞,201907,2739,2825,5564,37.620369,127.083641
노원구,1610, 화랑대역 2번출구 앞,201908,2522,2503,5025,37.620369,127.083641
노원구,1610, 화랑대역 2번출구 앞,201909,2763,2780,5543,37.620369,127.083641
노원구,1610, 화랑대역 2번출구 앞,201910,2995,2947,5942,37.620369,127.083641
노원구,1610, 화랑대역 2번출구 앞,201911,1697,1695,3392,37.620369,127.083641
노원구,1610, 화랑대역 2번출구 앞,201912,905,944,1849,37.620369,127.083641
노원구,1610, 화랑대역 2번출구 앞,202001,826,856,1682,37.620369,127.083641
노원구,1610, 화랑대역 2번출구 앞,202002,772,777,1549,37.620369,127.083641
노원구,1610, 화랑대역 2번출구 앞,202003,1883,1866,3749,37.620369,127.083641
노원구,1610, 화랑대역 2번출구 앞,202004,2936,2936,5872,37.620369,127.083641
노원구,1610, 화랑대역 2번출구 앞,202005,3129,3143,6272,37.620369,127.083641
노원구,1610, 화랑대역 2번출구 앞,202006,3595,3653,7248,37.620369,127.083641
노원구,1611, 과기대 입구(우),201901,584,581,1165,37.62994,127.076553
노원구,1611, 과기대 입구(우),201902,463,529,992,37.62994,127.076553
노원구,1611, 과기대 입구(우),201903,1306,1455,2761,37.62994,127.076553
노원구,1611, 과기대 입구(우),201904,2180,2273,4453,37.62994,127.076553
노원구,1611, 과기대 입구(우),201905,3654,3753,7407,37.62994,127.076553
노원구,1611, 과기대 입구(우),201906,3515,3576,7091,37.62994,127.076553
노원구,1611, 과기대 입구(우),201907,2912,2917,5829,37.62994,127.076553
노원구,1611, 과기대 입구(우),201908,2806,2856,5662,37.62994,127.076553
노원구,1611, 과기대 입구(우),201909,3613,3800,7413,37.62994,127.076553
노원구,1611, 과기대 입구(우),201910,3890,4047,7937,37.62994,127.076553
노원구,1611, 과기대 입구(우),201911,2245,2382,4627,37.62994,127.076553
노원구,1611, 과기대 입구(우),201912,1163,1210,2373,37.62994,127.076553
노원구,1611, 과기대 입구(우),202001,931,955,1886,37.62994,127.076553
노원구,1611, 과기대 입구(우),202002,903,938,1841,37.62994,127.076553
노원구,1611, 과기대 입구(우),202003,1665,1751,3416,37.62994,127.076553
노원구,1611, 과기대 입구(우),202004,2749,2841,5590,37.62994,127.076553
노원구,1611, 과기대 입구(우),202005,3475,3599,7074,37.62994,127.076553
노원구,1611, 과기대 입구(우),202006,4002,4063,8065,37.62994,127.076553
노원구,1616, 하계2동 공항버스정류장 옆,201901,505,526,1031,37.635109,127.068329
노원구,1616, 하계2동 공항버스정류장 옆,201902,610,607,1217,37.635109,127.068329
노원구,1616, 하계2동 공항버스정류장 옆,201903,1161,1193,2354,37.635109,127.068329
노원구,1616, 하계2동 공항버스정류장 옆,201904,1791,1957,3748,37.635109,127.068329
노원구,1616, 하계2동 공항버스정류장 옆,201905,2960,3199,6159,37.635109,127.068329
노원구,1616, 하계2동 공항버스정류장 옆,201906,3313,3472,6785,37.635109,127.068329
노원구,1616, 하계2동 공항버스정류장 옆,201907,3316,3397,6713,37.635109,127.068329
노원구,1616, 하계2동 공항버스정류장 옆,201908,3058,3212,6270,37.635109,127.068329
노원구,1616, 하계2동 공항버스정류장 옆,201909,3153,3276,6429,37.635109,127.068329
노원구,1616, 하계2동 공항버스정류장 옆,201910,3585,3644,7229,37.635109,127.068329
노원구,1616, 하계2동 공항버스정류장 옆,201911,2257,2368,4625,37.635109,127.068329
노원구,1616, 하계2동 공항버스정류장 옆,201912,1333,1507,2840,37.635109,127.068329
노원구,1616, 하계2동 공항버스정류장 옆,202001,1268,1397,2665,37.635109,127.068329
노원구,1616, 하계2동 공항버스정류장 옆,202002,1170,1244,2414,37.635109,127.068329
노원구,1616, 하계2동 공항버스정류장 옆,202003,2103,2154,4257,37.635109,127.068329
노원구,1616, 하계2동 공항버스정류장 옆,202004,3087,3137,6224,37.635109,127.068329
노원구,1616, 하계2동 공항버스정류장 옆,202005,3985,4058,8043,37.635109,127.068329
노원구,1616, 하계2동 공항버스정류장 옆,202006,4171,4346,8517,37.635109,127.068329
노원구,1617, 하계동 중평어린이공원 앞,201901,119,173,292,37.63715,127.063271
노원구,1617, 하계동 중평어린이공원 앞,201902,289,319,608,37.63715,127.063271
노원구,1617, 하계동 중평어린이공원 앞,201903,575,683,1258,37.63715,127.063271
노원구,1617, 하계동 중평어린이공원 앞,201904,803,935,1738,37.63715,127.063271
노원구,1617, 하계동 중평어린이공원 앞,201905,1349,1474,2823,37.63715,127.063271
노원구,1617, 하계동 중평어린이공원 앞,201906,1675,1893,3568,37.63715,127.063271
노원구,1617, 하계동 중평어린이공원 앞,201907,1628,1979,3607,37.63715,127.063271
노원구,1617, 하계동 중평어린이공원 앞,201908,1571,1740,3311,37.63715,127.063271
노원구,1617, 하계동 중평어린이공원 앞,201909,1672,1796,3468,37.63715,127.063271
노원구,1617, 하계동 중평어린이공원 앞,201910,2151,2362,4513,37.63715,127.063271
노원구,1617, 하계동 중평어린이공원 앞,201911,1393,1618,3011,37.63715,127.063271
노원구,1617, 하계동 중평어린이공원 앞,201912,907,1082,1989,37.63715,127.063271
노원구,1617, 하계동 중평어린이공원 앞,202001,763,816,1579,37.63715,127.063271
노원구,1617, 하계동 중평어린이공원 앞,202002,697,738,1435,37.63715,127.063271
노원구,1617, 하계동 중평어린이공원 앞,202003,1485,1540,3025,37.63715,127.063271
노원구,1617, 하계동 중평어린이공원 앞,202004,2265,2343,4608,37.63715,127.063271
노원구,1617, 하계동 중평어린이공원 앞,202005,2832,2925,5757,37.63715,127.063271
노원구,1617, 하계동 중평어린이공원 앞,202006,3146,3461,6607,37.63715,127.063271
노원구,1619, 중계동 하나프라자빌딩 앞(중1-1),201901,414,412,826,37.649021,127.076408
노원구,1619, 중계동 하나프라자빌딩 앞(중1-1),201902,569,568,1137,37.649021,127.076408
노원구,1619, 중계동 하나프라자빌딩 앞(중1-1),201903,902,942,1844,37.649021,127.076408
노원구,1619, 중계동 하나프라자빌딩 앞(중1-1),201904,1310,1350,2660,37.649021,127.076408
노원구,1619, 중계동 하나프라자빌딩 앞(중1-1),201905,2086,2121,4207,37.649021,127.076408
노원구,1619, 중계동 하나프라자빌딩 앞(중1-1),201906,2317,2288,4605,37.649021,127.076408
노원구,1619, 중계동 하나프라자빌딩 앞(중1-1),201907,106,103,209,37.649021,127.076408
노원구,1619, 중계동 하나프라자빌딩 앞(중1-1),201908,660,611,1271,37.649021,127.076408
노원구,1619, 중계동 하나프라자빌딩 앞(중1-1),201909,1717,1656,3373,37.649021,127.076408
노원구,1619, 중계동 하나프라자빌딩 앞(중1-1),201910,2225,2158,4383,37.649021,127.076408
노원구,1619, 중계동 하나프라자빌딩 앞(중1-1),201911,1545,1528,3073,37.649021,127.076408
노원구,1619, 중계동 하나프라자빌딩 앞(중1-1),201912,990,993,1983,37.649021,127.076408
노원구,1619, 중계동 하나프라자빌딩 앞(중1-1),202001,953,967,1920,37.649021,127.076408
노원구,1619, 중계동 하나프라자빌딩 앞(중1-1),202002,869,867,1736,37.649021,127.076408
노원구,1619, 중계동 하나프라자빌딩 앞(중1-1),202003,1477,1469,2946,37.649021,127.076408
노원구,1619, 중계동 하나프라자빌딩 앞(중1-1),202004,2183,2174,4357,37.649021,127.076408
노원구,1619, 중계동 하나프라자빌딩 앞(중1-1),202005,2619,2594,5213,37.649021,127.076408
노원구,1619, 중계동 하나프라자빌딩 앞(중1-1),202006,3000,3008,6008,37.649021,127.076408
노원구,1620, 중계동 노원구민체육센터 옆(중1-2),201901,437,368,805,37.648209,127.070221
노원구,1620, 중계동 노원구민체육센터 옆(중1-2),201902,386,393,779,37.648209,127.070221
노원구,1620, 중계동 노원구민체육센터 옆(중1-2),201903,776,728,1504,37.648209,127.070221
노원구,1620, 중계동 노원구민체육센터 옆(중1-2),201904,1110,1037,2147,37.648209,127.070221
노원구,1620, 중계동 노원구민체육센터 옆(중1-2),201905,1658,1608,3266,37.648209,127.070221
노원구,1620, 중계동 노원구민체육센터 옆(중1-2),201906,1806,1750,3556,37.648209,127.070221
노원구,1620, 중계동 노원구민체육센터 옆(중1-2),201907,1694,1649,3343,37.648209,127.070221
노원구,1620, 중계동 노원구민체육센터 옆(중1-2),201908,1651,1636,3287,37.648209,127.070221
노원구,1620, 중계동 노원구민체육센터 옆(중1-2),201909,1354,1337,2691,37.648209,127.070221
노원구,1620, 중계동 노원구민체육센터 옆(중1-2),201910,1614,1598,3212,37.648209,127.070221
노원구,1620, 중계동 노원구민체육센터 옆(중1-2),201911,1137,1120,2257,37.648209,127.070221
노원구,1620, 중계동 노원구민체육센터 옆(중1-2),201912,843,830,1673,37.648209,127.070221
노원구,1620, 중계동 노원구민체육센터 옆(중1-2),202001,713,700,1413,37.648209,127.070221
노원구,1620, 중계동 노원구민체육센터 옆(중1-2),202002,560,549,1109,37.648209,127.070221
노원구,1620, 중계동 노원구민체육센터 옆(중1-2),202003,932,876,1808,37.648209,127.070221
노원구,1620, 중계동 노원구민체육센터 옆(중1-2),202004,1432,1402,2834,37.648209,127.070221
노원구,1620, 중계동 노원구민체육센터 옆(중1-2),202005,1636,1589,3225,37.648209,127.070221
노원구,1620, 중계동 노원구민체육센터 옆(중1-2),202006,1761,1729,3490,37.648209,127.070221
노원구,1623, 노원 구민회관,201901,531,563,1094,#N/A,#N/A
노원구,1623, 노원 구민회관,201902,562,556,1118,#N/A,#N/A
노원구,1623, 노원 구민회관,201903,962,927,1889,#N/A,#N/A
노원구,1623, 노원 구민회관,201904,1497,1522,3019,#N/A,#N/A
노원구,1623, 노원 구민회관,201905,2515,2495,5010,#N/A,#N/A
노원구,1623, 노원 구민회관,201906,2892,2843,5735,#N/A,#N/A
노원구,1623, 노원 구민회관,201907,2578,2452,5030,#N/A,#N/A
노원구,1623, 노원 구민회관,201908,2638,2523,5161,#N/A,#N/A
노원구,1623, 노원 구민회관,201909,2448,2369,4817,#N/A,#N/A
노원구,1623, 노원 구민회관,201910,2964,2833,5797,#N/A,#N/A
노원구,1623, 노원 구민회관,201911,1790,1719,3509,#N/A,#N/A
노원구,1623, 노원 구민회관,201912,1107,1116,2223,#N/A,#N/A
노원구,1623, 노원 구민회관,202001,9,7,16,#N/A,#N/A
노원구,1625, 상계역(4번출구),201901,877,868,1745,37.66,127.072968
노원구,1625, 상계역(4번출구),201902,814,800,1614,37.66,127.072968
노원구,1625, 상계역(4번출구),201903,1418,1494,2912,37.66,127.072968
노원구,1625, 상계역(4번출구),201904,2259,2315,4574,37.66,127.072968
노원구,1625, 상계역(4번출구),201905,4108,4182,8290,37.66,127.072968
노원구,1625, 상계역(4번출구),201906,4542,4446,8988,37.66,127.072968
노원구,1625, 상계역(4번출구),201907,4092,3933,8025,37.66,127.072968
노원구,1625, 상계역(4번출구),201908,3903,3792,7695,37.66,127.072968
노원구,1625, 상계역(4번출구),201909,3540,3415,6955,37.66,127.072968
노원구,1625, 상계역(4번출구),201910,3991,3813,7804,37.66,127.072968
노원구,1625, 상계역(4번출구),201911,2726,2678,5404,37.66,127.072968
노원구,1625, 상계역(4번출구),201912,1776,1646,3422,37.66,127.072968
노원구,1625, 상계역(4번출구),202001,1759,1698,3457,37.66,127.072968
노원구,1625, 상계역(4번출구),202002,1517,1415,2932,37.66,127.072968
노원구,1625, 상계역(4번출구),202003,2879,2788,5667,37.66,127.072968
노원구,1625, 상계역(4번출구),202004,4094,3977,8071,37.66,127.072968
노원구,1625, 상계역(4번출구),202005,4620,4478,9098,37.66,127.072968
노원구,1625, 상계역(4번출구),202006,5109,5011,10120,37.66,127.072968
노원구,1627, 수락산역 4번출구,201901,120,130,250,37.676941,127.055099
노원구,1627, 수락산역 4번출구,201902,150,160,310,37.676941,127.055099
노원구,1627, 수락산역 4번출구,201903,286,373,659,37.676941,127.055099
노원구,1627, 수락산역 4번출구,201904,569,672,1241,37.676941,127.055099
노원구,1627, 수락산역 4번출구,201905,1105,1160,2265,37.676941,127.055099
노원구,1627, 수락산역 4번출구,201906,735,817,1552,37.676941,127.055099
노원구,1627, 수락산역 4번출구,201907,0,1,1,37.676941,127.055099
노원구,1627, 수락산역 4번출구,201910,3,12,15,37.676941,127.055099
노원구,1627, 수락산역 4번출구,201911,8,21,29,37.676941,127.055099
노원구,1628, 노일초등학교 앞,201901,126,148,274,37.673618,127.055252
노원구,1628, 노일초등학교 앞,201902,156,171,327,37.673618,127.055252
노원구,1628, 노일초등학교 앞,201903,236,307,543,37.673618,127.055252
노원구,1628, 노일초등학교 앞,201904,422,497,919,37.673618,127.055252
노원구,1628, 노일초등학교 앞,201905,702,864,1566,37.673618,127.055252
노원구,1628, 노일초등학교 앞,201906,793,1001,1794,37.673618,127.055252
노원구,1628, 노일초등학교 앞,201907,779,935,1714,37.673618,127.055252
노원구,1628, 노일초등학교 앞,201908,785,930,1715,37.673618,127.055252
노원구,1628, 노일초등학교 앞,201909,849,958,1807,37.673618,127.055252
노원구,1628, 노일초등학교 앞,201910,1051,1129,2180,37.673618,127.055252
노원구,1628, 노일초등학교 앞,201911,637,723,1360,37.673618,127.055252
노원구,1628, 노일초등학교 앞,201912,307,329,636,37.673618,127.055252
노원구,1628, 노일초등학교 앞,202001,312,339,651,37.673618,127.055252
노원구,1628, 노일초등학교 앞,202002,274,295,569,37.673618,127.055252
노원구,1628, 노일초등학교 앞,202003,809,797,1606,37.673618,127.055252
노원구,1628, 노일초등학교 앞,202004,1304,1349,2653,37.673618,127.055252
노원구,1628, 노일초등학교 앞,202005,1481,1557,3038,37.673618,127.055252
노원구,1628, 노일초등학교 앞,202006,1334,1405,2739,37.673618,127.055252
노원구,1630, 수연빌딩 앞,201901,120,121,241,37.67625,127.055504
노원구,1630, 수연빌딩 앞,201902,114,105,219,37.67625,127.055504
노원구,1630, 수연빌딩 앞,201903,198,183,381,37.67625,127.055504
노원구,1630, 수연빌딩 앞,201904,441,403,844,37.67625,127.055504
노원구,1630, 수연빌딩 앞,201905,709,687,1396,37.67625,127.055504
노원구,1630, 수연빌딩 앞,201906,1066,1128,2194,37.67625,127.055504
노원구,1630, 수연빌딩 앞,201907,1335,1507,2842,37.67625,127.055504
노원구,1630, 수연빌딩 앞,201908,1267,1351,2618,37.67625,127.055504
노원구,1630, 수연빌딩 앞,201909,1326,1355,2681,37.67625,127.055504
노원구,1630, 수연빌딩 앞,201910,1486,1512,2998,37.67625,127.055504
노원구,1630, 수연빌딩 앞,201911,902,943,1845,37.67625,127.055504
노원구,1630, 수연빌딩 앞,201912,510,539,1049,37.67625,127.055504
노원구,1630, 수연빌딩 앞,202001,470,500,970,37.67625,127.055504
노원구,1630, 수연빌딩 앞,202002,483,466,949,37.67625,127.055504
노원구,1630, 수연빌딩 앞,202003,983,1008,1991,37.67625,127.055504
노원구,1630, 수연빌딩 앞,202004,675,710,1385,37.67625,127.055504
노원구,1630, 수연빌딩 앞,202005,1276,1310,2586,37.67625,127.055504
노원구,1630, 수연빌딩 앞,202006,1864,1899,3763,37.67625,127.055504
노원구,1634, 당고개공원 대여소,201901,315,337,652,37.669079,127.077591
노원구,1634, 당고개공원 대여소,201902,311,321,632,37.669079,127.077591
노원구,1634, 당고개공원 대여소,201903,545,549,1094,37.669079,127.077591
노원구,1634, 당고개공원 대여소,201904,718,777,1495,37.669079,127.077591
노원구,1634, 당고개공원 대여소,201905,1161,1177,2338,37.669079,127.077591
노원구,1634, 당고개공원 대여소,201906,1424,1477,2901,37.669079,127.077591
노원구,1634, 당고개공원 대여소,201907,1423,1454,2877,37.669079,127.077591
노원구,1634, 당고개공원 대여소,201908,1201,1195,2396,37.669079,127.077591
노원구,1634, 당고개공원 대여소,201909,1283,1312,2595,37.669079,127.077591
노원구,1634, 당고개공원 대여소,201910,1494,1502,2996,37.669079,127.077591
노원구,1634, 당고개공원 대여소,201911,1016,991,2007,37.669079,127.077591
노원구,1634, 당고개공원 대여소,201912,557,532,1089,37.669079,127.077591
노원구,1634, 당고개공원 대여소,202001,565,563,1128,37.669079,127.077591
노원구,1634, 당고개공원 대여소,202002,512,448,960,37.669079,127.077591
노원구,1634, 당고개공원 대여소,202003,861,857,1718,37.669079,127.077591
노원구,1634, 당고개공원 대여소,202004,1352,1347,2699,37.669079,127.077591
노원구,1634, 당고개공원 대여소,202005,1578,1572,3150,37.669079,127.077591
노원구,1634, 당고개공원 대여소,202006,1901,1904,3805,37.669079,127.077591
노원구,1635, 상계3,201901,121,63,184,37.67271,127.08316
노원구,1635, 상계3,201902,139,75,214,37.67271,127.08316
노원구,1635, 상계3,201903,197,134,331,37.67271,127.08316
노원구,1635, 상계3,201904,256,227,483,37.67271,127.08316
노원구,1635, 상계3,201905,368,329,697,37.67271,127.08316
노원구,1635, 상계3,201906,371,345,716,37.67271,127.08316
노원구,1635, 상계3,201907,341,297,638,37.67271,127.08316
노원구,1635, 상계3,201908,342,291,633,37.67271,127.08316
노원구,1635, 상계3,201909,308,312,620,37.67271,127.08316
노원구,1635, 상계3,201910,257,249,506,37.67271,127.08316
노원구,1635, 상계3,201911,215,199,414,37.67271,127.08316
노원구,1635, 상계3,201912,162,111,273,37.67271,127.08316
노원구,1635, 상계3,202001,186,112,298,37.67271,127.08316
노원구,1635, 상계3,202002,105,95,200,37.67271,127.08316
노원구,1635, 상계3,202003,246,174,420,37.67271,127.08316
노원구,1635, 상계3,202004,396,316,712,37.67271,127.08316
노원구,1635, 상계3,202005,428,380,808,37.67271,127.08316
노원구,1635, 상계3,202006,537,483,1020,37.67271,127.08316
노원구,1636, 백병원 사거리 농협은행 앞,201901,722,686,1408,37.649212,127.061768
노원구,1636, 백병원 사거리 농협은행 앞,201902,683,680,1363,37.649212,127.061768
노원구,1636, 백병원 사거리 농협은행 앞,201903,1307,1275,2582,37.649212,127.061768
노원구,1636, 백병원 사거리 농협은행 앞,201904,1886,1817,3703,37.649212,127.061768
노원구,1636, 백병원 사거리 농협은행 앞,201905,3139,3089,6228,37.649212,127.061768
노원구,1636, 백병원 사거리 농협은행 앞,201906,3815,3826,7641,37.649212,127.061768
노원구,1636, 백병원 사거리 농협은행 앞,201907,3072,3078,6150,37.649212,127.061768
노원구,1636, 백병원 사거리 농협은행 앞,201908,2796,2780,5576,37.649212,127.061768
노원구,1636, 백병원 사거리 농협은행 앞,201909,2862,2890,5752,37.649212,127.061768
노원구,1636, 백병원 사거리 농협은행 앞,201910,3330,3367,6697,37.649212,127.061768
노원구,1636, 백병원 사거리 농협은행 앞,201911,2327,2406,4733,37.649212,127.061768
노원구,1636, 백병원 사거리 농협은행 앞,201912,1408,1435,2843,37.649212,127.061768
노원구,1636, 백병원 사거리 농협은행 앞,202001,1362,1356,2718,37.649212,127.061768
노원구,1636, 백병원 사거리 농협은행 앞,202002,1143,1143,2286,37.649212,127.061768
노원구,1636, 백병원 사거리 농협은행 앞,202003,1640,1689,3329,37.649212,127.061768
노원구,1636, 백병원 사거리 농협은행 앞,202004,2356,2410,4766,37.649212,127.061768
노원구,1636, 백병원 사거리 농협은행 앞,202005,2991,2983,5974,37.649212,127.061768
노원구,1636, 백병원 사거리 농협은행 앞,202006,3774,3765,7539,37.649212,127.061768
노원구,1637, KT 노원점 건물 앞,201901,798,753,1551,37.654701,127.0634
노원구,1637, KT 노원점 건물 앞,201902,750,708,1458,37.654701,127.0634
노원구,1637, KT 노원점 건물 앞,201903,1447,1340,2787,37.654701,127.0634
노원구,1637, KT 노원점 건물 앞,201904,2026,1835,3861,37.654701,127.0634
노원구,1637, KT 노원점 건물 앞,201905,3136,2930,6066,37.654701,127.0634
노원구,1637, KT 노원점 건물 앞,201906,3606,3490,7096,37.654701,127.0634
노원구,1637, KT 노원점 건물 앞,201907,3339,3142,6481,37.654701,127.0634
노원구,1637, KT 노원점 건물 앞,201908,3159,3023,6182,37.654701,127.0634
노원구,1637, KT 노원점 건물 앞,201909,2903,2770,5673,37.654701,127.0634
노원구,1637, KT 노원점 건물 앞,201910,3344,3090,6434,37.654701,127.0634
노원구,1637, KT 노원점 건물 앞,201911,2295,2140,4435,37.654701,127.0634
노원구,1637, KT 노원점 건물 앞,201912,1497,1374,2871,37.654701,127.0634
노원구,1637, KT 노원점 건물 앞,202001,1397,1270,2667,37.654701,127.0634
노원구,1637, KT 노원점 건물 앞,202002,1318,1252,2570,37.654701,127.0634
노원구,1637, KT 노원점 건물 앞,202003,1970,1851,3821,37.654701,127.0634
노원구,1637, KT 노원점 건물 앞,202004,2862,2792,5654,37.654701,127.0634
노원구,1637, KT 노원점 건물 앞,202005,3379,3300,6679,37.654701,127.0634
노원구,1637, KT 노원점 건물 앞,202006,4210,3970,8180,37.654701,127.0634
노원구,1639, 희성오피앙,201901,86,71,157,37.680313,127.055069
노원구,1639, 희성오피앙,201902,86,110,196,37.680313,127.055069
노원구,1639, 희성오피앙,201903,207,216,423,37.680313,127.055069
노원구,1639, 희성오피앙,201904,333,356,689,37.680313,127.055069
노원구,1639, 희성오피앙,201905,654,677,1331,37.680313,127.055069
노원구,1639, 희성오피앙,201906,704,793,1497,37.680313,127.055069
노원구,1639, 희성오피앙,201907,874,922,1796,37.680313,127.055069
노원구,1639, 희성오피앙,201908,932,991,1923,37.680313,127.055069
노원구,1639, 희성오피앙,201909,1094,1178,2272,37.680313,127.055069
노원구,1639, 희성오피앙,201910,1137,1161,2298,37.680313,127.055069
노원구,1639, 희성오피앙,201911,614,639,1253,37.680313,127.055069
노원구,1639, 희성오피앙,201912,334,350,684,37.680313,127.055069
노원구,1639, 희성오피앙,202001,321,345,666,37.680313,127.055069
노원구,1639, 희성오피앙,202002,332,345,677,37.680313,127.055069
노원구,1639, 희성오피앙,202003,898,895,1793,37.680313,127.055069
노원구,1639, 희성오피앙,202004,1378,1501,2879,37.680313,127.055069
노원구,1639, 희성오피앙,202005,1595,1670,3265,37.680313,127.055069
노원구,1639, 희성오피앙,202006,1676,1873,3549,37.680313,127.055069
노원구,1640, 한내근린공원 북측,201901,202,186,388,37.623863,127.068489
노원구,1640, 한내근린공원 북측,201902,244,253,497,37.623863,127.068489
노원구,1640, 한내근린공원 북측,201903,473,472,945,37.623863,127.068489
노원구,1640, 한내근린공원 북측,201904,780,845,1625,37.623863,127.068489
노원구,1640, 한내근린공원 북측,201905,1178,1313,2491,37.623863,127.068489
노원구,1640, 한내근린공원 북측,201906,1223,1454,2677,37.623863,127.068489
노원구,1640, 한내근린공원 북측,201907,1196,1443,2639,37.623863,127.068489
노원구,1640, 한내근린공원 북측,201908,1149,1387,2536,37.623863,127.068489
노원구,1640, 한내근린공원 북측,201909,1264,1438,2702,37.623863,127.068489
노원구,1640, 한내근린공원 북측,201910,1431,1589,3020,37.623863,127.068489
노원구,1640, 한내근린공원 북측,201911,756,816,1572,37.623863,127.068489
노원구,1640, 한내근린공원 북측,201912,409,438,847,37.623863,127.068489
노원구,1640, 한내근린공원 북측,202001,344,345,689,37.623863,127.068489
노원구,1640, 한내근린공원 북측,202002,427,409,836,37.623863,127.068489
노원구,1640, 한내근린공원 북측,202003,1230,1304,2534,37.623863,127.068489
노원구,1640, 한내근린공원 북측,202004,1969,2065,4034,37.623863,127.068489
노원구,1640, 한내근린공원 북측,202005,2201,2267,4468,37.623863,127.068489
노원구,1640, 한내근린공원 북측,202006,2159,2294,4453,37.623863,127.068489
노원구,1641, 한내근린공원 남측,201901,133,143,276,37.621555,127.069511
노원구,1641, 한내근린공원 남측,201902,204,180,384,37.621555,127.069511
노원구,1641, 한내근린공원 남측,201903,259,253,512,37.621555,127.069511
노원구,1641, 한내근린공원 남측,201904,358,432,790,37.621555,127.069511
노원구,1641, 한내근린공원 남측,201905,608,671,1279,37.621555,127.069511
노원구,1641, 한내근린공원 남측,201906,612,749,1361,37.621555,127.069511
노원구,1641, 한내근린공원 남측,201907,616,692,1308,37.621555,127.069511
노원구,1641, 한내근린공원 남측,201908,658,794,1452,37.621555,127.069511
노원구,1641, 한내근린공원 남측,201909,735,834,1569,37.621555,127.069511
노원구,1641, 한내근린공원 남측,201910,776,859,1635,37.621555,127.069511
노원구,1641, 한내근린공원 남측,201911,492,556,1048,37.621555,127.069511
노원구,1641, 한내근린공원 남측,201912,204,216,420,37.621555,127.069511
노원구,1641, 한내근린공원 남측,202001,242,221,463,37.621555,127.069511
노원구,1641, 한내근린공원 남측,202002,204,218,422,37.621555,127.069511
노원구,1641, 한내근린공원 남측,202003,499,513,1012,37.621555,127.069511
노원구,1641, 한내근린공원 남측,202004,761,771,1532,37.621555,127.069511
노원구,1641, 한내근린공원 남측,202005,911,940,1851,37.621555,127.069511
노원구,1641, 한내근린공원 남측,202006,952,1006,1958,37.621555,127.069511
노원구,1642, 서울여대 남문,201901,175,145,320,37.625435,127.088493
노원구,1642, 서울여대 남문,201902,141,117,258,37.625435,127.088493
노원구,1642, 서울여대 남문,201903,404,361,765,37.625435,127.088493
노원구,1642, 서울여대 남문,201904,668,598,1266,37.625435,127.088493
노원구,1642, 서울여대 남문,201905,982,883,1865,37.625435,127.088493
노원구,1642, 서울여대 남문,201906,984,883,1867,37.625435,127.088493
노원구,1642, 서울여대 남문,201907,785,757,1542,37.625435,127.088493
노원구,1642, 서울여대 남문,201908,690,663,1353,37.625435,127.088493
노원구,1642, 서울여대 남문,201909,1011,1017,2028,37.625435,127.088493
노원구,1642, 서울여대 남문,201910,979,967,1946,37.625435,127.088493
노원구,1642, 서울여대 남문,201911,513,483,996,37.625435,127.088493
노원구,1642, 서울여대 남문,201912,308,287,595,37.625435,127.088493
노원구,1642, 서울여대 남문,202001,205,179,384,37.625435,127.088493
노원구,1642, 서울여대 남문,202002,218,187,405,37.625435,127.088493
노원구,1642, 서울여대 남문,202003,413,368,781,37.625435,127.088493
노원구,1642, 서울여대 남문,202004,582,569,1151,37.625435,127.088493
노원구,1642, 서울여대 남문,202005,771,752,1523,37.625435,127.088493
노원구,1642, 서울여대 남문,202006,865,789,1654,37.625435,127.088493
노원구,1643, 태릉입구역 8번출구,201901,271,239,510,37.617367,127.075211
노원구,1643, 태릉입구역 8번출구,201902,263,263,526,37.617367,127.075211
노원구,1643, 태릉입구역 8번출구,201903,590,619,1209,37.617367,127.075211
노원구,1643, 태릉입구역 8번출구,201904,1167,1209,2376,37.617367,127.075211
노원구,1643, 태릉입구역 8번출구,201905,2022,2294,4316,37.617367,127.075211
노원구,1643, 태릉입구역 8번출구,201906,1835,1888,3723,37.617367,127.075211
노원구,1643, 태릉입구역 8번출구,201907,788,789,1577,37.617367,127.075211
노원구,1643, 태릉입구역 8번출구,201908,1514,1528,3042,37.617367,127.075211
노원구,1643, 태릉입구역 8번출구,201909,1958,1981,3939,37.617367,127.075211
노원구,1643, 태릉입구역 8번출구,201910,2047,2067,4114,37.617367,127.075211
노원구,1643, 태릉입구역 8번출구,201911,1147,1185,2332,37.617367,127.075211
노원구,1643, 태릉입구역 8번출구,201912,616,606,1222,37.617367,127.075211
노원구,1643, 태릉입구역 8번출구,202001,500,527,1027,37.617367,127.075211
노원구,1643, 태릉입구역 8번출구,202002,569,566,1135,37.617367,127.075211
노원구,1643, 태릉입구역 8번출구,202003,1729,1800,3529,37.617367,127.075211
노원구,1643, 태릉입구역 8번출구,202004,2709,2774,5483,37.617367,127.075211
노원구,1643, 태릉입구역 8번출구,202005,3493,3556,7049,37.617367,127.075211
노원구,1643, 태릉입구역 8번출구,202006,3088,3120,6208,37.617367,127.075211
노원구,1646, 삼육대 입구,201901,66,68,134,37.638489,127.107903
노원구,1646, 삼육대 입구,201902,59,68,127,37.638489,127.107903
노원구,1646, 삼육대 입구,201903,198,186,384,37.638489,127.107903
노원구,1646, 삼육대 입구,201904,278,257,535,37.638489,127.107903
노원구,1646, 삼육대 입구,201905,578,425,1003,37.638489,127.107903
노원구,1646, 삼육대 입구,201906,429,411,840,37.638489,127.107903
노원구,1646, 삼육대 입구,201907,406,384,790,37.638489,127.107903
노원구,1646, 삼육대 입구,201908,423,389,812,37.638489,127.107903
노원구,1646, 삼육대 입구,201909,399,390,789,37.638489,127.107903
노원구,1646, 삼육대 입구,201910,543,513,1056,37.638489,127.107903
노원구,1646, 삼육대 입구,201911,342,294,636,37.638489,127.107903
노원구,1646, 삼육대 입구,201912,140,108,248,37.638489,127.107903
노원구,1646, 삼육대 입구,202001,139,119,258,37.638489,127.107903
노원구,1646, 삼육대 입구,202002,173,155,328,37.638489,127.107903
노원구,1646, 삼육대 입구,202003,501,478,979,37.638489,127.107903
노원구,1646, 삼육대 입구,202004,717,717,1434,37.638489,127.107903
노원구,1646, 삼육대 입구,202005,940,922,1862,37.638489,127.107903
노원구,1646, 삼육대 입구,202006,845,838,1683,37.638489,127.107903
노원구,1650, 중계근린공원내,201901,501,473,974,37.63958,127.065102
노원구,1650, 중계근린공원내,201902,416,435,851,37.63958,127.065102
노원구,1650, 중계근린공원내,201903,886,853,1739,37.63958,127.065102
노원구,1650, 중계근린공원내,201904,1264,1282,2546,37.63958,127.065102
노원구,1650, 중계근린공원내,201905,2256,2184,4440,37.63958,127.065102
노원구,1650, 중계근린공원내,201906,2735,2608,5343,37.63958,127.065102
노원구,1650, 중계근린공원내,201907,2386,2189,4575,37.63958,127.065102
노원구,1650, 중계근린공원내,201908,2388,2277,4665,37.63958,127.065102
노원구,1650, 중계근린공원내,201909,2531,2378,4909,37.63958,127.065102
노원구,1650, 중계근린공원내,201910,2997,2856,5853,37.63958,127.065102
노원구,1650, 중계근린공원내,201911,1809,1761,3570,37.63958,127.065102
노원구,1650, 중계근린공원내,201912,970,954,1924,37.63958,127.065102
노원구,1650, 중계근린공원내,202001,1490,1532,3022,37.63958,127.065102
노원구,1650, 중계근린공원내,202002,1420,1465,2885,37.63958,127.065102
노원구,1650, 중계근린공원내,202003,2666,2642,5308,37.63958,127.065102
노원구,1650, 중계근린공원내,202004,3835,3751,7586,37.63958,127.065102
노원구,1650, 중계근린공원내,202005,4925,4904,9829,37.63958,127.065102
노원구,1650, 중계근린공원내,202006,4326,4355,8681,37.63958,127.065102
노원구,1651, 맥도날드 상계점 앞,201901,205,233,438,37.672375,127.055992
노원구,1651, 맥도날드 상계점 앞,201902,212,251,463,37.672375,127.055992
노원구,1651, 맥도날드 상계점 앞,201903,277,371,648,37.672375,127.055992
노원구,1651, 맥도날드 상계점 앞,201904,521,582,1103,37.672375,127.055992
노원구,1651, 맥도날드 상계점 앞,201905,903,965,1868,37.672375,127.055992
노원구,1651, 맥도날드 상계점 앞,201906,1039,1100,2139,37.672375,127.055992
노원구,1651, 맥도날드 상계점 앞,201907,1052,1025,2077,37.672375,127.055992
노원구,1651, 맥도날드 상계점 앞,201908,1020,1043,2063,37.672375,127.055992
노원구,1651, 맥도날드 상계점 앞,201909,953,933,1886,37.672375,127.055992
노원구,1651, 맥도날드 상계점 앞,201910,1232,1185,2417,37.672375,127.055992
노원구,1651, 맥도날드 상계점 앞,201911,761,747,1508,37.672375,127.055992
노원구,1651, 맥도날드 상계점 앞,201912,400,401,801,37.672375,127.055992
노원구,1651, 맥도날드 상계점 앞,202001,415,436,851,37.672375,127.055992
노원구,1651, 맥도날드 상계점 앞,202002,475,501,976,37.672375,127.055992
노원구,1651, 맥도날드 상계점 앞,202003,799,772,1571,37.672375,127.055992
노원구,1651, 맥도날드 상계점 앞,202004,1194,1136,2330,37.672375,127.055992
노원구,1651, 맥도날드 상계점 앞,202005,1330,1283,2613,37.672375,127.055992
노원구,1651, 맥도날드 상계점 앞,202006,1388,1423,2811,37.672375,127.055992
노원구,1652, 파르코 앞,201901,74,63,137,37.68,127.05558
노원구,1652, 파르코 앞,201902,59,67,126,37.68,127.05558
노원구,1652, 파르코 앞,201903,82,75,157,37.68,127.05558
노원구,1652, 파르코 앞,201904,142,152,294,37.68,127.05558
노원구,1652, 파르코 앞,201905,291,320,611,37.68,127.05558
노원구,1652, 파르코 앞,201906,326,396,722,37.68,127.05558
노원구,1652, 파르코 앞,201907,394,437,831,37.68,127.05558
노원구,1652, 파르코 앞,201908,361,402,763,37.68,127.05558
노원구,1652, 파르코 앞,201909,379,405,784,37.68,127.05558
노원구,1652, 파르코 앞,201910,426,420,846,37.68,127.05558
노원구,1652, 파르코 앞,201911,278,292,570,37.68,127.05558
노원구,1652, 파르코 앞,201912,182,173,355,37.68,127.05558
노원구,1652, 파르코 앞,202001,196,183,379,37.68,127.05558
노원구,1652, 파르코 앞,202002,281,265,546,37.68,127.05558
노원구,1652, 파르코 앞,202003,448,430,878,37.68,127.05558
노원구,1652, 파르코 앞,202004,708,731,1439,37.68,127.05558
노원구,1652, 파르코 앞,202005,627,619,1246,37.68,127.05558
노원구,1652, 파르코 앞,202006,640,659,1299,37.68,127.05558
노원구,1653, 노원역1번출구,201901,729,824,1553,37.6562,127.063622
노원구,1653, 노원역1번출구,201902,676,741,1417,37.6562,127.063622
노원구,1653, 노원역1번출구,201903,1173,1253,2426,37.6562,127.063622
노원구,1653, 노원역1번출구,201904,1901,2054,3955,37.6562,127.063622
노원구,1653, 노원역1번출구,201905,3172,3410,6582,37.6562,127.063622
노원구,1653, 노원역1번출구,201906,3972,4232,8204,37.6562,127.063622
노원구,1653, 노원역1번출구,201907,3742,3909,7651,37.6562,127.063622
노원구,1653, 노원역1번출구,201908,3711,3902,7613,37.6562,127.063622
노원구,1653, 노원역1번출구,201909,3305,3487,6792,37.6562,127.063622
노원구,1653, 노원역1번출구,201910,3948,4130,8078,37.6562,127.063622
노원구,1653, 노원역1번출구,201911,2632,2768,5400,37.6562,127.063622
노원구,1653, 노원역1번출구,201912,1556,1722,3278,37.6562,127.063622
노원구,1653, 노원역1번출구,202001,1432,1620,3052,37.6562,127.063622
노원구,1653, 노원역1번출구,202002,1351,1507,2858,37.6562,127.063622
노원구,1653, 노원역1번출구,202003,2099,2176,4275,37.6562,127.063622
노원구,1653, 노원역1번출구,202004,3122,3202,6324,37.6562,127.063622
노원구,1653, 노원역1번출구,202005,4054,4175,8229,37.6562,127.063622
노원구,1653, 노원역1번출구,202006,5178,5478,10656,37.6562,127.063622
노원구,1654, 당고개입구 오거리,201901,133,115,248,37.663792,127.075447
노원구,1654, 당고개입구 오거리,201902,133,111,244,37.663792,127.075447
노원구,1654, 당고개입구 오거리,201903,227,164,391,37.663792,127.075447
노원구,1654, 당고개입구 오거리,201904,364,249,613,37.663792,127.075447
노원구,1654, 당고개입구 오거리,201905,545,479,1024,37.663792,127.075447
노원구,1654, 당고개입구 오거리,201906,723,602,1325,37.663792,127.075447
노원구,1654, 당고개입구 오거리,201907,676,546,1222,37.663792,127.075447
노원구,1654, 당고개입구 오거리,201908,628,556,1184,37.663792,127.075447
노원구,1654, 당고개입구 오거리,201909,611,559,1170,37.663792,127.075447
노원구,1654, 당고개입구 오거리,201910,703,597,1300,37.663792,127.075447
노원구,1654, 당고개입구 오거리,201911,522,448,970,37.663792,127.075447
노원구,1654, 당고개입구 오거리,201912,84,80,164,37.663792,127.075447
노원구,1654, 당고개입구 오거리,202004,1,1,2,37.663792,127.075447
노원구,1654, 당고개입구 오거리,202005,885,852,1737,37.663792,127.075447
노원구,1654, 당고개입구 오거리,202006,1349,1286,2635,37.663792,127.075447
노원구,1655, 공릉1단지아파트,201901,410,454,864,37.631111,127.07016
노원구,1655, 공릉1단지아파트,201902,410,482,892,37.631111,127.07016
노원구,1655, 공릉1단지아파트,201903,893,936,1829,37.631111,127.07016
노원구,1655, 공릉1단지아파트,201904,1277,1433,2710,37.631111,127.07016
노원구,1655, 공릉1단지아파트,201905,2191,2565,4756,37.631111,127.07016
노원구,1655, 공릉1단지아파트,201906,2350,2640,4990,37.631111,127.07016
노원구,1655, 공릉1단지아파트,201907,2186,2396,4582,37.631111,127.07016
노원구,1655, 공릉1단지아파트,201908,2168,2369,4537,37.631111,127.07016
노원구,1655, 공릉1단지아파트,201909,2480,2510,4990,37.631111,127.07016
노원구,1655, 공릉1단지아파트,201910,2790,2798,5588,37.631111,127.07016
노원구,1655, 공릉1단지아파트,201911,1567,1552,3119,37.631111,127.07016
노원구,1655, 공릉1단지아파트,201912,865,881,1746,37.631111,127.07016
노원구,1655, 공릉1단지아파트,202001,899,919,1818,37.631111,127.07016
노원구,1655, 공릉1단지아파트,202002,966,889,1855,37.631111,127.07016
노원구,1655, 공릉1단지아파트,202003,1821,1845,3666,37.631111,127.07016
노원구,1655, 공릉1단지아파트,202004,2852,2923,5775,37.631111,127.07016
노원구,1655, 공릉1단지아파트,202005,3498,3583,7081,37.631111,127.07016
노원구,1655, 공릉1단지아파트,202006,3423,3582,7005,37.631111,127.07016
노원구,1656, 중앙하이츠 아파트 입구,201901,618,627,1245,37.654999,127.067436
노원구,1656, 중앙하이츠 아파트 입구,201902,625,646,1271,37.654999,127.067436
노원구,1656, 중앙하이츠 아파트 입구,201903,1128,1120,2248,37.654999,127.067436
노원구,1656, 중앙하이츠 아파트 입구,201904,1576,1503,3079,37.654999,127.067436
노원구,1656, 중앙하이츠 아파트 입구,201905,2375,2207,4582,37.654999,127.067436
노원구,1656, 중앙하이츠 아파트 입구,201906,2666,2533,5199,37.654999,127.067436
노원구,1656, 중앙하이츠 아파트 입구,201907,2369,2238,4607,37.654999,127.067436
노원구,1656, 중앙하이츠 아파트 입구,201908,2483,2297,4780,37.654999,127.067436
노원구,1656, 중앙하이츠 아파트 입구,201909,1901,1760,3661,37.654999,127.067436
노원구,1656, 중앙하이츠 아파트 입구,201910,2260,2115,4375,37.654999,127.067436
노원구,1656, 중앙하이츠 아파트 입구,201911,1702,1603,3305,37.654999,127.067436
노원구,1656, 중앙하이츠 아파트 입구,201912,1083,1046,2129,37.654999,127.067436
노원구,1656, 중앙하이츠 아파트 입구,202001,974,981,1955,37.654999,127.067436
노원구,1656, 중앙하이츠 아파트 입구,202002,818,858,1676,37.654999,127.067436
노원구,1656, 중앙하이츠 아파트 입구,202003,1124,1097,2221,37.654999,127.067436
노원구,1656, 중앙하이츠 아파트 입구,202004,1411,1365,2776,37.654999,127.067436
노원구,1656, 중앙하이츠 아파트 입구,202005,1929,1897,3826,37.654999,127.067436
노원구,1656, 중앙하이츠 아파트 입구,202006,2508,2491,4999,37.654999,127.067436
노원구,1657, 노원구청,201901,174,243,417,37.654049,127.057327
노원구,1657, 노원구청,201902,198,207,405,37.654049,127.057327
노원구,1657, 노원구청,201903,417,467,884,37.654049,127.057327
노원구,1657, 노원구청,201904,630,723,1353,37.654049,127.057327
노원구,1657, 노원구청,201905,1050,1108,2158,37.654049,127.057327
노원구,1657, 노원구청,201906,1132,1165,2297,37.654049,127.057327
노원구,1657, 노원구청,201907,964,1016,1980,37.654049,127.057327
노원구,1657, 노원구청,201908,888,906,1794,37.654049,127.057327
노원구,1657, 노원구청,201909,959,1046,2005,37.654049,127.057327
노원구,1657, 노원구청,201910,972,1188,2160,37.654049,127.057327
노원구,1657, 노원구청,201911,703,796,1499,37.654049,127.057327
노원구,1657, 노원구청,201912,418,399,817,37.654049,127.057327
노원구,1657, 노원구청,202001,453,435,888,37.654049,127.057327
노원구,1657, 노원구청,202002,475,494,969,37.654049,127.057327
노원구,1657, 노원구청,202003,930,926,1856,37.654049,127.057327
노원구,1657, 노원구청,202004,1122,1125,2247,37.654049,127.057327
노원구,1657, 노원구청,202005,1331,1376,2707,37.654049,127.057327
노원구,1657, 노원구청,202006,1481,1472,2953,37.654049,127.057327
노원구,1659, 중계동 을지중학교,201901,298,273,571,37.65033,127.071602
노원구,1659, 중계동 을지중학교,201902,215,210,425,37.65033,127.071602
노원구,1659, 중계동 을지중학교,201903,479,392,871,37.65033,127.071602
노원구,1659, 중계동 을지중학교,201904,691,655,1346,37.65033,127.071602
노원구,1659, 중계동 을지중학교,201905,1023,916,1939,37.65033,127.071602
노원구,1659, 중계동 을지중학교,201906,1047,1010,2057,37.65033,127.071602
노원구,1659, 중계동 을지중학교,201907,1246,1183,2429,37.65033,127.071602
노원구,1659, 중계동 을지중학교,201908,1079,1048,2127,37.65033,127.071602
노원구,1659, 중계동 을지중학교,201909,959,955,1914,37.65033,127.071602
노원구,1659, 중계동 을지중학교,201910,1113,1093,2206,37.65033,127.071602
노원구,1659, 중계동 을지중학교,201911,676,652,1328,37.65033,127.071602
노원구,1659, 중계동 을지중학교,201912,393,369,762,37.65033,127.071602
노원구,1659, 중계동 을지중학교,202001,365,323,688,37.65033,127.071602
노원구,1659, 중계동 을지중학교,202002,343,315,658,37.65033,127.071602
노원구,1659, 중계동 을지중학교,202003,717,679,1396,37.65033,127.071602
노원구,1659, 중계동 을지중학교,202004,1105,1087,2192,37.65033,127.071602
노원구,1659, 중계동 을지중학교,202005,1418,1378,2796,37.65033,127.071602
노원구,1659, 중계동 을지중학교,202006,1504,1444,2948,37.65033,127.071602
노원구,1660, 서울시립과학관,201901,142,109,251,37.642071,127.076622
노원구,1660, 서울시립과학관,201902,111,84,195,37.642071,127.076622
노원구,1660, 서울시립과학관,201903,245,192,437,37.642071,127.076622
노원구,1660, 서울시립과학관,201904,435,406,841,37.642071,127.076622
노원구,1660, 서울시립과학관,201905,698,659,1357,37.642071,127.076622
노원구,1660, 서울시립과학관,201906,689,684,1373,37.642071,127.076622
노원구,1660, 서울시립과학관,201907,667,615,1282,37.642071,127.076622
노원구,1660, 서울시립과학관,201908,682,657,1339,37.642071,127.076622
노원구,1660, 서울시립과학관,201909,685,635,1320,37.642071,127.076622
노원구,1660, 서울시립과학관,201910,696,645,1341,37.642071,127.076622
노원구,1660, 서울시립과학관,201911,498,456,954,37.642071,127.076622
노원구,1660, 서울시립과학관,201912,332,281,613,37.642071,127.076622
노원구,1660, 서울시립과학관,202001,273,232,505,37.642071,127.076622
노원구,1660, 서울시립과학관,202002,252,199,451,37.642071,127.076622
노원구,1660, 서울시립과학관,202003,379,353,732,37.642071,127.076622
노원구,1660, 서울시립과학관,202004,598,539,1137,37.642071,127.076622
노원구,1660, 서울시립과학관,202005,681,605,1286,37.642071,127.076622
노원구,1660, 서울시립과학관,202006,714,636,1350,37.642071,127.076622
노원구,1661, 당현천근린공원,201901,303,255,558,37.649639,127.065605
노원구,1661, 당현천근린공원,201902,311,285,596,37.649639,127.065605
노원구,1661, 당현천근린공원,201903,688,573,1261,37.649639,127.065605
노원구,1661, 당현천근린공원,201904,982,913,1895,37.649639,127.065605
노원구,1661, 당현천근린공원,201905,1343,1234,2577,37.649639,127.065605
노원구,1661, 당현천근린공원,201906,1440,1341,2781,37.649639,127.065605
노원구,1661, 당현천근린공원,201907,1070,984,2054,37.649639,127.065605
노원구,1661, 당현천근린공원,201908,1271,1160,2431,37.649639,127.065605
노원구,1661, 당현천근린공원,201909,1133,1074,2207,37.649639,127.065605
노원구,1661, 당현천근린공원,201910,1282,1268,2550,37.649639,127.065605
노원구,1661, 당현천근린공원,201911,935,851,1786,37.649639,127.065605
노원구,1661, 당현천근린공원,201912,482,425,907,37.649639,127.065605
노원구,1661, 당현천근린공원,202001,442,399,841,37.649639,127.065605
노원구,1661, 당현천근린공원,202002,466,461,927,37.649639,127.065605
노원구,1661, 당현천근린공원,202003,885,866,1751,37.649639,127.065605
노원구,1661, 당현천근린공원,202004,1282,1226,2508,37.649639,127.065605
노원구,1661, 당현천근린공원,202005,1435,1419,2854,37.649639,127.065605
노원구,1661, 당현천근린공원,202006,1225,1219,2444,37.649639,127.065605
노원구,1662, 노원역7번출구,201901,339,323,662,37.654114,127.059151
노원구,1662, 노원역7번출구,201902,387,326,713,37.654114,127.059151
노원구,1662, 노원역7번출구,201903,694,646,1340,37.654114,127.059151
노원구,1662, 노원역7번출구,201904,1161,968,2129,37.654114,127.059151
노원구,1662, 노원역7번출구,201905,1757,1587,3344,37.654114,127.059151
노원구,1662, 노원역7번출구,201906,1429,1365,2794,37.654114,127.059151
노원구,1662, 노원역7번출구,201907,1240,1161,2401,37.654114,127.059151
노원구,1662, 노원역7번출구,201908,1426,1294,2720,37.654114,127.059151
노원구,1662, 노원역7번출구,201909,1349,1264,2613,37.654114,127.059151
노원구,1662, 노원역7번출구,201910,1856,1698,3554,37.654114,127.059151
노원구,1662, 노원역7번출구,201911,1224,1091,2315,37.654114,127.059151
노원구,1662, 노원역7번출구,201912,728,622,1350,37.654114,127.059151
노원구,1662, 노원역7번출구,202001,766,662,1428,37.654114,127.059151
노원구,1662, 노원역7번출구,202002,644,596,1240,37.654114,127.059151
노원구,1662, 노원역7번출구,202003,1044,888,1932,37.654114,127.059151
노원구,1662, 노원역7번출구,202004,1496,1478,2974,37.654114,127.059151
노원구,1662, 노원역7번출구,202005,1717,1638,3355,37.654114,127.059151
노원구,1662, 노원역7번출구,202006,1892,1663,3555,37.654114,127.059151
노원구,1663, 동해문화예술관앞,201901,591,657,1248,37.619381,127.057854
노원구,1663, 동해문화예술관앞,201902,441,493,934,37.619381,127.057854
노원구,1663, 동해문화예술관앞,201903,1254,1425,2679,37.619381,127.057854
노원구,1663, 동해문화예술관앞,201904,2022,2154,4176,37.619381,127.057854
노원구,1663, 동해문화예술관앞,201905,3351,3510,6861,37.619381,127.057854
노원구,1663, 동해문화예술관앞,201906,3363,3529,6892,37.619381,127.057854
노원구,1663, 동해문화예술관앞,201907,2928,3159,6087,37.619381,127.057854
노원구,1663, 동해문화예술관앞,201908,2790,2935,5725,37.619381,127.057854
노원구,1663, 동해문화예술관앞,201909,3409,3859,7268,37.619381,127.057854
노원구,1663, 동해문화예술관앞,201910,3930,4442,8372,37.619381,127.057854
노원구,1663, 동해문화예술관앞,201911,2528,2940,5468,37.619381,127.057854
노원구,1663, 동해문화예술관앞,201912,1319,1385,2704,37.619381,127.057854
노원구,1663, 동해문화예술관앞,202001,1007,1107,2114,37.619381,127.057854
노원구,1663, 동해문화예술관앞,202002,1013,1071,2084,37.619381,127.057854
노원구,1663, 동해문화예술관앞,202003,2221,2319,4540,37.619381,127.057854
노원구,1663, 동해문화예술관앞,202004,2868,2950,5818,37.619381,127.057854
노원구,1663, 동해문화예술관앞,202005,2264,2371,4635,37.619381,127.057854
노원구,1663, 동해문화예술관앞,202006,3259,3306,6565,37.619381,127.057854
노원구,1664, 노해근린공원내,201901,101,78,179,37.649361,127.070442
노원구,1664, 노해근린공원내,201902,81,69,150,37.649361,127.070442
노원구,1664, 노해근린공원내,201903,194,157,351,37.649361,127.070442
노원구,1664, 노해근린공원내,201904,372,310,682,37.649361,127.070442
노원구,1664, 노해근린공원내,201905,501,401,902,37.649361,127.070442
노원구,1664, 노해근린공원내,201906,550,471,1021,37.649361,127.070442
노원구,1664, 노해근린공원내,201907,471,402,873,37.649361,127.070442
노원구,1664, 노해근린공원내,201908,347,335,682,37.649361,127.070442
노원구,1664, 노해근린공원내,201909,370,370,740,37.649361,127.070442
노원구,1664, 노해근린공원내,201910,386,372,758,37.649361,127.070442
노원구,1664, 노해근린공원내,201911,229,209,438,37.649361,127.070442
노원구,1664, 노해근린공원내,201912,118,108,226,37.649361,127.070442
노원구,1664, 노해근린공원내,202001,125,101,226,37.649361,127.070442
노원구,1664, 노해근린공원내,202002,184,145,329,37.649361,127.070442
노원구,1664, 노해근린공원내,202003,446,421,867,37.649361,127.070442
노원구,1664, 노해근린공원내,202004,566,536,1102,37.649361,127.070442
노원구,1664, 노해근린공원내,202005,560,542,1102,37.649361,127.070442
노원구,1664, 노해근린공원내,202006,566,541,1107,37.649361,127.070442
노원구,1665, 양지근린공원앞,201901,380,348,728,37.647335,127.076424
노원구,1665, 양지근린공원앞,201902,294,236,530,37.647335,127.076424
노원구,1665, 양지근린공원앞,201903,432,328,760,37.647335,127.076424
노원구,1665, 양지근린공원앞,201904,688,546,1234,37.647335,127.076424
노원구,1665, 양지근린공원앞,201905,983,801,1784,37.647335,127.076424
노원구,1665, 양지근린공원앞,201906,990,821,1811,37.647335,127.076424
노원구,1665, 양지근린공원앞,201907,1970,1906,3876,37.647335,127.076424
노원구,1665, 양지근린공원앞,201908,1566,1497,3063,37.647335,127.076424
노원구,1665, 양지근린공원앞,201909,879,823,1702,37.647335,127.076424
노원구,1665, 양지근린공원앞,201910,980,867,1847,37.647335,127.076424
노원구,1665, 양지근린공원앞,201911,586,514,1100,37.647335,127.076424
노원구,1665, 양지근린공원앞,201912,397,316,713,37.647335,127.076424
노원구,1665, 양지근린공원앞,202001,430,350,780,37.647335,127.076424
노원구,1665, 양지근린공원앞,202002,488,382,870,37.647335,127.076424
노원구,1665, 양지근린공원앞,202003,600,512,1112,37.647335,127.076424
노원구,1665, 양지근린공원앞,202004,772,701,1473,37.647335,127.076424
노원구,1665, 양지근린공원앞,202005,1092,1009,2101,37.647335,127.076424
노원구,1665, 양지근린공원앞,202006,1261,1135,2396,37.647335,127.076424
노원구,1666, 노원소방서인근,201901,484,404,888,37.655781,127.071777
노원구,1666, 노원소방서인근,201902,392,321,713,37.655781,127.071777
노원구,1666, 노원소방서인근,201903,646,615,1261,37.655781,127.071777
노원구,1666, 노원소방서인근,201904,883,832,1715,37.655781,127.071777
노원구,1666, 노원소방서인근,201905,1525,1377,2902,37.655781,127.071777
노원구,1666, 노원소방서인근,201906,1654,1511,3165,37.655781,127.071777
노원구,1666, 노원소방서인근,201907,1690,1609,3299,37.655781,127.071777
노원구,1666, 노원소방서인근,201908,1638,1625,3263,37.655781,127.071777
노원구,1666, 노원소방서인근,201909,1361,1395,2756,37.655781,127.071777
노원구,1666, 노원소방서인근,201910,1550,1573,3123,37.655781,127.071777
노원구,1666, 노원소방서인근,201911,1018,1003,2021,37.655781,127.071777
노원구,1666, 노원소방서인근,201912,648,624,1272,37.655781,127.071777
노원구,1666, 노원소방서인근,202001,658,597,1255,37.655781,127.071777
노원구,1666, 노원소방서인근,202002,529,496,1025,37.655781,127.071777
노원구,1666, 노원소방서인근,202003,1040,1009,2049,37.655781,127.071777
노원구,1666, 노원소방서인근,202004,1523,1488,3011,37.655781,127.071777
노원구,1666, 노원소방서인근,202005,1784,1753,3537,37.655781,127.071777
노원구,1666, 노원소방서인근,202006,2091,1982,4073,37.655781,127.071777
노원구,1667, 중계중학교,201901,360,351,711,37.654499,127.074387
노원구,1667, 중계중학교,201902,300,275,575,37.654499,127.074387
노원구,1667, 중계중학교,201903,591,549,1140,37.654499,127.074387
노원구,1667, 중계중학교,201904,852,796,1648,37.654499,127.074387
노원구,1667, 중계중학교,201905,1394,1298,2692,37.654499,127.074387
노원구,1667, 중계중학교,201906,1485,1438,2923,37.654499,127.074387
노원구,1667, 중계중학교,201907,1460,1400,2860,37.654499,127.074387
노원구,1667, 중계중학교,201908,1480,1426,2906,37.654499,127.074387
노원구,1667, 중계중학교,201909,1276,1300,2576,37.654499,127.074387
노원구,1667, 중계중학교,201910,1362,1314,2676,37.654499,127.074387
노원구,1667, 중계중학교,201911,951,942,1893,37.654499,127.074387
노원구,1667, 중계중학교,201912,682,663,1345,37.654499,127.074387
노원구,1667, 중계중학교,202001,600,557,1157,37.654499,127.074387
노원구,1667, 중계중학교,202002,655,620,1275,37.654499,127.074387
노원구,1667, 중계중학교,202003,972,919,1891,37.654499,127.074387
노원구,1667, 중계중학교,202004,1370,1271,2641,37.654499,127.074387
노원구,1667, 중계중학교,202005,1596,1517,3113,37.654499,127.074387
노원구,1667, 중계중학교,202006,2015,1882,3897,37.654499,127.074387
노원구,1668, 중계역 6번출구,201901,630,650,1280,37.645508,127.063255
노원구,1668, 중계역 6번출구,201902,670,649,1319,37.645508,127.063255
노원구,1668, 중계역 6번출구,201903,1142,1242,2384,37.645508,127.063255
노원구,1668, 중계역 6번출구,201904,1798,1902,3700,37.645508,127.063255
노원구,1668, 중계역 6번출구,201905,2919,3111,6030,37.645508,127.063255
노원구,1668, 중계역 6번출구,201906,1172,1466,2638,37.645508,127.063255
노원구,1668, 중계역 6번출구,201907,2612,2660,5272,37.645508,127.063255
노원구,1668, 중계역 6번출구,201908,2944,3052,5996,37.645508,127.063255
노원구,1668, 중계역 6번출구,201909,2871,2985,5856,37.645508,127.063255
노원구,1668, 중계역 6번출구,201910,3569,3603,7172,37.645508,127.063255
노원구,1668, 중계역 6번출구,201911,2197,2272,4469,37.645508,127.063255
노원구,1668, 중계역 6번출구,201912,1337,1407,2744,37.645508,127.063255
노원구,1668, 중계역 6번출구,202001,1160,1237,2397,37.645508,127.063255
노원구,1668, 중계역 6번출구,202002,980,1004,1984,37.645508,127.063255
노원구,1668, 중계역 6번출구,202003,1640,1625,3265,37.645508,127.063255
노원구,1668, 중계역 6번출구,202004,2341,2329,4670,37.645508,127.063255
노원구,1668, 중계역 6번출구,202005,2893,2885,5778,37.645508,127.063255
노원구,1668, 중계역 6번출구,202006,3188,3162,6350,37.645508,127.063255
노원구,1669, 중계역 3번출구,201901,429,454,883,37.643757,127.064987
노원구,1669, 중계역 3번출구,201902,402,373,775,37.643757,127.064987
노원구,1669, 중계역 3번출구,201903,705,754,1459,37.643757,127.064987
노원구,1669, 중계역 3번출구,201904,1118,1051,2169,37.643757,127.064987
노원구,1669, 중계역 3번출구,201905,1846,1730,3576,37.643757,127.064987
노원구,1669, 중계역 3번출구,201906,2824,2727,5551,37.643757,127.064987
노원구,1669, 중계역 3번출구,201907,2119,2060,4179,37.643757,127.064987
노원구,1669, 중계역 3번출구,201908,1838,1816,3654,37.643757,127.064987
노원구,1669, 중계역 3번출구,201909,1712,1682,3394,37.643757,127.064987
노원구,1669, 중계역 3번출구,201910,2089,2067,4156,37.643757,127.064987
노원구,1669, 중계역 3번출구,201911,1373,1352,2725,37.643757,127.064987
노원구,1669, 중계역 3번출구,201912,871,861,1732,37.643757,127.064987
노원구,1669, 중계역 3번출구,202001,797,783,1580,37.643757,127.064987
노원구,1669, 중계역 3번출구,202002,798,768,1566,37.643757,127.064987
노원구,1669, 중계역 3번출구,202003,1250,1237,2487,37.643757,127.064987
노원구,1669, 중계역 3번출구,202004,1684,1679,3363,37.643757,127.064987
노원구,1669, 중계역 3번출구,202005,2198,2176,4374,37.643757,127.064987
노원구,1669, 중계역 3번출구,202006,2284,2265,4549,37.643757,127.064987
노원구,1670, 노원경찰서교차로,201901,395,339,734,37.64341,127.071838
노원구,1670, 노원경찰서교차로,201902,398,354,752,37.64341,127.071838
노원구,1670, 노원경찰서교차로,201903,634,556,1190,37.64341,127.071838
노원구,1670, 노원경찰서교차로,201904,1012,883,1895,37.64341,127.071838
노원구,1670, 노원경찰서교차로,201905,1569,1456,3025,37.64341,127.071838
노원구,1670, 노원경찰서교차로,201906,1608,1483,3091,37.64341,127.071838
노원구,1670, 노원경찰서교차로,201907,1402,1292,2694,37.64341,127.071838
노원구,1670, 노원경찰서교차로,201908,1498,1352,2850,37.64341,127.071838
노원구,1670, 노원경찰서교차로,201909,1395,1355,2750,37.64341,127.071838
노원구,1670, 노원경찰서교차로,201910,1613,1550,3163,37.64341,127.071838
노원구,1670, 노원경찰서교차로,201911,1259,1189,2448,37.64341,127.071838
노원구,1670, 노원경찰서교차로,201912,774,769,1543,37.64341,127.071838
노원구,1670, 노원경찰서교차로,202001,754,761,1515,37.64341,127.071838
노원구,1670, 노원경찰서교차로,202002,660,618,1278,37.64341,127.071838
노원구,1670, 노원경찰서교차로,202003,964,919,1883,37.64341,127.071838
노원구,1670, 노원경찰서교차로,202004,1364,1367,2731,37.64341,127.071838
노원구,1670, 노원경찰서교차로,202005,1773,1738,3511,37.64341,127.071838
노원구,1670, 노원경찰서교차로,202006,1964,1898,3862,37.64341,127.071838
노원구,1671, 인덕대학교,201901,193,188,381,37.629349,127.054825
노원구,1671, 인덕대학교,201902,196,226,422,37.629349,127.054825
노원구,1671, 인덕대학교,201903,550,556,1106,37.629349,127.054825
노원구,1671, 인덕대학교,201904,889,931,1820,37.629349,127.054825
노원구,1671, 인덕대학교,201905,1379,1357,2736,37.629349,127.054825
노원구,1671, 인덕대학교,201906,1603,1600,3203,37.629349,127.054825
노원구,1671, 인덕대학교,201907,1148,1366,2514,37.629349,127.054825
노원구,1671, 인덕대학교,201908,1097,1210,2307,37.629349,127.054825
노원구,1671, 인덕대학교,201909,1367,1441,2808,37.629349,127.054825
노원구,1671, 인덕대학교,201910,1667,1732,3399,37.629349,127.054825
노원구,1671, 인덕대학교,201911,1016,1106,2122,37.629349,127.054825
노원구,1671, 인덕대학교,201912,528,552,1080,37.629349,127.054825
노원구,1671, 인덕대학교,202001,353,400,753,37.629349,127.054825
노원구,1671, 인덕대학교,202002,414,439,853,37.629349,127.054825
노원구,1671, 인덕대학교,202003,946,979,1925,37.629349,127.054825
노원구,1671, 인덕대학교,202004,1376,1444,2820,37.629349,127.054825
노원구,1671, 인덕대학교,202005,1534,1568,3102,37.629349,127.054825
노원구,1671, 인덕대학교,202006,1369,1464,2833,37.629349,127.054825
노원구,1672, 상계동수락리버시티,201901,174,122,296,37.688599,127.053406
노원구,1672, 상계동수락리버시티,201902,168,160,328,37.688599,127.053406
노원구,1672, 상계동수락리버시티,201903,329,297,626,37.688599,127.053406
노원구,1672, 상계동수락리버시티,201904,589,584,1173,37.688599,127.053406
노원구,1672, 상계동수락리버시티,201905,802,927,1729,37.688599,127.053406
노원구,1672, 상계동수락리버시티,201906,980,1089,2069,37.688599,127.053406
노원구,1672, 상계동수락리버시티,201907,902,1053,1955,37.688599,127.053406
노원구,1672, 상계동수락리버시티,201908,783,1053,1836,37.688599,127.053406
노원구,1672, 상계동수락리버시티,201909,827,1030,1857,37.688599,127.053406
노원구,1672, 상계동수락리버시티,201910,979,1188,2167,37.688599,127.053406
노원구,1672, 상계동수락리버시티,201911,655,761,1416,37.688599,127.053406
노원구,1672, 상계동수락리버시티,201912,392,447,839,37.688599,127.053406
노원구,1672, 상계동수락리버시티,202001,340,353,693,37.688599,127.053406
노원구,1672, 상계동수락리버시티,202002,334,347,681,37.688599,127.053406
노원구,1672, 상계동수락리버시티,202003,765,802,1567,37.688599,127.053406
노원구,1672, 상계동수락리버시티,202004,1132,1313,2445,37.688599,127.053406
노원구,1672, 상계동수락리버시티,202005,1343,1511,2854,37.688599,127.053406
노원구,1672, 상계동수락리버시티,202006,1001,1206,2207,37.688599,127.053406
노원구,1673, 노원역?5번출구,201901,747,773,1520,37.653976,127.060974
노원구,1673, 노원역?5번출구,201902,748,791,1539,37.653976,127.060974
노원구,1673, 노원역?5번출구,201903,1274,1407,2681,37.653976,127.060974
노원구,1673, 노원역?5번출구,201904,1887,2009,3896,37.653976,127.060974
노원구,1673, 노원역?5번출구,201905,3133,3428,6561,37.653976,127.060974
노원구,1673, 노원역?5번출구,201906,3731,3915,7646,37.653976,127.060974
노원구,1673, 노원역?5번출구,201907,3167,3361,6528,37.653976,127.060974
노원구,1673, 노원역?5번출구,201908,3155,3309,6464,37.653976,127.060974
노원구,1673, 노원역?5번출구,201909,2925,2997,5922,37.653976,127.060974
노원구,1673, 노원역?5번출구,201910,3532,3764,7296,37.653976,127.060974
노원구,1673, 노원역?5번출구,201911,2351,2429,4780,37.653976,127.060974
노원구,1673, 노원역 5번출구,201912,1561,1565,3126,37.653976,127.060974
노원구,1673, 노원역 5번출구,202001,1471,1520,2991,37.653976,127.060974
노원구,1673, 노원역 5번출구,202002,1285,1316,2601,37.653976,127.060974
노원구,1673, 노원역 5번출구,202003,2228,2202,4430,37.653976,127.060974
노원구,1673, 노원역 5번출구,202004,3064,3051,6115,37.653976,127.060974
노원구,1673, 노원역 5번출구,202005,3562,3578,7140,37.653976,127.060974
노원구,1673, 노원역 5번출구,202006,4373,4339,8712,37.653976,127.060974
노원구,1674, 서울북부고용센터앞,201901,315,332,647,37.653549,127.058083
노원구,1674, 서울북부고용센터앞,201902,319,336,655,37.653549,127.058083
노원구,1674, 서울북부고용센터앞,201903,658,614,1272,37.653549,127.058083
노원구,1674, 서울북부고용센터앞,201904,1260,1110,2370,37.653549,127.058083
노원구,1674, 서울북부고용센터앞,201905,2176,1934,4110,37.653549,127.058083
노원구,1674, 서울북부고용센터앞,201906,2318,2095,4413,37.653549,127.058083
노원구,1674, 서울북부고용센터앞,201907,1994,1915,3909,37.653549,127.058083
노원구,1674, 서울북부고용센터앞,201908,1834,1788,3622,37.653549,127.058083
노원구,1674, 서울북부고용센터앞,201909,1812,1716,3528,37.653549,127.058083
노원구,1674, 서울북부고용센터앞,201910,1935,1903,3838,37.653549,127.058083
노원구,1674, 서울북부고용센터앞,201911,1183,1119,2302,37.653549,127.058083
노원구,1674, 서울북부고용센터앞,201912,698,612,1310,37.653549,127.058083
노원구,1674, 서울북부고용센터앞,202001,644,603,1247,37.653549,127.058083
노원구,1674, 서울북부고용센터앞,202002,611,559,1170,37.653549,127.058083
노원구,1674, 서울북부고용센터앞,202003,1565,1536,3101,37.653549,127.058083
노원구,1674, 서울북부고용센터앞,202004,2424,2401,4825,37.653549,127.058083
노원구,1674, 서울북부고용센터앞,202005,2554,2526,5080,37.653549,127.058083
노원구,1674, 서울북부고용센터앞,202006,2767,2656,5423,37.653549,127.058083
노원구,1675, 월계문화체육센터,201901,110,76,186,37.626942,127.05513
노원구,1675, 월계문화체육센터,201902,72,43,115,37.626942,127.05513
노원구,1675, 월계문화체육센터,201903,135,78,213,37.626942,127.05513
노원구,1675, 월계문화체육센터,201904,208,125,333,37.626942,127.05513
노원구,1675, 월계문화체육센터,201905,303,144,447,37.626942,127.05513
노원구,1675, 월계문화체육센터,201906,268,155,423,37.626942,127.05513
노원구,1675, 월계문화체육센터,201907,232,141,373,37.626942,127.05513
노원구,1675, 월계문화체육센터,201908,243,156,399,37.626942,127.05513
노원구,1675, 월계문화체육센터,201909,328,196,524,37.626942,127.05513
노원구,1675, 월계문화체육센터,201910,328,184,512,37.626942,127.05513
노원구,1675, 월계문화체육센터,201911,264,161,425,37.626942,127.05513
노원구,1675, 월계문화체육센터,201912,187,75,262,37.626942,127.05513
노원구,1675, 월계문화체육센터,202001,108,55,163,37.626942,127.05513
노원구,1675, 월계문화체육센터,202002,49,12,61,37.626942,127.05513
노원구,1675, 월계문화체육센터,202003,53,34,87,37.626942,127.05513
노원구,1675, 월계문화체육센터,202004,58,43,101,37.626942,127.05513
노원구,1675, 월계문화체육센터,202005,98,54,152,37.626942,127.05513
노원구,1675, 월계문화체육센터,202006,123,78,201,37.626942,127.05513
노원구,1677, 육군사관학교 앞,201901,129,119,248,37.623165,127.0905
노원구,1677, 육군사관학교 앞,201902,96,96,192,37.623165,127.0905
노원구,1677, 육군사관학교 앞,201903,245,288,533,37.623165,127.0905
노원구,1677, 육군사관학교 앞,201904,590,594,1184,37.623165,127.0905
노원구,1677, 육군사관학교 앞,201905,863,876,1739,37.623165,127.0905
노원구,1677, 육군사관학교 앞,201906,898,900,1798,37.623165,127.0905
노원구,1677, 육군사관학교 앞,201907,696,735,1431,37.623165,127.0905
노원구,1677, 육군사관학교 앞,201908,680,709,1389,37.623165,127.0905
노원구,1677, 육군사관학교 앞,201909,716,751,1467,37.623165,127.0905
노원구,1677, 육군사관학교 앞,201910,1140,1175,2315,37.623165,127.0905
노원구,1677, 육군사관학교 앞,201911,631,616,1247,37.623165,127.0905
노원구,1677, 육군사관학교 앞,201912,240,236,476,37.623165,127.0905
노원구,1677, 육군사관학교 앞,202001,195,201,396,37.623165,127.0905
노원구,1677, 육군사관학교 앞,202002,245,225,470,37.623165,127.0905
노원구,1677, 육군사관학교 앞,202003,767,784,1551,37.623165,127.0905
노원구,1677, 육군사관학교 앞,202004,1166,1195,2361,37.623165,127.0905
노원구,1677, 육군사관학교 앞,202005,1665,1692,3357,37.623165,127.0905
노원구,1677, 육군사관학교 앞,202006,1681,1733,3414,37.623165,127.0905
노원구,1678, 성서대학교 밀알관,201901,113,117,230,37.648438,127.064445
노원구,1678, 성서대학교 밀알관,201902,94,86,180,37.648438,127.064445
노원구,1678, 성서대학교 밀알관,201903,240,229,469,37.648438,127.064445
노원구,1678, 성서대학교 밀알관,201904,403,351,754,37.648438,127.064445
노원구,1678, 성서대학교 밀알관,201905,745,606,1351,37.648438,127.064445
노원구,1678, 성서대학교 밀알관,201906,897,710,1607,37.648438,127.064445
노원구,1678, 성서대학교 밀알관,201907,560,469,1029,37.648438,127.064445
노원구,1678, 성서대학교 밀알관,201908,462,425,887,37.648438,127.064445
노원구,1678, 성서대학교 밀알관,201909,524,502,1026,37.648438,127.064445
노원구,1678, 성서대학교 밀알관,201910,717,699,1416,37.648438,127.064445
노원구,1678, 성서대학교 밀알관,201911,511,520,1031,37.648438,127.064445
노원구,1678, 성서대학교 밀알관,201912,235,243,478,37.648438,127.064445
노원구,1678, 성서대학교 밀알관,202001,96,72,168,37.648438,127.064445
노원구,1678, 성서대학교 밀알관,202002,105,100,205,37.648438,127.064445
노원구,1678, 성서대학교 밀알관,202003,217,168,385,37.648438,127.064445
노원구,1678, 성서대학교 밀알관,202004,268,229,497,37.648438,127.064445
노원구,1678, 성서대학교 밀알관,202005,263,249,512,37.648438,127.064445
노원구,1678, 성서대학교 밀알관,202006,405,364,769,37.648438,127.064445
노원구,1679, 삼육대 도서관,201901,48,34,82,37.64283,127.106667
노원구,1679, 삼육대 도서관,201902,46,35,81,37.64283,127.106667
노원구,1679, 삼육대 도서관,201903,228,169,397,37.64283,127.106667
노원구,1679, 삼육대 도서관,201904,349,293,642,37.64283,127.106667
노원구,1679, 삼육대 도서관,201905,667,619,1286,37.64283,127.106667
노원구,1679, 삼육대 도서관,201906,524,483,1007,37.64283,127.106667
노원구,1679, 삼육대 도서관,201907,330,327,657,37.64283,127.106667
노원구,1679, 삼육대 도서관,201908,389,345,734,37.64283,127.106667
노원구,1679, 삼육대 도서관,201909,430,414,844,37.64283,127.106667
노원구,1679, 삼육대 도서관,201910,419,412,831,37.64283,127.106667
노원구,1679, 삼육대 도서관,201911,250,226,476,37.64283,127.106667
노원구,1679, 삼육대 도서관,201912,142,125,267,37.64283,127.106667
노원구,1679, 삼육대 도서관,202001,130,102,232,37.64283,127.106667
노원구,1679, 삼육대 도서관,202002,98,84,182,37.64283,127.106667
노원구,1679, 삼육대 도서관,202003,193,185,378,37.64283,127.106667
노원구,1679, 삼육대 도서관,202004,237,234,471,37.64283,127.106667
노원구,1679, 삼육대 도서관,202005,260,242,502,37.64283,127.106667
노원구,1679, 삼육대 도서관,202006,335,295,630,37.64283,127.106667
노원구,1680, 삼육대 제3과학관,201901,14,12,26,37.642654,127.108383
노원구,1680, 삼육대 제3과학관,201902,18,15,33,37.642654,127.108383
노원구,1680, 삼육대 제3과학관,201903,83,50,133,37.642654,127.108383
노원구,1680, 삼육대 제3과학관,201904,96,63,159,37.642654,127.108383
노원구,1680, 삼육대 제3과학관,201905,213,146,359,37.642654,127.108383
노원구,1680, 삼육대 제3과학관,201906,177,132,309,37.642654,127.108383
노원구,1680, 삼육대 제3과학관,201907,130,113,243,37.642654,127.108383
노원구,1680, 삼육대 제3과학관,201908,146,114,260,37.642654,127.108383
노원구,1680, 삼육대 제3과학관,201909,122,97,219,37.642654,127.108383
노원구,1680, 삼육대 제3과학관,201910,66,56,122,37.642654,127.108383
노원구,1680, 삼육대 제3과학관,201911,66,42,108,37.642654,127.108383
노원구,1680, 삼육대 제3과학관,201912,32,12,44,37.642654,127.108383
노원구,1680, 삼육대 제3과학관,202001,27,9,36,37.642654,127.108383
노원구,1680, 삼육대 제3과학관,202002,19,7,26,37.642654,127.108383
노원구,1680, 삼육대 제3과학관,202003,54,39,93,37.642654,127.108383
노원구,1680, 삼육대 제3과학관,202004,77,68,145,37.642654,127.108383
노원구,1680, 삼육대 제3과학관,202005,44,26,70,37.642654,127.108383
노원구,1680, 삼육대 제3과학관,202006,68,42,110,37.642654,127.108383
노원구,1681, 현대6차 아파트,201901,334,269,603,37.645802,127.08226
노원구,1681, 현대6차 아파트,201902,320,288,608,37.645802,127.08226
노원구,1681, 현대6차 아파트,201903,572,506,1078,37.645802,127.08226
노원구,1681, 현대6차 아파트,201904,746,667,1413,37.645802,127.08226
노원구,1681, 현대6차 아파트,201905,1247,1180,2427,37.645802,127.08226
노원구,1681, 현대6차 아파트,201906,1403,1343,2746,37.645802,127.08226
노원구,1681, 현대6차 아파트,201907,1187,1108,2295,37.645802,127.08226
노원구,1681, 현대6차 아파트,201908,1156,1069,2225,37.645802,127.08226
노원구,1681, 현대6차 아파트,201909,1083,972,2055,37.645802,127.08226
노원구,1681, 현대6차 아파트,201910,1053,929,1982,37.645802,127.08226
노원구,1681, 현대6차 아파트,201911,738,573,1311,37.645802,127.08226
노원구,1681, 현대6차 아파트,201912,472,369,841,37.645802,127.08226
노원구,1681, 현대6차 아파트,202001,480,330,810,37.645802,127.08226
노원구,1681, 현대6차 아파트,202002,395,312,707,37.645802,127.08226
노원구,1681, 현대6차 아파트,202003,527,420,947,37.645802,127.08226
노원구,1681, 현대6차 아파트,202004,879,717,1596,37.645802,127.08226
노원구,1681, 현대6차 아파트,202005,1001,888,1889,37.645802,127.08226
노원구,1681, 현대6차 아파트,202006,1307,1196,2503,37.645802,127.08226
노원구,1682, 중계종합사회복지관 교차로,201901,238,181,419,37.656799,127.077606
노원구,1682, 중계종합사회복지관 교차로,201902,232,168,400,37.656799,127.077606
노원구,1682, 중계종합사회복지관 교차로,201903,549,449,998,37.656799,127.077606
노원구,1682, 중계종합사회복지관 교차로,201904,667,548,1215,37.656799,127.077606
노원구,1682, 중계종합사회복지관 교차로,201905,964,945,1909,37.656799,127.077606
노원구,1682, 중계종합사회복지관 교차로,201906,1175,1122,2297,37.656799,127.077606
노원구,1682, 중계종합사회복지관 교차로,201907,1069,1019,2088,37.656799,127.077606
노원구,1682, 중계종합사회복지관 교차로,201908,1161,1103,2264,37.656799,127.077606
노원구,1682, 중계종합사회복지관 교차로,201909,927,914,1841,37.656799,127.077606
노원구,1682, 중계종합사회복지관 교차로,201910,917,921,1838,37.656799,127.077606
노원구,1682, 중계종합사회복지관 교차로,201911,739,735,1474,37.656799,127.077606
노원구,1682, 중계종합사회복지관 교차로,201912,432,422,854,37.656799,127.077606
노원구,1682, 중계종합사회복지관 교차로,202001,479,443,922,37.656799,127.077606
노원구,1682, 중계종합사회복지관 교차로,202002,419,356,775,37.656799,127.077606
노원구,1682, 중계종합사회복지관 교차로,202003,654,602,1256,37.656799,127.077606
노원구,1682, 중계종합사회복지관 교차로,202004,707,654,1361,37.656799,127.077606
노원구,1682, 중계종합사회복지관 교차로,202005,673,665,1338,37.656799,127.077606
노원구,1682, 중계종합사회복지관 교차로,202006,1293,1253,2546,37.656799,127.077606
노원구,1683, 노원문화예술회관,201901,363,354,717,37.650459,127.080887
노원구,1683, 노원문화예술회관,201902,314,312,626,37.650459,127.080887
노원구,1683, 노원문화예술회관,201903,552,502,1054,37.650459,127.080887
노원구,1683, 노원문화예술회관,201904,768,708,1476,37.650459,127.080887
노원구,1683, 노원문화예술회관,201905,1393,1350,2743,37.650459,127.080887
노원구,1683, 노원문화예술회관,201906,1492,1421,2913,37.650459,127.080887
노원구,1683, 노원문화예술회관,201907,1741,1691,3432,37.650459,127.080887
노원구,1683, 노원문화예술회관,201908,1461,1407,2868,37.650459,127.080887
노원구,1683, 노원문화예술회관,201909,1144,1147,2291,37.650459,127.080887
노원구,1683, 노원문화예술회관,201910,1428,1341,2769,37.650459,127.080887
노원구,1683, 노원문화예술회관,201911,1056,947,2003,37.650459,127.080887
노원구,1683, 노원문화예술회관,201912,728,677,1405,37.650459,127.080887
노원구,1683, 노원문화예술회관,202001,709,641,1350,37.650459,127.080887
노원구,1683, 노원문화예술회관,202002,646,595,1241,37.650459,127.080887
노원구,1683, 노원문화예술회관,202003,914,878,1792,37.650459,127.080887
노원구,1683, 노원문화예술회관,202004,1131,1103,2234,37.650459,127.080887
노원구,1683, 노원문화예술회관,202005,1510,1456,2966,37.650459,127.080887
노원구,1683, 노원문화예술회관,202006,1921,1840,3761,37.650459,127.080887
노원구,1684, 태릉입구역 5번출구,201901,438,344,782,37.61832,127.07563
노원구,1684, 태릉입구역 5번출구,201902,391,324,715,37.61832,127.07563
노원구,1684, 태릉입구역 5번출구,201903,908,866,1774,37.61832,127.07563
노원구,1684, 태릉입구역 5번출구,201904,1508,1380,2888,37.61832,127.07563
노원구,1684, 태릉입구역 5번출구,201905,2681,2607,5288,37.61832,127.07563
노원구,1684, 태릉입구역 5번출구,201906,2830,2678,5508,37.61832,127.07563
노원구,1684, 태릉입구역 5번출구,201907,2596,2431,5027,37.61832,127.07563
노원구,1684, 태릉입구역 5번출구,201908,2326,2231,4557,37.61832,127.07563
노원구,1684, 태릉입구역 5번출구,201909,2633,2547,5180,37.61832,127.07563
노원구,1684, 태릉입구역 5번출구,201910,3283,3266,6549,37.61832,127.07563
노원구,1684, 태릉입구역 5번출구,201911,1810,1756,3566,37.61832,127.07563
노원구,1684, 태릉입구역 5번출구,201912,1016,968,1984,37.61832,127.07563
노원구,1684, 태릉입구역 5번출구,202001,935,907,1842,37.61832,127.07563
노원구,1684, 태릉입구역 5번출구,202002,876,792,1668,37.61832,127.07563
노원구,1684, 태릉입구역 5번출구,202003,1626,1552,3178,37.61832,127.07563
노원구,1684, 태릉입구역 5번출구,202004,2427,2389,4816,37.61832,127.07563
노원구,1684, 태릉입구역 5번출구,202005,3016,2972,5988,37.61832,127.07563
노원구,1684, 태릉입구역 5번출구,202006,3398,3257,6655,37.61832,127.07563
노원구,1685, 불암고등학교 앞 횡단보도,201901,165,139,304,37.64819,127.080482
노원구,1685, 불암고등학교 앞 횡단보도,201902,202,185,387,37.64819,127.080482
노원구,1685, 불암고등학교 앞 횡단보도,201903,408,347,755,37.64819,127.080482
노원구,1685, 불암고등학교 앞 횡단보도,201904,603,535,1138,37.64819,127.080482
노원구,1685, 불암고등학교 앞 횡단보도,201905,978,903,1881,37.64819,127.080482
노원구,1685, 불암고등학교 앞 횡단보도,201906,1033,965,1998,37.64819,127.080482
노원구,1685, 불암고등학교 앞 횡단보도,201907,976,944,1920,37.64819,127.080482
노원구,1685, 불암고등학교 앞 횡단보도,201908,920,872,1792,37.64819,127.080482
노원구,1685, 불암고등학교 앞 횡단보도,201909,805,795,1600,37.64819,127.080482
노원구,1685, 불암고등학교 앞 횡단보도,201910,843,808,1651,37.64819,127.080482
노원구,1685, 불암고등학교 앞 횡단보도,201911,691,644,1335,37.64819,127.080482
노원구,1685, 불암고등학교 앞 횡단보도,201912,400,361,761,37.64819,127.080482
노원구,1685, 불암고등학교 앞 횡단보도,202001,352,289,641,37.64819,127.080482
노원구,1685, 불암고등학교 앞 횡단보도,202002,355,292,647,37.64819,127.080482
노원구,1685, 불암고등학교 앞 횡단보도,202003,463,411,874,37.64819,127.080482
노원구,1685, 불암고등학교 앞 횡단보도,202004,726,671,1397,37.64819,127.080482
노원구,1685, 불암고등학교 앞 횡단보도,202005,863,808,1671,37.64819,127.080482
노원구,1685, 불암고등학교 앞 횡단보도,202006,1033,931,1964,37.64819,127.080482
노원구,1686, 온수골사거리(스타벅스앞),201901,348,301,649,37.66114,127.058052
노원구,1686, 온수골사거리(스타벅스앞),201902,336,299,635,37.66114,127.058052
노원구,1686, 온수골사거리(스타벅스앞),201903,672,565,1237,37.66114,127.058052
노원구,1686, 온수골사거리(스타벅스앞),201904,1036,909,1945,37.66114,127.058052
노원구,1686, 온수골사거리(스타벅스앞),201905,1065,941,2006,37.66114,127.058052
노원구,1686, 온수골사거리(스타벅스앞),201906,2416,2162,4578,37.66114,127.058052
노원구,1686, 온수골사거리(스타벅스앞),201907,2137,1982,4119,37.66114,127.058052
노원구,1686, 온수골사거리(스타벅스앞),201908,2220,2026,4246,37.66114,127.058052
노원구,1686, 온수골사거리(스타벅스앞),201909,2066,1927,3993,37.66114,127.058052
노원구,1686, 온수골사거리(스타벅스앞),201910,2186,2089,4275,37.66114,127.058052
노원구,1686, 온수골사거리(스타벅스앞),201911,1392,1311,2703,37.66114,127.058052
노원구,1686, 온수골사거리(스타벅스앞),201912,877,831,1708,37.66114,127.058052
노원구,1686, 온수골사거리(스타벅스앞),202001,805,737,1542,37.66114,127.058052
노원구,1686, 온수골사거리(스타벅스앞),202002,851,809,1660,37.66114,127.058052
노원구,1686, 온수골사거리(스타벅스앞),202003,1690,1680,3370,37.66114,127.058052
노원구,1686, 온수골사거리(스타벅스앞),202004,2238,2200,4438,37.66114,127.058052
노원구,1686, 온수골사거리(스타벅스앞),202005,2889,2793,5682,37.66114,127.058052
노원구,1686, 온수골사거리(스타벅스앞),202006,3406,3277,6683,37.66114,127.058052
마포구,1687, 서울월드컵경기장 테스트,201902,2,0,2,#N/A,#N/A
마포구,1687, 서울월드컵경기장 테스트,201904,7,9,16,#N/A,#N/A
마포구,1687, 서울월드컵경기장 테스트,201906,1,1,2,#N/A,#N/A
마포구,1687, 서울월드컵경기장 테스트,201907,1,2,3,#N/A,#N/A
마포구,1687, 서울월드컵경기장 테스트,201908,2,1,3,#N/A,#N/A
마포구,1687, 서울월드컵경기장 테스트,201909,2,1,3,#N/A,#N/A
마포구,1687, 서울월드컵경기장 테스트,201910,2,2,4,#N/A,#N/A
마포구,1687, 서울월드컵경기장 테스트,201911,3,0,3,#N/A,#N/A
마포구,1687, 서울월드컵경기장 테스트,201912,3,3,6,#N/A,#N/A
마포구,1687, 서울월드컵경기장 테스트,202002,1,2,3,#N/A,#N/A
마포구,1687, 서울월드컵경기장 테스트,202003,1,1,2,#N/A,#N/A
노원구,1688, 마들역 7번출구,201901,224,258,482,37.665661,127.057297
노원구,1688, 마들역 7번출구,201902,248,262,510,37.665661,127.057297
노원구,1688, 마들역 7번출구,201903,468,570,1038,37.665661,127.057297
노원구,1688, 마들역 7번출구,201904,892,963,1855,37.665661,127.057297
노원구,1688, 마들역 7번출구,201905,1728,1848,3576,37.665661,127.057297
노원구,1688, 마들역 7번출구,201906,1961,2080,4041,37.665661,127.057297
노원구,1688, 마들역 7번출구,201907,1895,1931,3826,37.665661,127.057297
노원구,1688, 마들역 7번출구,201908,1832,1876,3708,37.665661,127.057297
노원구,1688, 마들역 7번출구,201909,1797,1801,3598,37.665661,127.057297
노원구,1688, 마들역 7번출구,201910,2034,2055,4089,37.665661,127.057297
노원구,1688, 마들역 7번출구,201911,1157,1166,2323,37.665661,127.057297
노원구,1688, 마들역 7번출구,201912,550,567,1117,37.665661,127.057297
노원구,1688, 마들역 7번출구,202001,535,578,1113,37.665661,127.057297
노원구,1688, 마들역 7번출구,202002,578,591,1169,37.665661,127.057297
노원구,1688, 마들역 7번출구,202003,1272,1331,2603,37.665661,127.057297
노원구,1688, 마들역 7번출구,202004,1974,1992,3966,37.665661,127.057297
노원구,1688, 마들역 7번출구,202005,2310,2269,4579,37.665661,127.057297
노원구,1688, 마들역 7번출구,202006,2414,2408,4822,37.665661,127.057297
노원구,1689, 마들역 3번출구,201901,189,179,368,37.665249,127.057892
노원구,1689, 마들역 3번출구,201902,226,220,446,37.665249,127.057892
노원구,1689, 마들역 3번출구,201903,409,403,812,37.665249,127.057892
노원구,1689, 마들역 3번출구,201904,624,631,1255,37.665249,127.057892
노원구,1689, 마들역 3번출구,201905,1311,1307,2618,37.665249,127.057892
노원구,1689, 마들역 3번출구,201906,1482,1460,2942,37.665249,127.057892
노원구,1689, 마들역 3번출구,201907,1337,1336,2673,37.665249,127.057892
노원구,1689, 마들역 3번출구,201908,1268,1263,2531,37.665249,127.057892
노원구,1689, 마들역 3번출구,201909,1241,1223,2464,37.665249,127.057892
노원구,1689, 마들역 3번출구,201910,1353,1339,2692,37.665249,127.057892
노원구,1689, 마들역 3번출구,201911,810,800,1610,37.665249,127.057892
노원구,1689, 마들역 3번출구,201912,480,491,971,37.665249,127.057892
노원구,1689, 마들역 3번출구,202001,476,496,972,37.665249,127.057892
노원구,1689, 마들역 3번출구,202002,453,484,937,37.665249,127.057892
노원구,1689, 마들역 3번출구,202003,861,871,1732,37.665249,127.057892
노원구,1689, 마들역 3번출구,202004,1218,1210,2428,37.665249,127.057892
노원구,1689, 마들역 3번출구,202005,1423,1404,2827,37.665249,127.057892
노원구,1689, 마들역 3번출구,202006,1766,1754,3520,37.665249,127.057892
노원구,1690, 도봉운전면허시험장,201901,156,134,290,37.65773,127.059311
노원구,1690, 도봉운전면허시험장,201902,161,141,302,37.65773,127.059311
노원구,1690, 도봉운전면허시험장,201903,396,304,700,37.65773,127.059311
노원구,1690, 도봉운전면허시험장,201904,671,547,1218,37.65773,127.059311
노원구,1690, 도봉운전면허시험장,201905,1419,1263,2682,37.65773,127.059311
노원구,1690, 도봉운전면허시험장,201906,1208,1032,2240,37.65773,127.059311
노원구,1690, 도봉운전면허시험장,201907,1091,1003,2094,37.65773,127.059311
노원구,1690, 도봉운전면허시험장,201908,996,902,1898,37.65773,127.059311
노원구,1690, 도봉운전면허시험장,201909,987,883,1870,37.65773,127.059311
노원구,1690, 도봉운전면허시험장,201910,1100,1045,2145,37.65773,127.059311
노원구,1690, 도봉운전면허시험장,201911,768,701,1469,37.65773,127.059311
노원구,1690, 도봉운전면허시험장,201912,445,407,852,37.65773,127.059311
노원구,1690, 도봉운전면허시험장,202001,427,373,800,37.65773,127.059311
노원구,1690, 도봉운전면허시험장,202002,405,355,760,37.65773,127.059311
노원구,1690, 도봉운전면허시험장,202003,798,774,1572,37.65773,127.059311
노원구,1690, 도봉운전면허시험장,202004,1045,1029,2074,37.65773,127.059311
노원구,1690, 도봉운전면허시험장,202005,1361,1331,2692,37.65773,127.059311
노원구,1690, 도봉운전면허시험장,202006,1655,1615,3270,37.65773,127.059311
노원구,1691, 노원정보도서관,201901,410,421,831,37.660709,127.065331
노원구,1691, 노원정보도서관,201902,304,330,634,37.660709,127.065331
노원구,1691, 노원정보도서관,201903,552,559,1111,37.660709,127.065331
노원구,1691, 노원정보도서관,201904,817,788,1605,37.660709,127.065331
노원구,1691, 노원정보도서관,201905,1460,1336,2796,37.660709,127.065331
노원구,1691, 노원정보도서관,201906,1661,1615,3276,37.660709,127.065331
노원구,1691, 노원정보도서관,201907,1725,1726,3451,37.660709,127.065331
노원구,1691, 노원정보도서관,201908,1497,1502,2999,37.660709,127.065331
노원구,1691, 노원정보도서관,201909,1222,1226,2448,37.660709,127.065331
노원구,1691, 노원정보도서관,201910,1483,1470,2953,37.660709,127.065331
노원구,1691, 노원정보도서관,201911,1010,997,2007,37.660709,127.065331
노원구,1691, 노원정보도서관,201912,643,630,1273,37.660709,127.065331
노원구,1691, 노원정보도서관,202001,674,649,1323,37.660709,127.065331
노원구,1691, 노원정보도서관,202002,301,319,620,37.660709,127.065331
노원구,1691, 노원정보도서관,202003,471,469,940,37.660709,127.065331
노원구,1691, 노원정보도서관,202004,602,569,1171,37.660709,127.065331
노원구,1691, 노원정보도서관,202005,764,746,1510,37.660709,127.065331
노원구,1691, 노원정보도서관,202006,1063,984,2047,37.660709,127.065331
노원구,1692, 온곡초교 교차로,201901,272,194,466,37.664188,127.06601
노원구,1692, 온곡초교 교차로,201902,317,198,515,37.664188,127.06601
노원구,1692, 온곡초교 교차로,201903,566,346,912,37.664188,127.06601
노원구,1692, 온곡초교 교차로,201904,859,637,1496,37.664188,127.06601
노원구,1692, 온곡초교 교차로,201905,1556,1206,2762,37.664188,127.06601
노원구,1692, 온곡초교 교차로,201906,1748,1378,3126,37.664188,127.06601
노원구,1692, 온곡초교 교차로,201907,1532,1321,2853,37.664188,127.06601
노원구,1692, 온곡초교 교차로,201908,1492,1248,2740,37.664188,127.06601
노원구,1692, 온곡초교 교차로,201909,1373,1217,2590,37.664188,127.06601
노원구,1692, 온곡초교 교차로,201910,1446,1243,2689,37.664188,127.06601
노원구,1692, 온곡초교 교차로,201911,976,764,1740,37.664188,127.06601
노원구,1692, 온곡초교 교차로,201912,600,448,1048,37.664188,127.06601
노원구,1692, 온곡초교 교차로,202001,622,436,1058,37.664188,127.06601
노원구,1692, 온곡초교 교차로,202002,606,420,1026,37.664188,127.06601
노원구,1692, 온곡초교 교차로,202003,1085,875,1960,37.664188,127.06601
노원구,1692, 온곡초교 교차로,202004,1317,1137,2454,37.664188,127.06601
노원구,1692, 온곡초교 교차로,202005,1608,1412,3020,37.664188,127.06601
노원구,1692, 온곡초교 교차로,202006,1711,1341,3052,37.664188,127.06601
노원구,1693, 원자력 병원,201903,4,3,7,37.628189,127.082108
노원구,1693, 원자력 병원,201904,278,178,456,37.628189,127.082108
노원구,1693, 원자력 병원,201905,438,289,727,37.628189,127.082108
노원구,1693, 원자력 병원,201906,463,294,757,37.628189,127.082108
노원구,1693, 원자력 병원,201907,399,262,661,37.628189,127.082108
노원구,1693, 원자력 병원,201908,393,292,685,37.628189,127.082108
노원구,1693, 원자력 병원,201909,403,344,747,37.628189,127.082108
노원구,1693, 원자력 병원,201910,425,374,799,37.628189,127.082108
노원구,1693, 원자력 병원,201911,300,222,522,37.628189,127.082108
노원구,1693, 원자력 병원,201912,192,155,347,37.628189,127.082108
노원구,1693, 원자력 병원,202001,218,144,362,37.628189,127.082108
노원구,1693, 원자력 병원,202002,217,108,325,37.628189,127.082108
노원구,1693, 원자력 병원,202003,296,195,491,37.628189,127.082108
노원구,1693, 원자력 병원,202004,336,276,612,37.628189,127.082108
노원구,1693, 원자력 병원,202005,403,356,759,37.628189,127.082108
노원구,1693, 원자력 병원,202006,618,415,1033,37.628189,127.082108
노원구,1694,월계세양청마루아파트 후문,202004,0,1,1,#N/A,#N/A
노원구,1696,수락리버시티4단지,202004,1,1,2,37.686451,127.052834
노원구,1696,수락리버시티4단지,202005,48,43,91,37.686451,127.052834
노원구,1696,수락리버시티4단지,202006,535,574,1109,37.686451,127.052834
노원구,1697,상계주공2단지 219동,202004,2,2,4,37.650249,127.057152
노원구,1697,상계주공2단지 219동,202005,78,76,154,37.650249,127.057152
노원구,1697,상계주공2단지 219동,202006,1131,1086,2217,37.650249,127.057152
노원구,1700,상계보람아파트 202동,202004,2,2,4,37.665215,127.066139
노원구,1700,상계보람아파트 202동,202005,55,38,93,37.665215,127.066139
노원구,1700,상계보람아파트 202동,202006,797,597,1394,37.665215,127.066139
도봉구,1702, 녹천역 1번출구 앞,201901,127,170,297,37.646172,127.05056
도봉구,1702, 녹천역 1번출구 앞,201902,179,181,360,37.646172,127.05056
도봉구,1702, 녹천역 1번출구 앞,201903,354,414,768,37.646172,127.05056
도봉구,1702, 녹천역 1번출구 앞,201904,487,582,1069,37.646172,127.05056
도봉구,1702, 녹천역 1번출구 앞,201905,700,981,1681,37.646172,127.05056
도봉구,1702, 녹천역 1번출구 앞,201906,785,1051,1836,37.646172,127.05056
도봉구,1702, 녹천역 1번출구 앞,201907,871,1048,1919,37.646172,127.05056
도봉구,1702, 녹천역 1번출구 앞,201908,767,943,1710,37.646172,127.05056
도봉구,1702, 녹천역 1번출구 앞,201909,740,852,1592,37.646172,127.05056
도봉구,1702, 녹천역 1번출구 앞,201910,1013,1100,2113,37.646172,127.05056
도봉구,1702, 녹천역 1번출구 앞,201911,733,834,1567,37.646172,127.05056
도봉구,1702, 녹천역 1번출구 앞,201912,345,404,749,37.646172,127.05056
도봉구,1702, 녹천역 1번출구 앞,202001,300,303,603,37.646172,127.05056
도봉구,1702, 녹천역 1번출구 앞,202002,276,312,588,37.646172,127.05056
도봉구,1702, 녹천역 1번출구 앞,202003,574,556,1130,37.646172,127.05056
도봉구,1702, 녹천역 1번출구 앞,202004,716,728,1444,37.646172,127.05056
도봉구,1702, 녹천역 1번출구 앞,202005,1000,998,1998,37.646172,127.05056
도봉구,1702, 녹천역 1번출구 앞,202006,1014,1001,2015,37.646172,127.05056
도봉구,1703, 도봉산광역환승센터앞,201901,59,41,100,37.68972,127.045197
도봉구,1703, 도봉산광역환승센터앞,201902,73,78,151,37.68972,127.045197
도봉구,1703, 도봉산광역환승센터앞,201903,180,204,384,37.68972,127.045197
도봉구,1703, 도봉산광역환승센터앞,201904,331,388,719,37.68972,127.045197
도봉구,1703, 도봉산광역환승센터앞,201905,528,531,1059,37.68972,127.045197
도봉구,1703, 도봉산광역환승센터앞,201906,654,659,1313,37.68972,127.045197
도봉구,1703, 도봉산광역환승센터앞,201907,453,514,967,37.68972,127.045197
도봉구,1703, 도봉산광역환승센터앞,201908,483,434,917,37.68972,127.045197
도봉구,1703, 도봉산광역환승센터앞,201909,503,650,1153,37.68972,127.045197
도봉구,1703, 도봉산광역환승센터앞,201910,655,691,1346,37.68972,127.045197
도봉구,1703, 도봉산광역환승센터앞,201911,343,319,662,37.68972,127.045197
도봉구,1703, 도봉산광역환승센터앞,201912,129,129,258,37.68972,127.045197
도봉구,1703, 도봉산광역환승센터앞,202001,124,128,252,37.68972,127.045197
도봉구,1703, 도봉산광역환승센터앞,202002,183,196,379,37.68972,127.045197
도봉구,1703, 도봉산광역환승센터앞,202003,527,511,1038,37.68972,127.045197
도봉구,1703, 도봉산광역환승센터앞,202004,815,838,1653,37.68972,127.045197
도봉구,1703, 도봉산광역환승센터앞,202005,948,951,1899,37.68972,127.045197
도봉구,1703, 도봉산광역환승센터앞,202006,852,905,1757,37.68972,127.045197
도봉구,1705, 도봉구청 정문앞,201901,304,301,605,37.669224,127.046516
도봉구,1705, 도봉구청 정문앞,201902,282,310,592,37.669224,127.046516
도봉구,1705, 도봉구청 정문앞,201903,577,583,1160,37.669224,127.046516
도봉구,1705, 도봉구청 정문앞,201904,856,901,1757,37.669224,127.046516
도봉구,1705, 도봉구청 정문앞,201905,1444,1452,2896,37.669224,127.046516
도봉구,1705, 도봉구청 정문앞,201906,1650,1813,3463,37.669224,127.046516
도봉구,1705, 도봉구청 정문앞,201907,1555,1640,3195,37.669224,127.046516
도봉구,1705, 도봉구청 정문앞,201908,1358,1388,2746,37.669224,127.046516
도봉구,1705, 도봉구청 정문앞,201909,1288,1324,2612,37.669224,127.046516
도봉구,1705, 도봉구청 정문앞,201910,1508,1541,3049,37.669224,127.046516
도봉구,1705, 도봉구청 정문앞,201911,917,916,1833,37.669224,127.046516
도봉구,1705, 도봉구청 정문앞,201912,512,575,1087,37.669224,127.046516
도봉구,1705, 도봉구청 정문앞,202001,431,462,893,37.669224,127.046516
도봉구,1705, 도봉구청 정문앞,202002,524,535,1059,37.669224,127.046516
도봉구,1705, 도봉구청 정문앞,202003,990,975,1965,37.669224,127.046516
도봉구,1705, 도봉구청 정문앞,202004,1520,1516,3036,37.669224,127.046516
도봉구,1705, 도봉구청 정문앞,202005,1850,1855,3705,37.669224,127.046516
도봉구,1705, 도봉구청 정문앞,202006,1841,1843,3684,37.669224,127.046516
도봉구,1706, 기업은행 앞,201901,243,283,526,37.665665,127.042671
도봉구,1706, 기업은행 앞,201902,232,243,475,37.665665,127.042671
도봉구,1706, 기업은행 앞,201903,566,587,1153,37.665665,127.042671
도봉구,1706, 기업은행 앞,201904,771,850,1621,37.665665,127.042671
도봉구,1706, 기업은행 앞,201905,1193,1232,2425,37.665665,127.042671
도봉구,1706, 기업은행 앞,201906,1331,1403,2734,37.665665,127.042671
도봉구,1706, 기업은행 앞,201907,1285,1429,2714,37.665665,127.042671
도봉구,1706, 기업은행 앞,201908,1188,1341,2529,37.665665,127.042671
도봉구,1706, 기업은행 앞,201909,1267,1345,2612,37.665665,127.042671
도봉구,1706, 기업은행 앞,201910,1351,1353,2704,37.665665,127.042671
도봉구,1706, 기업은행 앞,201911,896,908,1804,37.665665,127.042671
도봉구,1706, 기업은행 앞,201912,576,581,1157,37.665665,127.042671
도봉구,1706, 기업은행 앞,202001,492,480,972,37.665665,127.042671
도봉구,1706, 기업은행 앞,202002,534,535,1069,37.665665,127.042671
도봉구,1706, 기업은행 앞,202003,923,941,1864,37.665665,127.042671
도봉구,1706, 기업은행 앞,202004,1194,1176,2370,37.665665,127.042671
도봉구,1706, 기업은행 앞,202005,1460,1454,2914,37.665665,127.042671
도봉구,1706, 기업은행 앞,202006,1392,1468,2860,37.665665,127.042671
도봉구,1707, 도봉구민회관,201901,259,222,481,37.654461,127.038513
도봉구,1707, 도봉구민회관,201902,274,239,513,37.654461,127.038513
도봉구,1707, 도봉구민회관,201903,591,533,1124,37.654461,127.038513
도봉구,1707, 도봉구민회관,201904,803,686,1489,37.654461,127.038513
도봉구,1707, 도봉구민회관,201905,1316,1177,2493,37.654461,127.038513
도봉구,1707, 도봉구민회관,201906,1569,1362,2931,37.654461,127.038513
도봉구,1707, 도봉구민회관,201907,1384,1272,2656,37.654461,127.038513
도봉구,1707, 도봉구민회관,201908,1323,1147,2470,37.654461,127.038513
도봉구,1707, 도봉구민회관,201909,1354,1157,2511,37.654461,127.038513
도봉구,1707, 도봉구민회관,201910,1541,1363,2904,37.654461,127.038513
도봉구,1707, 도봉구민회관,201911,1019,882,1901,37.654461,127.038513
도봉구,1707, 도봉구민회관,201912,622,536,1158,37.654461,127.038513
도봉구,1707, 도봉구민회관,202001,540,448,988,37.654461,127.038513
도봉구,1707, 도봉구민회관,202002,515,470,985,37.654461,127.038513
도봉구,1707, 도봉구민회관,202003,926,829,1755,37.654461,127.038513
도봉구,1707, 도봉구민회관,202004,1065,1031,2096,37.654461,127.038513
도봉구,1707, 도봉구민회관,202005,1278,1194,2472,37.654461,127.038513
도봉구,1707, 도봉구민회관,202006,1557,1478,3035,37.654461,127.038513
도봉구,1708, 보건소사거리(다비치안경창동점),201901,301,292,593,37.65683,127.039848
도봉구,1708, 보건소사거리(다비치안경창동점),201902,267,304,571,37.65683,127.039848
도봉구,1708, 보건소사거리(다비치안경창동점),201903,577,572,1149,37.65683,127.039848
도봉구,1708, 보건소사거리(다비치안경창동점),201904,850,863,1713,37.65683,127.039848
도봉구,1708, 보건소사거리(다비치안경창동점),201905,1554,1650,3204,37.65683,127.039848
도봉구,1708, 보건소사거리(다비치안경창동점),201906,1786,1829,3615,37.65683,127.039848
도봉구,1708, 보건소사거리(다비치안경창동점),201907,1626,1650,3276,37.65683,127.039848
도봉구,1708, 보건소사거리(다비치안경창동점),201908,1527,1541,3068,37.65683,127.039848
도봉구,1708, 보건소사거리(다비치안경창동점),201909,1479,1479,2958,37.65683,127.039848
도봉구,1708, 보건소사거리(다비치안경창동점),201910,1666,1707,3373,37.65683,127.039848
도봉구,1708, 보건소사거리(다비치안경창동점),201911,1191,1238,2429,37.65683,127.039848
도봉구,1708, 보건소사거리(다비치안경창동점),201912,668,664,1332,37.65683,127.039848
도봉구,1708, 보건소사거리(다비치안경창동점),202001,600,559,1159,37.65683,127.039848
도봉구,1708, 보건소사거리(다비치안경창동점),202002,632,618,1250,37.65683,127.039848
도봉구,1708, 보건소사거리(다비치안경창동점),202003,1149,1184,2333,37.65683,127.039848
도봉구,1708, 보건소사거리(다비치안경창동점),202004,1562,1579,3141,37.65683,127.039848
도봉구,1708, 보건소사거리(다비치안경창동점),202005,1889,1888,3777,37.65683,127.039848
도봉구,1708, 보건소사거리(다비치안경창동점),202006,2182,2227,4409,37.65683,127.039848
도봉구,1709, 쌍문역4번출구 주변,201901,461,441,902,37.650127,127.035347
도봉구,1709, 쌍문역4번출구 주변,201902,340,290,630,37.650127,127.035347
도봉구,1709, 쌍문역4번출구 주변,201903,641,598,1239,37.650127,127.035347
도봉구,1709, 쌍문역4번출구 주변,201904,1133,1022,2155,37.650127,127.035347
도봉구,1709, 쌍문역4번출구 주변,201905,1919,1689,3608,37.650127,127.035347
도봉구,1709, 쌍문역4번출구 주변,201906,2239,2022,4261,37.650127,127.035347
도봉구,1709, 쌍문역4번출구 주변,201907,1854,1651,3505,37.650127,127.035347
도봉구,1709, 쌍문역4번출구 주변,201908,1659,1530,3189,37.650127,127.035347
도봉구,1709, 쌍문역4번출구 주변,201909,1773,1634,3407,37.650127,127.035347
도봉구,1709, 쌍문역4번출구 주변,201910,2085,2005,4090,37.650127,127.035347
도봉구,1709, 쌍문역4번출구 주변,201911,1215,1151,2366,37.650127,127.035347
도봉구,1709, 쌍문역4번출구 주변,201912,678,601,1279,37.650127,127.035347
도봉구,1709, 쌍문역4번출구 주변,202001,686,593,1279,37.650127,127.035347
도봉구,1709, 쌍문역4번출구 주변,202002,705,654,1359,37.650127,127.035347
도봉구,1709, 쌍문역4번출구 주변,202003,1193,1129,2322,37.650127,127.035347
도봉구,1709, 쌍문역4번출구 주변,202004,1766,1709,3475,37.650127,127.035347
도봉구,1709, 쌍문역4번출구 주변,202005,2045,2023,4068,37.650127,127.035347
도봉구,1709, 쌍문역4번출구 주변,202006,1993,1917,3910,37.650127,127.035347
도봉구,1712, 창동역공영주차장앞,201901,391,362,753,#N/A,#N/A
도봉구,1712, 창동역공영주차장앞,201902,393,347,740,#N/A,#N/A
도봉구,1712, 창동역공영주차장앞,201903,783,728,1511,#N/A,#N/A
도봉구,1712, 창동역공영주차장앞,201904,1261,1143,2404,#N/A,#N/A
도봉구,1712, 창동역공영주차장앞,201905,1825,1649,3474,#N/A,#N/A
도봉구,1712, 창동역공영주차장앞,201906,870,774,1644,#N/A,#N/A
도봉구,1713, 쌍문동 청소년 랜드,201901,242,185,427,#N/A,#N/A
도봉구,1713, 쌍문동 청소년 랜드,201902,209,165,374,#N/A,#N/A
도봉구,1713, 쌍문동 청소년 랜드,201903,436,385,821,#N/A,#N/A
도봉구,1713, 쌍문동 청소년 랜드,201904,539,504,1043,#N/A,#N/A
도봉구,1713, 쌍문동 청소년 랜드,201905,882,840,1722,#N/A,#N/A
도봉구,1713, 쌍문동 청소년 랜드,201906,905,904,1809,#N/A,#N/A
도봉구,1713, 쌍문동 청소년 랜드,201907,844,898,1742,#N/A,#N/A
도봉구,1713, 쌍문동 청소년 랜드,201908,806,830,1636,#N/A,#N/A
도봉구,1713, 쌍문동 청소년 랜드,201909,840,863,1703,#N/A,#N/A
도봉구,1713, 쌍문동 청소년 랜드,201910,971,966,1937,#N/A,#N/A
도봉구,1713, 쌍문동 청소년 랜드,201911,614,612,1226,#N/A,#N/A
도봉구,1713, 쌍문동 청소년 랜드,201912,341,323,664,#N/A,#N/A
도봉구,1713, 쌍문동 청소년 랜드,202001,332,325,657,#N/A,#N/A
도봉구,1713, 쌍문동 청소년 랜드,202002,346,341,687,#N/A,#N/A
도봉구,1713, 쌍문동 청소년 랜드,202003,703,696,1399,#N/A,#N/A
도봉구,1713, 쌍문동 청소년 랜드,202004,1051,1048,2099,#N/A,#N/A
도봉구,1713, 쌍문동 청소년 랜드,202005,1142,1129,2271,#N/A,#N/A
도봉구,1713, 쌍문동 청소년 랜드,202006,1184,1215,2399,#N/A,#N/A
도봉구,1714, 도봉문화정보도서관 삼거리,201901,105,32,137,37.64463,127.044609
도봉구,1714, 도봉문화정보도서관 삼거리,201902,107,44,151,37.64463,127.044609
도봉구,1714, 도봉문화정보도서관 삼거리,201903,218,96,314,37.64463,127.044609
도봉구,1714, 도봉문화정보도서관 삼거리,201904,267,129,396,37.64463,127.044609
도봉구,1714, 도봉문화정보도서관 삼거리,201905,383,157,540,37.64463,127.044609
도봉구,1714, 도봉문화정보도서관 삼거리,201906,399,146,545,37.64463,127.044609
도봉구,1714, 도봉문화정보도서관 삼거리,201907,368,142,510,37.64463,127.044609
도봉구,1714, 도봉문화정보도서관 삼거리,201908,335,100,435,37.64463,127.044609
도봉구,1714, 도봉문화정보도서관 삼거리,201909,355,213,568,37.64463,127.044609
도봉구,1714, 도봉문화정보도서관 삼거리,201910,385,139,524,37.64463,127.044609
도봉구,1714, 도봉문화정보도서관 삼거리,201911,261,98,359,37.64463,127.044609
도봉구,1714, 도봉문화정보도서관 삼거리,201912,152,42,194,37.64463,127.044609
도봉구,1714, 도봉문화정보도서관 삼거리,202001,177,42,219,37.64463,127.044609
도봉구,1714, 도봉문화정보도서관 삼거리,202002,144,39,183,37.64463,127.044609
도봉구,1714, 도봉문화정보도서관 삼거리,202003,190,52,242,37.64463,127.044609
도봉구,1714, 도봉문화정보도서관 삼거리,202004,228,105,333,37.64463,127.044609
도봉구,1714, 도봉문화정보도서관 삼거리,202005,244,116,360,37.64463,127.044609
도봉구,1714, 도봉문화정보도서관 삼거리,202006,337,128,465,37.64463,127.044609
도봉구,1715, 서울특별시교육청도봉도서관,201901,175,169,344,37.653179,127.012787
도봉구,1715, 서울특별시교육청도봉도서관,201902,159,148,307,37.653179,127.012787
도봉구,1715, 서울특별시교육청도봉도서관,201903,415,388,803,37.653179,127.012787
도봉구,1715, 서울특별시교육청도봉도서관,201904,720,722,1442,37.653179,127.012787
도봉구,1715, 서울특별시교육청도봉도서관,201905,988,894,1882,37.653179,127.012787
도봉구,1715, 서울특별시교육청도봉도서관,201906,984,951,1935,37.653179,127.012787
도봉구,1715, 서울특별시교육청도봉도서관,201907,907,869,1776,37.653179,127.012787
도봉구,1715, 서울특별시교육청도봉도서관,201908,887,877,1764,37.653179,127.012787
도봉구,1715, 서울특별시교육청도봉도서관,201909,1079,1073,2152,37.653179,127.012787
도봉구,1715, 서울특별시교육청도봉도서관,201910,1181,1210,2391,37.653179,127.012787
도봉구,1715, 서울특별시교육청도봉도서관,201911,646,614,1260,37.653179,127.012787
도봉구,1715, 서울특별시교육청도봉도서관,201912,358,361,719,37.653179,127.012787
도봉구,1715, 서울특별시교육청도봉도서관,202001,327,334,661,37.653179,127.012787
도봉구,1715, 서울특별시교육청도봉도서관,202002,280,303,583,37.653179,127.012787
도봉구,1715, 서울특별시교육청도봉도서관,202003,723,733,1456,37.653179,127.012787
도봉구,1715, 서울특별시교육청도봉도서관,202004,1141,1119,2260,37.653179,127.012787
도봉구,1715, 서울특별시교육청도봉도서관,202005,1596,1589,3185,37.653179,127.012787
도봉구,1715, 서울특별시교육청도봉도서관,202006,1454,1406,2860,37.653179,127.012787
도봉구,1716, 하나로마트 창동점,201901,172,221,393,37.654202,127.050728
도봉구,1716, 하나로마트 창동점,201902,210,245,455,37.654202,127.050728
도봉구,1716, 하나로마트 창동점,201903,352,401,753,37.654202,127.050728
도봉구,1716, 하나로마트 창동점,201904,603,707,1310,37.654202,127.050728
도봉구,1716, 하나로마트 창동점,201905,1086,1121,2207,37.654202,127.050728
도봉구,1716, 하나로마트 창동점,201906,1761,1746,3507,37.654202,127.050728
도봉구,1716, 하나로마트 창동점,201907,2118,2125,4243,37.654202,127.050728
도봉구,1716, 하나로마트 창동점,201908,2132,2110,4242,37.654202,127.050728
도봉구,1716, 하나로마트 창동점,201909,2141,2172,4313,37.654202,127.050728
도봉구,1716, 하나로마트 창동점,201910,2190,2394,4584,37.654202,127.050728
도봉구,1716, 하나로마트 창동점,201911,1481,1596,3077,37.654202,127.050728
도봉구,1716, 하나로마트 창동점,201912,751,788,1539,37.654202,127.050728
도봉구,1716, 하나로마트 창동점,202001,748,799,1547,37.654202,127.050728
도봉구,1716, 하나로마트 창동점,202002,735,773,1508,37.654202,127.050728
도봉구,1716, 하나로마트 창동점,202003,1688,1724,3412,37.654202,127.050728
도봉구,1716, 하나로마트 창동점,202004,2438,2520,4958,37.654202,127.050728
도봉구,1716, 하나로마트 창동점,202005,3036,3116,6152,37.654202,127.050728
도봉구,1716, 하나로마트 창동점,202006,2962,3074,6036,37.654202,127.050728
도봉구,1717, 시립창동운동장 입구,201901,67,46,113,37.655708,127.050102
도봉구,1717, 시립창동운동장 입구,201902,80,64,144,37.655708,127.050102
도봉구,1717, 시립창동운동장 입구,201903,162,101,263,37.655708,127.050102
도봉구,1717, 시립창동운동장 입구,201904,207,190,397,37.655708,127.050102
도봉구,1717, 시립창동운동장 입구,201905,327,278,605,37.655708,127.050102
도봉구,1717, 시립창동운동장 입구,201906,451,348,799,37.655708,127.050102
도봉구,1717, 시립창동운동장 입구,201907,360,260,620,37.655708,127.050102
도봉구,1717, 시립창동운동장 입구,201908,398,288,686,37.655708,127.050102
도봉구,1717, 시립창동운동장 입구,201909,402,256,658,37.655708,127.050102
도봉구,1717, 시립창동운동장 입구,201910,588,445,1033,37.655708,127.050102
도봉구,1717, 시립창동운동장 입구,201911,247,208,455,37.655708,127.050102
도봉구,1717, 시립창동운동장 입구,201912,158,136,294,37.655708,127.050102
도봉구,1717, 시립창동운동장 입구,202001,131,113,244,37.655708,127.050102
도봉구,1717, 시립창동운동장 입구,202002,98,82,180,37.655708,127.050102
도봉구,1717, 시립창동운동장 입구,202003,334,263,597,37.655708,127.050102
도봉구,1717, 시립창동운동장 입구,202004,396,313,709,37.655708,127.050102
도봉구,1717, 시립창동운동장 입구,202005,435,354,789,37.655708,127.050102
도봉구,1717, 시립창동운동장 입구,202006,526,426,952,37.655708,127.050102
도봉구,1719, 신도봉사거리 버스정류장,201901,173,200,373,37.673283,127.043991
도봉구,1719, 신도봉사거리 버스정류장,201902,205,222,427,37.673283,127.043991
도봉구,1719, 신도봉사거리 버스정류장,201903,295,291,586,37.673283,127.043991
도봉구,1719, 신도봉사거리 버스정류장,201904,370,408,778,37.673283,127.043991
도봉구,1719, 신도봉사거리 버스정류장,201905,556,615,1171,37.673283,127.043991
도봉구,1719, 신도봉사거리 버스정류장,201906,737,757,1494,37.673283,127.043991
도봉구,1719, 신도봉사거리 버스정류장,201907,656,762,1418,37.673283,127.043991
도봉구,1719, 신도봉사거리 버스정류장,201908,622,782,1404,37.673283,127.043991
도봉구,1719, 신도봉사거리 버스정류장,201909,660,731,1391,37.673283,127.043991
도봉구,1719, 신도봉사거리 버스정류장,201910,686,766,1452,37.673283,127.043991
도봉구,1719, 신도봉사거리 버스정류장,201911,439,492,931,37.673283,127.043991
도봉구,1719, 신도봉사거리 버스정류장,201912,257,309,566,37.673283,127.043991
도봉구,1719, 신도봉사거리 버스정류장,202001,223,279,502,37.673283,127.043991
도봉구,1719, 신도봉사거리 버스정류장,202002,239,238,477,37.673283,127.043991
도봉구,1719, 신도봉사거리 버스정류장,202003,459,456,915,37.673283,127.043991
도봉구,1719, 신도봉사거리 버스정류장,202004,570,570,1140,37.673283,127.043991
도봉구,1719, 신도봉사거리 버스정류장,202005,672,694,1366,37.673283,127.043991
도봉구,1719, 신도봉사거리 버스정류장,202006,769,855,1624,37.673283,127.043991
도봉구,1720, 도봉구청 옆(중랑천변),201901,255,227,482,37.668671,127.047981
도봉구,1720, 도봉구청 옆(중랑천변),201902,330,311,641,37.668671,127.047981
도봉구,1720, 도봉구청 옆(중랑천변),201903,687,621,1308,37.668671,127.047981
도봉구,1720, 도봉구청 옆(중랑천변),201904,1345,1362,2707,37.668671,127.047981
도봉구,1720, 도봉구청 옆(중랑천변),201905,1905,2080,3985,37.668671,127.047981
도봉구,1720, 도봉구청 옆(중랑천변),201906,1947,2116,4063,37.668671,127.047981
도봉구,1720, 도봉구청 옆(중랑천변),201907,1874,1970,3844,37.668671,127.047981
도봉구,1720, 도봉구청 옆(중랑천변),201908,1916,2087,4003,37.668671,127.047981
도봉구,1720, 도봉구청 옆(중랑천변),201909,2076,2069,4145,37.668671,127.047981
도봉구,1720, 도봉구청 옆(중랑천변),201910,1939,1984,3923,37.668671,127.047981
도봉구,1720, 도봉구청 옆(중랑천변),201911,997,968,1965,37.668671,127.047981
도봉구,1720, 도봉구청 옆(중랑천변),201912,460,469,929,37.668671,127.047981
도봉구,1720, 도봉구청 옆(중랑천변),202001,566,560,1126,37.668671,127.047981
도봉구,1720, 도봉구청 옆(중랑천변),202002,748,728,1476,37.668671,127.047981
도봉구,1720, 도봉구청 옆(중랑천변),202003,2245,2286,4531,37.668671,127.047981
도봉구,1720, 도봉구청 옆(중랑천변),202004,3596,3599,7195,37.668671,127.047981
도봉구,1720, 도봉구청 옆(중랑천변),202005,3905,3958,7863,37.668671,127.047981
도봉구,1720, 도봉구청 옆(중랑천변),202006,3450,3533,6983,37.668671,127.047981
도봉구,1721, 창동역 2번출구,201901,435,567,1002,37.653015,127.046997
도봉구,1721, 창동역 2번출구,201902,420,502,922,37.653015,127.046997
도봉구,1721, 창동역 2번출구,201903,864,1128,1992,37.653015,127.046997
도봉구,1721, 창동역 2번출구,201904,1277,1621,2898,37.653015,127.046997
도봉구,1721, 창동역 2번출구,201905,2287,2620,4907,37.653015,127.046997
도봉구,1721, 창동역 2번출구,201906,3081,3386,6467,37.653015,127.046997
도봉구,1721, 창동역 2번출구,201907,2937,3157,6094,37.653015,127.046997
도봉구,1721, 창동역 2번출구,201908,2879,3205,6084,37.653015,127.046997
도봉구,1721, 창동역 2번출구,201909,2714,3054,5768,37.653015,127.046997
도봉구,1721, 창동역 2번출구,201910,3164,3661,6825,37.653015,127.046997
도봉구,1721, 창동역 2번출구,201911,2099,2537,4636,37.653015,127.046997
도봉구,1721, 창동역 2번출구,201912,1307,1603,2910,37.653015,127.046997
도봉구,1721, 창동역 2번출구,202001,1069,1357,2426,37.653015,127.046997
도봉구,1721, 창동역 2번출구,202002,1124,1336,2460,37.653015,127.046997
도봉구,1721, 창동역 2번출구,202003,1953,2117,4070,37.653015,127.046997
도봉구,1721, 창동역 2번출구,202004,2470,2632,5102,37.653015,127.046997
도봉구,1721, 창동역 2번출구,202005,3110,3269,6379,37.653015,127.046997
도봉구,1721, 창동역 2번출구,202006,3440,3850,7290,37.653015,127.046997
도봉구,1722, 창동청소년수련관,201901,169,219,388,37.657799,127.050049
도봉구,1722, 창동청소년수련관,201902,182,201,383,37.657799,127.050049
도봉구,1722, 창동청소년수련관,201903,334,339,673,37.657799,127.050049
도봉구,1722, 창동청소년수련관,201904,505,538,1043,37.657799,127.050049
도봉구,1722, 창동청소년수련관,201905,848,946,1794,37.657799,127.050049
도봉구,1722, 창동청소년수련관,201906,1108,1163,2271,37.657799,127.050049
도봉구,1722, 창동청소년수련관,201907,1098,1119,2217,37.657799,127.050049
도봉구,1722, 창동청소년수련관,201908,999,982,1981,37.657799,127.050049
도봉구,1722, 창동청소년수련관,201909,963,942,1905,37.657799,127.050049
도봉구,1722, 창동청소년수련관,201910,1109,1085,2194,37.657799,127.050049
도봉구,1722, 창동청소년수련관,201911,640,649,1289,37.657799,127.050049
도봉구,1722, 창동청소년수련관,201912,403,396,799,37.657799,127.050049
도봉구,1722, 창동청소년수련관,202001,391,414,805,37.657799,127.050049
도봉구,1722, 창동청소년수련관,202002,328,341,669,37.657799,127.050049
도봉구,1722, 창동청소년수련관,202003,725,680,1405,37.657799,127.050049
도봉구,1722, 창동청소년수련관,202004,1031,966,1997,37.657799,127.050049
도봉구,1722, 창동청소년수련관,202005,1174,1162,2336,37.657799,127.050049
도봉구,1722, 창동청소년수련관,202006,1230,1203,2433,37.657799,127.050049
도봉구,1723, 방학동학마을도서관,201901,231,216,447,37.662079,127.027718
도봉구,1723, 방학동학마을도서관,201902,296,309,605,37.662079,127.027718
도봉구,1723, 방학동학마을도서관,201903,477,551,1028,37.662079,127.027718
도봉구,1723, 방학동학마을도서관,201904,636,789,1425,37.662079,127.027718
도봉구,1723, 방학동학마을도서관,201905,1039,1349,2388,37.662079,127.027718
도봉구,1723, 방학동학마을도서관,201906,1315,1715,3030,37.662079,127.027718
도봉구,1723, 방학동학마을도서관,201907,1115,1453,2568,37.662079,127.027718
도봉구,1723, 방학동학마을도서관,201908,1055,1308,2363,37.662079,127.027718
도봉구,1723, 방학동학마을도서관,201909,1126,1416,2542,37.662079,127.027718
도봉구,1723, 방학동학마을도서관,201910,1293,1486,2779,37.662079,127.027718
도봉구,1723, 방학동학마을도서관,201911,859,958,1817,37.662079,127.027718
도봉구,1723, 방학동학마을도서관,201912,458,482,940,37.662079,127.027718
도봉구,1723, 방학동학마을도서관,202001,428,481,909,37.662079,127.027718
도봉구,1723, 방학동학마을도서관,202002,394,432,826,37.662079,127.027718
도봉구,1723, 방학동학마을도서관,202003,811,895,1706,37.662079,127.027718
도봉구,1723, 방학동학마을도서관,202004,1113,1281,2394,37.662079,127.027718
도봉구,1723, 방학동학마을도서관,202005,1310,1480,2790,37.662079,127.027718
도봉구,1723, 방학동학마을도서관,202006,1140,1288,2428,37.662079,127.027718
도봉구,1725, 창1동주민센터,201901,101,122,223,37.647503,127.043312
도봉구,1725, 창1동주민센터,201902,67,81,148,37.647503,127.043312
도봉구,1725, 창1동주민센터,201903,224,199,423,37.647503,127.043312
도봉구,1725, 창1동주민센터,201904,298,259,557,37.647503,127.043312
도봉구,1725, 창1동주민센터,201905,408,383,791,37.647503,127.043312
도봉구,1725, 창1동주민센터,201906,479,486,965,37.647503,127.043312
도봉구,1725, 창1동주민센터,201907,516,492,1008,37.647503,127.043312
도봉구,1725, 창1동주민센터,201908,488,527,1015,37.647503,127.043312
도봉구,1725, 창1동주민센터,201909,482,498,980,37.647503,127.043312
도봉구,1725, 창1동주민센터,201910,637,658,1295,37.647503,127.043312
도봉구,1725, 창1동주민센터,201911,424,403,827,37.647503,127.043312
도봉구,1725, 창1동주민센터,201912,247,225,472,37.647503,127.043312
도봉구,1725, 창1동주민센터,202001,186,185,371,37.647503,127.043312
도봉구,1725, 창1동주민센터,202002,153,137,290,37.647503,127.043312
도봉구,1725, 창1동주민센터,202003,334,307,641,37.647503,127.043312
도봉구,1725, 창1동주민센터,202004,475,435,910,37.647503,127.043312
도봉구,1725, 창1동주민센터,202005,614,601,1215,37.647503,127.043312
도봉구,1725, 창1동주민센터,202006,659,695,1354,37.647503,127.043312
도봉구,1726, 삼익세라믹아파트교차로,201901,308,262,570,37.658588,127.03521
도봉구,1726, 삼익세라믹아파트교차로,201902,324,314,638,37.658588,127.03521
도봉구,1726, 삼익세라믹아파트교차로,201903,620,618,1238,37.658588,127.03521
도봉구,1726, 삼익세라믹아파트교차로,201904,874,965,1839,37.658588,127.03521
도봉구,1726, 삼익세라믹아파트교차로,201905,1369,1545,2914,37.658588,127.03521
도봉구,1726, 삼익세라믹아파트교차로,201906,1600,1623,3223,37.658588,127.03521
도봉구,1726, 삼익세라믹아파트교차로,201907,1460,1552,3012,37.658588,127.03521
도봉구,1726, 삼익세라믹아파트교차로,201908,1327,1345,2672,37.658588,127.03521
도봉구,1726, 삼익세라믹아파트교차로,201909,1267,1355,2622,37.658588,127.03521
도봉구,1726, 삼익세라믹아파트교차로,201910,1492,1549,3041,37.658588,127.03521
도봉구,1726, 삼익세라믹아파트교차로,201911,1101,1081,2182,37.658588,127.03521
도봉구,1726, 삼익세라믹아파트교차로,201912,550,554,1104,37.658588,127.03521
도봉구,1726, 삼익세라믹아파트교차로,202001,438,436,874,37.658588,127.03521
도봉구,1726, 삼익세라믹아파트교차로,202002,445,458,903,37.658588,127.03521
도봉구,1726, 삼익세라믹아파트교차로,202003,1083,1113,2196,37.658588,127.03521
도봉구,1726, 삼익세라믹아파트교차로,202004,1578,1578,3156,37.658588,127.03521
도봉구,1726, 삼익세라믹아파트교차로,202005,1992,2003,3995,37.658588,127.03521
도봉구,1726, 삼익세라믹아파트교차로,202006,1658,1680,3338,37.658588,127.03521
도봉구,1727, 서울도봉초등학교인근,201901,70,55,125,37.678677,127.040764
도봉구,1727, 서울도봉초등학교인근,201902,77,65,142,37.678677,127.040764
도봉구,1727, 서울도봉초등학교인근,201903,173,132,305,37.678677,127.040764
도봉구,1727, 서울도봉초등학교인근,201904,229,191,420,37.678677,127.040764
도봉구,1727, 서울도봉초등학교인근,201905,311,333,644,37.678677,127.040764
도봉구,1727, 서울도봉초등학교인근,201906,385,373,758,37.678677,127.040764
도봉구,1727, 서울도봉초등학교인근,201907,369,390,759,37.678677,127.040764
도봉구,1727, 서울도봉초등학교인근,201908,379,379,758,37.678677,127.040764
도봉구,1727, 서울도봉초등학교인근,201909,421,404,825,37.678677,127.040764
도봉구,1727, 서울도봉초등학교인근,201910,375,393,768,37.678677,127.040764
도봉구,1727, 서울도봉초등학교인근,201911,270,243,513,37.678677,127.040764
도봉구,1727, 서울도봉초등학교인근,201912,168,136,304,37.678677,127.040764
도봉구,1727, 서울도봉초등학교인근,202001,122,102,224,37.678677,127.040764
도봉구,1727, 서울도봉초등학교인근,202002,130,143,273,37.678677,127.040764
도봉구,1727, 서울도봉초등학교인근,202003,274,244,518,37.678677,127.040764
도봉구,1727, 서울도봉초등학교인근,202004,413,409,822,37.678677,127.040764
도봉구,1727, 서울도봉초등학교인근,202005,472,471,943,37.678677,127.040764
도봉구,1727, 서울도봉초등학교인근,202006,549,571,1120,37.678677,127.040764
도봉구,1728, 서울북부지방법원,201901,68,76,144,37.677666,127.046242
도봉구,1728, 서울북부지방법원,201902,68,64,132,37.677666,127.046242
도봉구,1728, 서울북부지방법원,201903,143,140,283,37.677666,127.046242
도봉구,1728, 서울북부지방법원,201904,292,250,542,37.677666,127.046242
도봉구,1728, 서울북부지방법원,201905,389,384,773,37.677666,127.046242
도봉구,1728, 서울북부지방법원,201906,384,391,775,37.677666,127.046242
도봉구,1728, 서울북부지방법원,201907,406,399,805,37.677666,127.046242
도봉구,1728, 서울북부지방법원,201908,382,353,735,37.677666,127.046242
도봉구,1728, 서울북부지방법원,201909,440,422,862,37.677666,127.046242
도봉구,1728, 서울북부지방법원,201910,536,497,1033,37.677666,127.046242
도봉구,1728, 서울북부지방법원,201911,282,275,557,37.677666,127.046242
도봉구,1728, 서울북부지방법원,201912,130,94,224,37.677666,127.046242
도봉구,1728, 서울북부지방법원,202001,133,103,236,37.677666,127.046242
도봉구,1728, 서울북부지방법원,202002,128,118,246,37.677666,127.046242
도봉구,1728, 서울북부지방법원,202003,338,305,643,37.677666,127.046242
도봉구,1728, 서울북부지방법원,202004,548,538,1086,37.677666,127.046242
도봉구,1728, 서울북부지방법원,202005,719,710,1429,37.677666,127.046242
도봉구,1728, 서울북부지방법원,202006,568,592,1160,37.677666,127.046242
도봉구,1729, 파리바게트앞,201901,141,157,298,37.68401,127.045792
도봉구,1729, 파리바게트앞,201902,141,155,296,37.68401,127.045792
도봉구,1729, 파리바게트앞,201903,271,273,544,37.68401,127.045792
도봉구,1729, 파리바게트앞,201904,460,499,959,37.68401,127.045792
도봉구,1729, 파리바게트앞,201905,899,966,1865,37.68401,127.045792
도봉구,1729, 파리바게트앞,201906,1061,1160,2221,37.68401,127.045792
도봉구,1729, 파리바게트앞,201907,1009,1067,2076,37.68401,127.045792
도봉구,1729, 파리바게트앞,201908,1081,1233,2314,37.68401,127.045792
도봉구,1729, 파리바게트앞,201909,1075,1231,2306,37.68401,127.045792
도봉구,1729, 파리바게트앞,201910,1288,1440,2728,37.68401,127.045792
도봉구,1729, 파리바게트앞,201911,862,886,1748,37.68401,127.045792
도봉구,1729, 파리바게트앞,201912,549,553,1102,37.68401,127.045792
도봉구,1729, 파리바게트앞,202001,499,481,980,37.68401,127.045792
도봉구,1729, 파리바게트앞,202002,485,534,1019,37.68401,127.045792
도봉구,1729, 파리바게트앞,202003,956,1023,1979,37.68401,127.045792
도봉구,1729, 파리바게트앞,202004,1438,1596,3034,37.68401,127.045792
도봉구,1729, 파리바게트앞,202005,1680,1822,3502,37.68401,127.045792
도봉구,1729, 파리바게트앞,202006,1077,1211,2288,37.68401,127.045792
도봉구,1730, 도봉산역 교차로 앞,201901,32,42,74,37.687592,127.045502
도봉구,1730, 도봉산역 교차로 앞,201902,10,16,26,37.687592,127.045502
도봉구,1730, 도봉산역 교차로 앞,201903,71,52,123,37.687592,127.045502
도봉구,1730, 도봉산역 교차로 앞,201904,130,138,268,37.687592,127.045502
도봉구,1730, 도봉산역 교차로 앞,201905,272,287,559,37.687592,127.045502
도봉구,1730, 도봉산역 교차로 앞,201906,251,209,460,37.687592,127.045502
도봉구,1730, 도봉산역 교차로 앞,201907,224,210,434,37.687592,127.045502
도봉구,1730, 도봉산역 교차로 앞,201908,202,214,416,37.687592,127.045502
도봉구,1730, 도봉산역 교차로 앞,201909,213,235,448,37.687592,127.045502
도봉구,1730, 도봉산역 교차로 앞,201910,280,262,542,37.687592,127.045502
도봉구,1730, 도봉산역 교차로 앞,201911,158,173,331,37.687592,127.045502
도봉구,1730, 도봉산역 교차로 앞,201912,74,64,138,37.687592,127.045502
도봉구,1730, 도봉산역 교차로 앞,202001,74,86,160,37.687592,127.045502
도봉구,1730, 도봉산역 교차로 앞,202002,84,87,171,37.687592,127.045502
도봉구,1730, 도봉산역 교차로 앞,202003,283,267,550,37.687592,127.045502
도봉구,1730, 도봉산역 교차로 앞,202004,429,411,840,37.687592,127.045502
도봉구,1730, 도봉산역 교차로 앞,202005,472,464,936,37.687592,127.045502
도봉구,1730, 도봉산역 교차로 앞,202006,530,566,1096,37.687592,127.045502
도봉구,1731, 도봉고등학교 맞은편,201901,43,34,77,37.6875,127.042557
도봉구,1731, 도봉고등학교 맞은편,201902,39,22,61,37.6875,127.042557
도봉구,1731, 도봉고등학교 맞은편,201903,128,76,204,37.6875,127.042557
도봉구,1731, 도봉고등학교 맞은편,201904,145,96,241,37.6875,127.042557
도봉구,1731, 도봉고등학교 맞은편,201905,271,228,499,37.6875,127.042557
도봉구,1731, 도봉고등학교 맞은편,201906,253,215,468,37.6875,127.042557
도봉구,1731, 도봉고등학교 맞은편,201907,293,201,494,37.6875,127.042557
도봉구,1731, 도봉고등학교 맞은편,201908,291,209,500,37.6875,127.042557
도봉구,1731, 도봉고등학교 맞은편,201909,323,251,574,37.6875,127.042557
도봉구,1731, 도봉고등학교 맞은편,201910,317,246,563,37.6875,127.042557
도봉구,1731, 도봉고등학교 맞은편,201911,216,177,393,37.6875,127.042557
도봉구,1731, 도봉고등학교 맞은편,201912,121,92,213,37.6875,127.042557
도봉구,1731, 도봉고등학교 맞은편,202001,123,85,208,37.6875,127.042557
도봉구,1731, 도봉고등학교 맞은편,202002,125,85,210,37.6875,127.042557
도봉구,1731, 도봉고등학교 맞은편,202003,241,166,407,37.6875,127.042557
도봉구,1731, 도봉고등학교 맞은편,202004,355,248,603,37.6875,127.042557
도봉구,1731, 도봉고등학교 맞은편,202005,386,337,723,37.6875,127.042557
도봉구,1731, 도봉고등학교 맞은편,202006,455,297,752,37.6875,127.042557
도봉구,1732, 우리은행 앞,201901,81,105,186,37.667599,127.042999
도봉구,1732, 우리은행 앞,201902,97,110,207,37.667599,127.042999
도봉구,1732, 우리은행 앞,201903,212,248,460,37.667599,127.042999
도봉구,1732, 우리은행 앞,201904,327,373,700,37.667599,127.042999
도봉구,1732, 우리은행 앞,201905,583,665,1248,37.667599,127.042999
도봉구,1732, 우리은행 앞,201906,684,813,1497,37.667599,127.042999
도봉구,1732, 우리은행 앞,201907,661,811,1472,37.667599,127.042999
도봉구,1732, 우리은행 앞,201908,649,765,1414,37.667599,127.042999
도봉구,1732, 우리은행 앞,201909,682,784,1466,37.667599,127.042999
도봉구,1732, 우리은행 앞,201910,731,790,1521,37.667599,127.042999
도봉구,1732, 우리은행 앞,201911,467,514,981,37.667599,127.042999
도봉구,1732, 우리은행 앞,201912,279,306,585,37.667599,127.042999
도봉구,1732, 우리은행 앞,202001,263,295,558,37.667599,127.042999
도봉구,1732, 우리은행 앞,202002,279,283,562,37.667599,127.042999
도봉구,1732, 우리은행 앞,202003,517,524,1041,37.667599,127.042999
도봉구,1732, 우리은행 앞,202004,819,814,1633,37.667599,127.042999
도봉구,1732, 우리은행 앞,202005,1138,1171,2309,37.667599,127.042999
도봉구,1732, 우리은행 앞,202006,1153,1231,2384,37.667599,127.042999
도봉구,1733, 방학사거리 (봄마당 앞),201901,225,256,481,37.662979,127.041939
도봉구,1733, 방학사거리 (봄마당 앞),201902,275,228,503,37.662979,127.041939
도봉구,1733, 방학사거리 (봄마당 앞),201903,473,470,943,37.662979,127.041939
도봉구,1733, 방학사거리 (봄마당 앞),201904,712,769,1481,37.662979,127.041939
도봉구,1733, 방학사거리 (봄마당 앞),201905,1165,1429,2594,37.662979,127.041939
도봉구,1733, 방학사거리 (봄마당 앞),201906,1405,1676,3081,37.662979,127.041939
도봉구,1733, 방학사거리 (봄마당 앞),201907,1423,1576,2999,37.662979,127.041939
도봉구,1733, 방학사거리 (봄마당 앞),201908,1278,1503,2781,37.662979,127.041939
도봉구,1733, 방학사거리 (봄마당 앞),201909,1412,1651,3063,37.662979,127.041939
도봉구,1733, 방학사거리 (봄마당 앞),201910,1728,1828,3556,37.662979,127.041939
도봉구,1733, 방학사거리 (봄마당 앞),201911,1061,1119,2180,37.662979,127.041939
도봉구,1733, 방학사거리 (봄마당 앞),201912,537,550,1087,37.662979,127.041939
도봉구,1733, 방학사거리 (봄마당 앞),202001,536,571,1107,37.662979,127.041939
도봉구,1733, 방학사거리 (봄마당 앞),202002,497,549,1046,37.662979,127.041939
도봉구,1733, 방학사거리 (봄마당 앞),202003,1016,1011,2027,37.662979,127.041939
도봉구,1733, 방학사거리 (봄마당 앞),202004,1701,1627,3328,37.662979,127.041939
도봉구,1733, 방학사거리 (봄마당 앞),202005,2039,2063,4102,37.662979,127.041939
도봉구,1733, 방학사거리 (봄마당 앞),202006,1901,2086,3987,37.662979,127.041939
도봉구,1734, 쌍문현대1차아파트 108동 앞,201901,290,218,508,37.65815,127.032669
도봉구,1734, 쌍문현대1차아파트 108동 앞,201902,263,217,480,37.65815,127.032669
도봉구,1734, 쌍문현대1차아파트 108동 앞,201903,492,458,950,37.65815,127.032669
도봉구,1734, 쌍문현대1차아파트 108동 앞,201904,820,703,1523,37.65815,127.032669
도봉구,1734, 쌍문현대1차아파트 108동 앞,201905,1247,1241,2488,37.65815,127.032669
도봉구,1734, 쌍문현대1차아파트 108동 앞,201906,1462,1438,2900,37.65815,127.032669
도봉구,1734, 쌍문현대1차아파트 108동 앞,201907,1343,1249,2592,37.65815,127.032669
도봉구,1734, 쌍문현대1차아파트 108동 앞,201908,1245,1171,2416,37.65815,127.032669
도봉구,1734, 쌍문현대1차아파트 108동 앞,201909,1279,1204,2483,37.65815,127.032669
도봉구,1734, 쌍문현대1차아파트 108동 앞,201910,1471,1356,2827,37.65815,127.032669
도봉구,1734, 쌍문현대1차아파트 108동 앞,201911,746,665,1411,37.65815,127.032669
도봉구,1734, 쌍문현대1차아파트 108동 앞,201912,569,513,1082,37.65815,127.032669
도봉구,1734, 쌍문현대1차아파트 108동 앞,202001,520,430,950,37.65815,127.032669
도봉구,1734, 쌍문현대1차아파트 108동 앞,202002,442,388,830,37.65815,127.032669
도봉구,1734, 쌍문현대1차아파트 108동 앞,202003,831,741,1572,37.65815,127.032669
도봉구,1734, 쌍문현대1차아파트 108동 앞,202004,1270,1196,2466,37.65815,127.032669
도봉구,1734, 쌍문현대1차아파트 108동 앞,202005,1518,1454,2972,37.65815,127.032669
도봉구,1734, 쌍문현대1차아파트 108동 앞,202006,1383,1235,2618,37.65815,127.032669
도봉구,1735," 도봉역 1,2번 출구사이 건너편",201901,68,82,150,37.679119,127.044983
도봉구,1735," 도봉역 1,2번 출구사이 건너편",201902,70,81,151,37.679119,127.044983
도봉구,1735," 도봉역 1,2번 출구사이 건너편",201903,150,176,326,37.679119,127.044983
도봉구,1735," 도봉역 1,2번 출구사이 건너편",201904,274,282,556,37.679119,127.044983
도봉구,1735," 도봉역 1,2번 출구사이 건너편",201905,550,609,1159,37.679119,127.044983
도봉구,1735," 도봉역 1,2번 출구사이 건너편",201906,604,647,1251,37.679119,127.044983
도봉구,1735," 도봉역 1,2번 출구사이 건너편",201907,640,683,1323,37.679119,127.044983
도봉구,1735," 도봉역 1,2번 출구사이 건너편",201908,636,666,1302,37.679119,127.044983
도봉구,1735," 도봉역 1,2번 출구사이 건너편",201909,714,708,1422,37.679119,127.044983
도봉구,1735," 도봉역 1,2번 출구사이 건너편",201910,755,745,1500,37.679119,127.044983
도봉구,1735," 도봉역 1,2번 출구사이 건너편",201911,552,528,1080,37.679119,127.044983
도봉구,1735," 도봉역 1,2번 출구사이 건너편",201912,259,228,487,37.679119,127.044983
도봉구,1735," 도봉역 1,2번 출구사이 건너편",202001,209,188,397,37.679119,127.044983
도봉구,1735," 도봉역 1,2번 출구사이 건너편",202002,233,225,458,37.679119,127.044983
도봉구,1735," 도봉역 1,2번 출구사이 건너편",202003,486,479,965,37.679119,127.044983
도봉구,1735," 도봉역 1,2번 출구사이 건너편",202004,749,726,1475,37.679119,127.044983
도봉구,1735," 도봉역 1,2번 출구사이 건너편",202005,1008,1073,2081,37.679119,127.044983
도봉구,1735," 도봉역 1,2번 출구사이 건너편",202006,1134,1345,2479,37.679119,127.044983
도봉구,1736, 버스정류장 앞,201901,68,97,165,37.652241,127.037064
도봉구,1736, 버스정류장 앞,201902,102,120,222,37.652241,127.037064
도봉구,1736, 버스정류장 앞,201903,214,158,372,37.652241,127.037064
도봉구,1736, 버스정류장 앞,201904,322,230,552,37.652241,127.037064
도봉구,1736, 버스정류장 앞,201905,635,425,1060,37.652241,127.037064
도봉구,1736, 버스정류장 앞,201906,773,591,1364,37.652241,127.037064
도봉구,1736, 버스정류장 앞,201907,817,622,1439,37.652241,127.037064
도봉구,1736, 버스정류장 앞,201908,821,599,1420,37.652241,127.037064
도봉구,1736, 버스정류장 앞,201909,750,634,1384,37.652241,127.037064
도봉구,1736, 버스정류장 앞,201910,928,772,1700,37.652241,127.037064
도봉구,1736, 버스정류장 앞,201911,623,525,1148,37.652241,127.037064
도봉구,1736, 버스정류장 앞,201912,349,307,656,37.652241,127.037064
도봉구,1736, 버스정류장 앞,202001,300,254,554,37.652241,127.037064
도봉구,1736, 버스정류장 앞,202002,306,238,544,37.652241,127.037064
도봉구,1736, 버스정류장 앞,202003,445,338,783,37.652241,127.037064
도봉구,1736, 버스정류장 앞,202004,580,481,1061,37.652241,127.037064
도봉구,1736, 버스정류장 앞,202005,598,486,1084,37.652241,127.037064
도봉구,1736, 버스정류장 앞,202006,826,658,1484,37.652241,127.037064
도봉구,1737, 하나은행 (창동점),201901,194,236,430,37.639702,127.038834
도봉구,1737, 하나은행 (창동점),201902,202,255,457,37.639702,127.038834
도봉구,1737, 하나은행 (창동점),201903,417,611,1028,37.639702,127.038834
도봉구,1737, 하나은행 (창동점),201904,753,1067,1820,37.639702,127.038834
도봉구,1737, 하나은행 (창동점),201905,1255,1742,2997,37.639702,127.038834
도봉구,1737, 하나은행 (창동점),201906,1588,2078,3666,37.639702,127.038834
도봉구,1737, 하나은행 (창동점),201907,1642,2109,3751,37.639702,127.038834
도봉구,1737, 하나은행 (창동점),201908,1452,1860,3312,37.639702,127.038834
도봉구,1737, 하나은행 (창동점),201909,712,832,1544,37.639702,127.038834
도봉구,1737, 하나은행 (창동점),201910,1484,1937,3421,37.639702,127.038834
도봉구,1737, 하나은행 (창동점),201911,1197,1492,2689,37.639702,127.038834
도봉구,1737, 하나은행 (창동점),201912,639,747,1386,37.639702,127.038834
도봉구,1737, 하나은행 (창동점),202001,607,746,1353,37.639702,127.038834
도봉구,1737, 하나은행 (창동점),202002,565,724,1289,37.639702,127.038834
도봉구,1737, 하나은행 (창동점),202003,1067,1247,2314,37.639702,127.038834
도봉구,1737, 하나은행 (창동점),202004,1927,2106,4033,37.639702,127.038834
도봉구,1737, 하나은행 (창동점),202005,2435,2617,5052,37.639702,127.038834
도봉구,1737, 하나은행 (창동점),202006,2565,3015,5580,37.639702,127.038834
도봉구,1738, 창동주공17단지 상가앞,201901,146,169,315,37.646309,127.052742
도봉구,1738, 창동주공17단지 상가앞,201902,224,236,460,37.646309,127.052742
도봉구,1738, 창동주공17단지 상가앞,201903,501,591,1092,37.646309,127.052742
도봉구,1738, 창동주공17단지 상가앞,201904,729,855,1584,37.646309,127.052742
도봉구,1738, 창동주공17단지 상가앞,201905,1298,1505,2803,37.646309,127.052742
도봉구,1738, 창동주공17단지 상가앞,201906,1662,1824,3486,37.646309,127.052742
도봉구,1738, 창동주공17단지 상가앞,201907,1646,1881,3527,37.646309,127.052742
도봉구,1738, 창동주공17단지 상가앞,201908,1511,1700,3211,37.646309,127.052742
도봉구,1738, 창동주공17단지 상가앞,201909,1515,1702,3217,37.646309,127.052742
도봉구,1738, 창동주공17단지 상가앞,201910,1801,2052,3853,37.646309,127.052742
도봉구,1738, 창동주공17단지 상가앞,201911,1072,1252,2324,37.646309,127.052742
도봉구,1738, 창동주공17단지 상가앞,201912,614,769,1383,37.646309,127.052742
도봉구,1738, 창동주공17단지 상가앞,202001,559,727,1286,37.646309,127.052742
도봉구,1738, 창동주공17단지 상가앞,202002,575,674,1249,37.646309,127.052742
도봉구,1738, 창동주공17단지 상가앞,202003,1080,1358,2438,37.646309,127.052742
도봉구,1738, 창동주공17단지 상가앞,202004,1631,1814,3445,37.646309,127.052742
도봉구,1738, 창동주공17단지 상가앞,202005,1933,2135,4068,37.646309,127.052742
도봉구,1738, 창동주공17단지 상가앞,202006,1964,2369,4333,37.646309,127.052742
도봉구,1739, 창동한신,201901,10,15,25,#N/A,#N/A
도봉구,1739, 창동한신,201902,27,38,65,#N/A,#N/A
도봉구,1739, 창동한신,201903,43,76,119,#N/A,#N/A
도봉구,1739, 창동한신,201904,107,129,236,#N/A,#N/A
도봉구,1739, 창동한신,201905,247,281,528,#N/A,#N/A
도봉구,1739, 창동한신,201906,47,59,106,#N/A,#N/A
도봉구,1741, 제일강산수산입구,201901,282,253,535,37.645199,127.032982
도봉구,1741, 제일강산수산입구,201902,384,325,709,37.645199,127.032982
도봉구,1741, 제일강산수산입구,201903,835,737,1572,37.645199,127.032982
도봉구,1741, 제일강산수산입구,201904,1476,1385,2861,37.645199,127.032982
도봉구,1741, 제일강산수산입구,201905,2462,2242,4704,37.645199,127.032982
도봉구,1741, 제일강산수산입구,201906,2550,2317,4867,37.645199,127.032982
도봉구,1741, 제일강산수산입구,201907,2526,2221,4747,37.645199,127.032982
도봉구,1741, 제일강산수산입구,201908,2165,1879,4044,37.645199,127.032982
도봉구,1741, 제일강산수산입구,201909,2323,2131,4454,37.645199,127.032982
도봉구,1741, 제일강산수산입구,201910,2638,2423,5061,37.645199,127.032982
도봉구,1741, 제일강산수산입구,201911,1656,1493,3149,37.645199,127.032982
도봉구,1741, 제일강산수산입구,201912,815,704,1519,37.645199,127.032982
도봉구,1741, 제일강산수산입구,202001,768,668,1436,37.645199,127.032982
도봉구,1741, 제일강산수산입구,202002,770,631,1401,37.645199,127.032982
도봉구,1741, 제일강산수산입구,202003,1772,1667,3439,37.645199,127.032982
도봉구,1741, 제일강산수산입구,202004,2758,2691,5449,37.645199,127.032982
도봉구,1741, 제일강산수산입구,202005,3029,2867,5896,37.645199,127.032982
도봉구,1741, 제일강산수산입구,202006,3213,2990,6203,37.645199,127.032982
도봉구,1742, 북한산 코오롱 하늘채,201901,201,179,380,37.648891,127.023018
도봉구,1742, 북한산 코오롱 하늘채,201902,200,178,378,37.648891,127.023018
도봉구,1742, 북한산 코오롱 하늘채,201903,530,543,1073,37.648891,127.023018
도봉구,1742, 북한산 코오롱 하늘채,201904,798,830,1628,37.648891,127.023018
도봉구,1742, 북한산 코오롱 하늘채,201905,1212,1330,2542,37.648891,127.023018
도봉구,1742, 북한산 코오롱 하늘채,201906,1233,1342,2575,37.648891,127.023018
도봉구,1742, 북한산 코오롱 하늘채,201907,1104,1245,2349,37.648891,127.023018
도봉구,1742, 북한산 코오롱 하늘채,201908,997,1187,2184,37.648891,127.023018
도봉구,1742, 북한산 코오롱 하늘채,201909,1242,1383,2625,37.648891,127.023018
도봉구,1742, 북한산 코오롱 하늘채,201910,1384,1526,2910,37.648891,127.023018
도봉구,1742, 북한산 코오롱 하늘채,201911,865,997,1862,37.648891,127.023018
도봉구,1742, 북한산 코오롱 하늘채,201912,409,468,877,37.648891,127.023018
도봉구,1742, 북한산 코오롱 하늘채,202001,404,397,801,37.648891,127.023018
도봉구,1742, 북한산 코오롱 하늘채,202002,366,381,747,37.648891,127.023018
도봉구,1742, 북한산 코오롱 하늘채,202003,585,605,1190,37.648891,127.023018
도봉구,1742, 북한산 코오롱 하늘채,202004,952,972,1924,37.648891,127.023018
도봉구,1742, 북한산 코오롱 하늘채,202005,1204,1234,2438,37.648891,127.023018
도봉구,1742, 북한산 코오롱 하늘채,202006,1534,1618,3152,37.648891,127.023018
도봉구,1743,창동19단지아파트 관리사무소앞,202004,1,1,2,37.650391,127.052193
도봉구,1743,창동19단지아파트 관리사무소앞,202006,418,403,821,37.650391,127.052193
도봉구,1744,KT방학지사 앞,202004,92,94,186,37.665272,127.043144
도봉구,1744,KT방학지사 앞,202005,169,175,344,37.665272,127.043144
도봉구,1744,KT방학지사 앞,202006,635,627,1262,37.665272,127.043144
도봉구,1746, 다이소방학점 앞,202004,2,2,4,37.666233,127.04332
도봉구,1748, 피자헛 앞(도봉병원 옆),202004,1,1,2,37.668983,127.043762
도봉구,1748, 피자헛 앞(도봉병원 옆),202006,236,224,460,37.668983,127.043762
도봉구,1749, ESA아파트 상가 앞,202004,3,3,6,37.666271,127.04599
도봉구,1749, ESA아파트 상가 앞,202006,531,536,1067,37.666271,127.04599
도봉구,1750, 창포원 남쪽 입구,202004,1,1,2,37.688267,127.048897
도봉구,1751, 창원초등학교 교차로,202004,1,1,2,37.652123,127.041702
도봉구,1752, 창동 주공 4단지 입구 옆,202004,3,3,6,37.645481,127.048576
도봉구,1752, 창동 주공 4단지 입구 옆,202006,352,356,708,37.645481,127.048576
도봉구,1753,창동 현대2차아파트(209동),202004,1,1,2,#N/A,#N/A
도봉구,1754, 창동시장입구 사거리,202004,1,1,2,37.646896,127.033432
도봉구,1754, 창동시장입구 사거리,202006,295,283,578,37.646896,127.033432
도봉구,1755, 롯데칠성음료 앞,202004,1,0,1,#N/A,#N/A
도봉구,1756,서울북부광역등기국,202004,1,1,2,37.651447,127.044708
도봉구,1756,서울북부광역등기국,202006,178,123,301,37.651447,127.044708
도봉구,1757,솔밭공원역 1번출구 앞,202004,3,3,6,37.655685,127.013382
도봉구,1757,솔밭공원역 1번출구 앞,202005,1,1,2,37.655685,127.013382
도봉구,1757,솔밭공원역 1번출구 앞,202006,218,188,406,37.655685,127.013382
도봉구,1758,북서울교회 버스정류소 앞,202004,1,1,2,37.65728,127.013756
도봉구,1758,북서울교회 버스정류소 앞,202006,314,299,613,37.65728,127.013756
도봉구,1759,서울북부지방법원 앞,202004,1,1,2,37.677219,127.048637
도봉구,1759,서울북부지방법원 앞,202006,206,215,421,37.677219,127.048637
도봉구,1760,다락원체육공원 입구,202004,1,1,2,#N/A,#N/A
도봉구,1761,방학중학교 앞,202004,1,1,2,37.665623,127.03109
도봉구,1761,방학중학교 앞,202006,284,286,570,37.665623,127.03109
도봉구,1762,북한산 한신휴플러스APT앞,202004,2,2,4,37.655338,127.042419
도봉구,1765,쌍문역 1번 출구(양산부인과 빌딩),202006,291,226,517,37.64967,127.035614
도봉구,1766,소피아 관광호텔 앞,202004,1,1,2,#N/A,#N/A
도봉구,1766,소피아 관광호텔 앞,202006,1,1,2,#N/A,#N/A
도봉구,1767,태양중앙교회 앞,202004,1,1,2,37.66251,127.033279
도봉구,1768,신동아타워 버스정류소,202004,1,1,2,37.662052,127.028755
도봉구,1768,신동아타워 버스정류소,202006,373,412,785,37.662052,127.028755
도봉구,1769,신동아아파트 교차로,202004,2,2,4,#N/A,#N/A
도봉구,1770,강북성복교회 주변,202004,1,1,2,#N/A,#N/A
도봉구,1770,강북성복교회 주변,202006,638,760,1398,#N/A,#N/A
도봉구,1771,성원APT버스정류소,202004,2,2,4,37.657967,127.03009
도봉구,1771,성원APT버스정류소,202006,474,405,879,37.657967,127.03009
도봉구,1772,시립도봉노인복지관 버스정류소,202004,2,2,4,37.658051,127.035759
도봉구,1772,시립도봉노인복지관 버스정류소,202006,254,227,481,37.658051,127.035759
도봉구,1774,반석교회(쌍문동),202004,1,1,2,37.651348,127.034729
도봉구,1774,반석교회(쌍문동),202006,110,106,216,37.651348,127.034729
도봉구,1775,신원리베르텔 앞,202004,2,2,4,37.651287,127.045548
도봉구,1775,신원리베르텔 앞,202006,290,273,563,37.651287,127.045548
금천구,1804, 독산역 2번출구 자전거주차장,201901,354,318,672,37.46653,126.888718
금천구,1804, 독산역 2번출구 자전거주차장,201902,284,243,527,37.46653,126.888718
금천구,1804, 독산역 2번출구 자전거주차장,201903,529,507,1036,37.46653,126.888718
금천구,1804, 독산역 2번출구 자전거주차장,201904,950,807,1757,37.46653,126.888718
금천구,1804, 독산역 2번출구 자전거주차장,201905,1199,1104,2303,37.46653,126.888718
금천구,1804, 독산역 2번출구 자전거주차장,201906,1298,1161,2459,37.46653,126.888718
금천구,1804, 독산역 2번출구 자전거주차장,201907,1257,1153,2410,37.46653,126.888718
금천구,1804, 독산역 2번출구 자전거주차장,201908,1167,1104,2271,37.46653,126.888718
금천구,1804, 독산역 2번출구 자전거주차장,201909,1109,1118,2227,37.46653,126.888718
금천구,1804, 독산역 2번출구 자전거주차장,201910,1260,1242,2502,37.46653,126.888718
금천구,1804, 독산역 2번출구 자전거주차장,201911,815,777,1592,37.46653,126.888718
금천구,1804, 독산역 2번출구 자전거주차장,201912,561,561,1122,37.46653,126.888718
금천구,1804, 독산역 2번출구 자전거주차장,202001,507,523,1030,37.46653,126.888718
금천구,1804, 독산역 2번출구 자전거주차장,202002,566,563,1129,37.46653,126.888718
금천구,1804, 독산역 2번출구 자전거주차장,202003,967,956,1923,37.46653,126.888718
금천구,1804, 독산역 2번출구 자전거주차장,202004,1494,1451,2945,37.46653,126.888718
금천구,1804, 독산역 2번출구 자전거주차장,202005,1595,1541,3136,37.46653,126.888718
금천구,1804, 독산역 2번출구 자전거주차장,202006,1507,1487,2994,37.46653,126.888718
금천구,1805, 서울디지털운동장 앞,201901,245,255,500,37.482288,126.877769
금천구,1805, 서울디지털운동장 앞,201902,198,206,404,37.482288,126.877769
금천구,1805, 서울디지털운동장 앞,201903,345,404,749,37.482288,126.877769
금천구,1805, 서울디지털운동장 앞,201904,562,570,1132,37.482288,126.877769
금천구,1805, 서울디지털운동장 앞,201905,765,772,1537,37.482288,126.877769
금천구,1805, 서울디지털운동장 앞,201906,664,664,1328,37.482288,126.877769
금천구,1805, 서울디지털운동장 앞,201907,611,600,1211,37.482288,126.877769
금천구,1805, 서울디지털운동장 앞,201908,555,556,1111,37.482288,126.877769
금천구,1805, 서울디지털운동장 앞,201909,650,690,1340,37.482288,126.877769
금천구,1805, 서울디지털운동장 앞,201910,980,1000,1980,37.482288,126.877769
금천구,1805, 서울디지털운동장 앞,201911,778,779,1557,37.482288,126.877769
금천구,1805, 서울디지털운동장 앞,201912,498,526,1024,37.482288,126.877769
금천구,1805, 서울디지털운동장 앞,202001,414,442,856,37.482288,126.877769
금천구,1805, 서울디지털운동장 앞,202002,451,475,926,37.482288,126.877769
금천구,1805, 서울디지털운동장 앞,202003,569,566,1135,37.482288,126.877769
금천구,1805, 서울디지털운동장 앞,202004,745,818,1563,37.482288,126.877769
금천구,1805, 서울디지털운동장 앞,202005,821,894,1715,37.482288,126.877769
금천구,1805, 서울디지털운동장 앞,202006,951,1070,2021,37.482288,126.877769
금천구,1806, 에이스하이엔드타워9차 앞,201901,117,190,307,37.486214,126.878639
금천구,1806, 에이스하이엔드타워9차 앞,201902,105,116,221,37.486214,126.878639
금천구,1806, 에이스하이엔드타워9차 앞,201903,212,228,440,37.486214,126.878639
금천구,1806, 에이스하이엔드타워9차 앞,201904,373,369,742,37.486214,126.878639
금천구,1806, 에이스하이엔드타워9차 앞,201905,616,604,1220,37.486214,126.878639
금천구,1806, 에이스하이엔드타워9차 앞,201906,693,713,1406,37.486214,126.878639
금천구,1806, 에이스하이엔드타워9차 앞,201907,731,799,1530,37.486214,126.878639
금천구,1806, 에이스하이엔드타워9차 앞,201908,607,618,1225,37.486214,126.878639
금천구,1806, 에이스하이엔드타워9차 앞,201909,583,618,1201,37.486214,126.878639
금천구,1806, 에이스하이엔드타워9차 앞,201910,811,896,1707,37.486214,126.878639
금천구,1806, 에이스하이엔드타워9차 앞,201911,591,627,1218,37.486214,126.878639
금천구,1806, 에이스하이엔드타워9차 앞,201912,362,378,740,37.486214,126.878639
금천구,1806, 에이스하이엔드타워9차 앞,202001,301,315,616,37.486214,126.878639
금천구,1806, 에이스하이엔드타워9차 앞,202002,324,321,645,37.486214,126.878639
금천구,1806, 에이스하이엔드타워9차 앞,202003,526,536,1062,37.486214,126.878639
금천구,1806, 에이스하이엔드타워9차 앞,202004,680,754,1434,37.486214,126.878639
금천구,1806, 에이스하이엔드타워9차 앞,202005,778,833,1611,37.486214,126.878639
금천구,1806, 에이스하이엔드타워9차 앞,202006,920,978,1898,37.486214,126.878639
금천구,1808, 에이스하이엔드타워8차 앞,201901,298,346,644,37.473209,126.884941
금천구,1808, 에이스하이엔드타워8차 앞,201902,217,254,471,37.473209,126.884941
금천구,1808, 에이스하이엔드타워8차 앞,201903,414,492,906,37.473209,126.884941
금천구,1808, 에이스하이엔드타워8차 앞,201904,580,659,1239,37.473209,126.884941
금천구,1808, 에이스하이엔드타워8차 앞,201905,671,734,1405,37.473209,126.884941
금천구,1808, 에이스하이엔드타워8차 앞,201906,792,791,1583,37.473209,126.884941
금천구,1808, 에이스하이엔드타워8차 앞,201907,912,917,1829,37.473209,126.884941
금천구,1808, 에이스하이엔드타워8차 앞,201908,743,754,1497,37.473209,126.884941
금천구,1808, 에이스하이엔드타워8차 앞,201909,688,725,1413,37.473209,126.884941
금천구,1808, 에이스하이엔드타워8차 앞,201910,835,879,1714,37.473209,126.884941
금천구,1808, 에이스하이엔드타워8차 앞,201911,637,698,1335,37.473209,126.884941
금천구,1808, 에이스하이엔드타워8차 앞,201912,479,509,988,37.473209,126.884941
금천구,1808, 에이스하이엔드타워8차 앞,202001,444,471,915,37.473209,126.884941
금천구,1808, 에이스하이엔드타워8차 앞,202002,453,497,950,37.473209,126.884941
금천구,1808, 에이스하이엔드타워8차 앞,202003,523,513,1036,37.473209,126.884941
금천구,1808, 에이스하이엔드타워8차 앞,202004,631,693,1324,37.473209,126.884941
금천구,1808, 에이스하이엔드타워8차 앞,202005,624,726,1350,37.473209,126.884941
금천구,1808, 에이스하이엔드타워8차 앞,202006,988,972,1960,37.473209,126.884941
금천구,1809, LG전자 별관동(호서대 벤처타워 맞은편),201901,249,213,462,37.470779,126.885155
금천구,1809, LG전자 별관동(호서대 벤처타워 맞은편),201902,148,126,274,37.470779,126.885155
금천구,1809, LG전자 별관동(호서대 벤처타워 맞은편),201903,268,245,513,37.470779,126.885155
금천구,1809, LG전자 별관동(호서대 벤처타워 맞은편),201904,353,344,697,37.470779,126.885155
금천구,1809, LG전자 별관동(호서대 벤처타워 맞은편),201905,402,404,806,37.470779,126.885155
금천구,1809, LG전자 별관동(호서대 벤처타워 맞은편),201906,383,382,765,37.470779,126.885155
금천구,1809, LG전자 별관동(호서대 벤처타워 맞은편),201907,491,472,963,37.470779,126.885155
금천구,1809, LG전자 별관동(호서대 벤처타워 맞은편),201908,394,370,764,37.470779,126.885155
금천구,1809, LG전자 별관동(호서대 벤처타워 맞은편),201909,397,388,785,37.470779,126.885155
금천구,1809, LG전자 별관동(호서대 벤처타워 맞은편),201910,500,535,1035,37.470779,126.885155
금천구,1809, LG전자 별관동(호서대 벤처타워 맞은편),201911,410,420,830,37.470779,126.885155
금천구,1809, LG전자 별관동(호서대 벤처타워 맞은편),201912,274,286,560,37.470779,126.885155
금천구,1809, LG전자 별관동(호서대 벤처타워 맞은편),202001,248,245,493,37.470779,126.885155
금천구,1809, LG전자 별관동(호서대 벤처타워 맞은편),202002,261,276,537,37.470779,126.885155
금천구,1809, LG전자 별관동(호서대 벤처타워 맞은편),202003,315,301,616,37.470779,126.885155
금천구,1809, LG전자 별관동(호서대 벤처타워 맞은편),202004,339,364,703,37.470779,126.885155
금천구,1809, LG전자 별관동(호서대 벤처타워 맞은편),202005,416,434,850,37.470779,126.885155
금천구,1809, LG전자 별관동(호서대 벤처타워 맞은편),202006,512,508,1020,37.470779,126.885155
금천구,1812, 갑을그레이트밸리 앞,201901,177,219,396,37.479031,126.887299
금천구,1812, 갑을그레이트밸리 앞,201902,164,160,324,37.479031,126.887299
금천구,1812, 갑을그레이트밸리 앞,201903,256,259,515,37.479031,126.887299
금천구,1812, 갑을그레이트밸리 앞,201904,422,412,834,37.479031,126.887299
금천구,1812, 갑을그레이트밸리 앞,201905,612,633,1245,37.479031,126.887299
금천구,1812, 갑을그레이트밸리 앞,201906,711,716,1427,37.479031,126.887299
금천구,1812, 갑을그레이트밸리 앞,201907,667,650,1317,37.479031,126.887299
금천구,1812, 갑을그레이트밸리 앞,201908,430,434,864,37.479031,126.887299
금천구,1812, 갑을그레이트밸리 앞,201909,445,448,893,37.479031,126.887299
금천구,1812, 갑을그레이트밸리 앞,201910,639,646,1285,37.479031,126.887299
금천구,1812, 갑을그레이트밸리 앞,201911,448,518,966,37.479031,126.887299
금천구,1812, 갑을그레이트밸리 앞,201912,265,319,584,37.479031,126.887299
금천구,1812, 갑을그레이트밸리 앞,202001,266,282,548,37.479031,126.887299
금천구,1812, 갑을그레이트밸리 앞,202002,268,278,546,37.479031,126.887299
금천구,1812, 갑을그레이트밸리 앞,202003,392,390,782,37.479031,126.887299
금천구,1812, 갑을그레이트밸리 앞,202004,676,671,1347,37.479031,126.887299
금천구,1812, 갑을그레이트밸리 앞,202005,868,865,1733,37.479031,126.887299
금천구,1812, 갑을그레이트밸리 앞,202006,968,983,1951,37.479031,126.887299
금천구,1814, 두산위브아파트 옆 상가건물 앞,201901,333,293,626,37.47422,126.894127
금천구,1814, 두산위브아파트 옆 상가건물 앞,201902,257,244,501,37.47422,126.894127
금천구,1814, 두산위브아파트 옆 상가건물 앞,201903,425,384,809,37.47422,126.894127
금천구,1814, 두산위브아파트 옆 상가건물 앞,201904,608,545,1153,37.47422,126.894127
금천구,1814, 두산위브아파트 옆 상가건물 앞,201905,905,856,1761,37.47422,126.894127
금천구,1814, 두산위브아파트 옆 상가건물 앞,201906,843,838,1681,37.47422,126.894127
금천구,1814, 두산위브아파트 옆 상가건물 앞,201907,980,945,1925,37.47422,126.894127
금천구,1814, 두산위브아파트 옆 상가건물 앞,201908,937,957,1894,37.47422,126.894127
금천구,1814, 두산위브아파트 옆 상가건물 앞,201909,717,690,1407,37.47422,126.894127
금천구,1814, 두산위브아파트 옆 상가건물 앞,201910,841,816,1657,37.47422,126.894127
금천구,1814, 두산위브아파트 옆 상가건물 앞,201911,524,500,1024,37.47422,126.894127
금천구,1814, 두산위브아파트 옆 상가건물 앞,201912,377,381,758,37.47422,126.894127
금천구,1814, 두산위브아파트 옆 상가건물 앞,202001,304,294,598,37.47422,126.894127
금천구,1814, 두산위브아파트 옆 상가건물 앞,202002,268,261,529,37.47422,126.894127
금천구,1814, 두산위브아파트 옆 상가건물 앞,202003,322,319,641,37.47422,126.894127
금천구,1814, 두산위브아파트 옆 상가건물 앞,202004,532,516,1048,37.47422,126.894127
금천구,1814, 두산위브아파트 옆 상가건물 앞,202005,724,713,1437,37.47422,126.894127
금천구,1814, 두산위브아파트 옆 상가건물 앞,202006,957,944,1901,37.47422,126.894127
금천구,1816, 금천폭포공원 앞,201901,88,49,137,37.446861,126.903831
금천구,1816, 금천폭포공원 앞,201902,70,33,103,37.446861,126.903831
금천구,1816, 금천폭포공원 앞,201903,145,78,223,37.446861,126.903831
금천구,1816, 금천폭포공원 앞,201904,202,131,333,37.446861,126.903831
금천구,1816, 금천폭포공원 앞,201905,268,173,441,37.446861,126.903831
금천구,1816, 금천폭포공원 앞,201906,345,246,591,37.446861,126.903831
금천구,1816, 금천폭포공원 앞,201907,285,228,513,37.446861,126.903831
금천구,1816, 금천폭포공원 앞,201908,264,204,468,37.446861,126.903831
금천구,1816, 금천폭포공원 앞,201909,249,206,455,37.446861,126.903831
금천구,1816, 금천폭포공원 앞,201910,286,261,547,37.446861,126.903831
금천구,1816, 금천폭포공원 앞,201911,234,165,399,37.446861,126.903831
금천구,1816, 금천폭포공원 앞,201912,97,72,169,37.446861,126.903831
금천구,1816, 금천폭포공원 앞,202001,83,45,128,37.446861,126.903831
금천구,1816, 금천폭포공원 앞,202002,64,56,120,37.446861,126.903831
금천구,1816, 금천폭포공원 앞,202003,198,177,375,37.446861,126.903831
금천구,1816, 금천폭포공원 앞,202004,355,307,662,37.446861,126.903831
금천구,1816, 금천폭포공원 앞,202005,374,349,723,37.446861,126.903831
금천구,1816, 금천폭포공원 앞,202006,376,282,658,37.446861,126.903831
금천구,1819, 금천구청 앞 자전거거치대,201901,169,152,321,37.456478,126.895927
금천구,1819, 금천구청 앞 자전거거치대,201902,154,175,329,37.456478,126.895927
금천구,1819, 금천구청 앞 자전거거치대,201903,271,256,527,37.456478,126.895927
금천구,1819, 금천구청 앞 자전거거치대,201904,506,501,1007,37.456478,126.895927
금천구,1819, 금천구청 앞 자전거거치대,201905,736,729,1465,37.456478,126.895927
금천구,1819, 금천구청 앞 자전거거치대,201906,709,741,1450,37.456478,126.895927
금천구,1819, 금천구청 앞 자전거거치대,201907,695,700,1395,37.456478,126.895927
금천구,1819, 금천구청 앞 자전거거치대,201908,705,777,1482,37.456478,126.895927
금천구,1819, 금천구청 앞 자전거거치대,201909,727,740,1467,37.456478,126.895927
금천구,1819, 금천구청 앞 자전거거치대,201910,823,822,1645,37.456478,126.895927
금천구,1819, 금천구청 앞 자전거거치대,201911,528,523,1051,37.456478,126.895927
금천구,1819, 금천구청 앞 자전거거치대,201912,265,298,563,37.456478,126.895927
금천구,1819, 금천구청 앞 자전거거치대,202001,318,304,622,37.456478,126.895927
금천구,1819, 금천구청 앞 자전거거치대,202002,277,270,547,37.456478,126.895927
금천구,1819, 금천구청 앞 자전거거치대,202003,386,384,770,37.456478,126.895927
금천구,1819, 금천구청 앞 자전거거치대,202004,750,714,1464,37.456478,126.895927
금천구,1819, 금천구청 앞 자전거거치대,202005,893,906,1799,37.456478,126.895927
금천구,1819, 금천구청 앞 자전거거치대,202006,818,838,1656,37.456478,126.895927
금천구,1820, 신한은행 시흥대로금융센터지점,201901,79,85,164,37.44334,126.903358
금천구,1820, 신한은행 시흥대로금융센터지점,201902,94,68,162,37.44334,126.903358
금천구,1820, 신한은행 시흥대로금융센터지점,201903,123,128,251,37.44334,126.903358
금천구,1820, 신한은행 시흥대로금융센터지점,201904,166,203,369,37.44334,126.903358
금천구,1820, 신한은행 시흥대로금융센터지점,201905,263,297,560,37.44334,126.903358
금천구,1820, 신한은행 시흥대로금융센터지점,201906,280,316,596,37.44334,126.903358
금천구,1820, 신한은행 시흥대로금융센터지점,201907,232,249,481,37.44334,126.903358
금천구,1820, 신한은행 시흥대로금융센터지점,201908,245,253,498,37.44334,126.903358
금천구,1820, 신한은행 시흥대로금융센터지점,201909,250,258,508,37.44334,126.903358
금천구,1820, 신한은행 시흥대로금융센터지점,201910,284,307,591,37.44334,126.903358
금천구,1820, 신한은행 시흥대로금융센터지점,201911,186,244,430,37.44334,126.903358
금천구,1820, 신한은행 시흥대로금융센터지점,201912,96,99,195,37.44334,126.903358
금천구,1820, 신한은행 시흥대로금융센터지점,202001,107,130,237,37.44334,126.903358
금천구,1820, 신한은행 시흥대로금융센터지점,202002,75,79,154,37.44334,126.903358
금천구,1820, 신한은행 시흥대로금융센터지점,202003,214,214,428,37.44334,126.903358
금천구,1820, 신한은행 시흥대로금융센터지점,202004,360,356,716,37.44334,126.903358
금천구,1820, 신한은행 시흥대로금융센터지점,202005,356,358,714,37.44334,126.903358
금천구,1820, 신한은행 시흥대로금융센터지점,202006,444,540,984,37.44334,126.903358
금천구,1821, 홈플러스 시흥점 맞은편 다비치안경 앞,201901,114,162,276,37.451458,126.902115
금천구,1821, 홈플러스 시흥점 맞은편 다비치안경 앞,201902,170,187,357,37.451458,126.902115
금천구,1821, 홈플러스 시흥점 맞은편 다비치안경 앞,201903,290,287,577,37.451458,126.902115
금천구,1821, 홈플러스 시흥점 맞은편 다비치안경 앞,201904,378,434,812,37.451458,126.902115
금천구,1821, 홈플러스 시흥점 맞은편 다비치안경 앞,201905,539,645,1184,37.451458,126.902115
금천구,1821, 홈플러스 시흥점 맞은편 다비치안경 앞,201906,666,756,1422,37.451458,126.902115
금천구,1821, 홈플러스 시흥점 맞은편 다비치안경 앞,201907,569,677,1246,37.451458,126.902115
금천구,1821, 홈플러스 시흥점 맞은편 다비치안경 앞,201908,632,637,1269,37.451458,126.902115
금천구,1821, 홈플러스 시흥점 맞은편 다비치안경 앞,201909,501,570,1071,37.451458,126.902115
금천구,1821, 홈플러스 시흥점 맞은편 다비치안경 앞,201910,685,725,1410,37.451458,126.902115
금천구,1821, 홈플러스 시흥점 맞은편 다비치안경 앞,201911,493,529,1022,37.451458,126.902115
금천구,1821, 홈플러스 시흥점 맞은편 다비치안경 앞,201912,286,314,600,37.451458,126.902115
금천구,1821, 홈플러스 시흥점 맞은편 다비치안경 앞,202001,277,290,567,37.451458,126.902115
금천구,1821, 홈플러스 시흥점 맞은편 다비치안경 앞,202002,276,283,559,37.451458,126.902115
금천구,1821, 홈플러스 시흥점 맞은편 다비치안경 앞,202003,421,446,867,37.451458,126.902115
금천구,1821, 홈플러스 시흥점 맞은편 다비치안경 앞,202004,791,783,1574,37.451458,126.902115
금천구,1821, 홈플러스 시흥점 맞은편 다비치안경 앞,202005,916,912,1828,37.451458,126.902115
금천구,1821, 홈플러스 시흥점 맞은편 다비치안경 앞,202006,983,1010,1993,37.451458,126.902115
금천구,1822, 서울 시흥동우체국 앞,201901,139,183,322,37.452991,126.900909
금천구,1822, 서울 시흥동우체국 앞,201902,143,187,330,37.452991,126.900909
금천구,1822, 서울 시흥동우체국 앞,201903,266,298,564,37.452991,126.900909
금천구,1822, 서울 시흥동우체국 앞,201904,440,525,965,37.452991,126.900909
금천구,1822, 서울 시흥동우체국 앞,201905,619,841,1460,37.452991,126.900909
금천구,1822, 서울 시흥동우체국 앞,201906,790,985,1775,37.452991,126.900909
금천구,1822, 서울 시흥동우체국 앞,201907,778,975,1753,37.452991,126.900909
금천구,1822, 서울 시흥동우체국 앞,201908,752,852,1604,37.452991,126.900909
금천구,1822, 서울 시흥동우체국 앞,201909,709,794,1503,37.452991,126.900909
금천구,1822, 서울 시흥동우체국 앞,201910,867,1016,1883,37.452991,126.900909
금천구,1822, 서울 시흥동우체국 앞,201911,500,621,1121,37.452991,126.900909
금천구,1822, 서울 시흥동우체국 앞,201912,320,430,750,37.452991,126.900909
금천구,1822, 서울 시흥동우체국 앞,202001,295,336,631,37.452991,126.900909
금천구,1822, 서울 시흥동우체국 앞,202002,283,294,577,37.452991,126.900909
금천구,1822, 서울 시흥동우체국 앞,202003,514,535,1049,37.452991,126.900909
금천구,1822, 서울 시흥동우체국 앞,202004,1007,1022,2029,37.452991,126.900909
금천구,1822, 서울 시흥동우체국 앞,202005,1140,1187,2327,37.452991,126.900909
금천구,1822, 서울 시흥동우체국 앞,202006,1271,1437,2708,37.452991,126.900909
금천구,1823, 상신정비공업 앞,201901,154,75,229,37.458912,126.89859
금천구,1823, 상신정비공업 앞,201902,142,90,232,37.458912,126.89859
금천구,1823, 상신정비공업 앞,201903,276,179,455,37.458912,126.89859
금천구,1823, 상신정비공업 앞,201904,434,236,670,37.458912,126.89859
금천구,1823, 상신정비공업 앞,201905,660,395,1055,37.458912,126.89859
금천구,1823, 상신정비공업 앞,201906,669,378,1047,37.458912,126.89859
금천구,1823, 상신정비공업 앞,201907,610,389,999,37.458912,126.89859
금천구,1823, 상신정비공업 앞,201908,549,344,893,37.458912,126.89859
금천구,1823, 상신정비공업 앞,201909,429,303,732,37.458912,126.89859
금천구,1823, 상신정비공업 앞,201910,619,383,1002,37.458912,126.89859
금천구,1823, 상신정비공업 앞,201911,441,236,677,37.458912,126.89859
금천구,1823, 상신정비공업 앞,201912,289,167,456,37.458912,126.89859
금천구,1823, 상신정비공업 앞,202001,183,116,299,37.458912,126.89859
금천구,1823, 상신정비공업 앞,202002,182,111,293,37.458912,126.89859
금천구,1823, 상신정비공업 앞,202003,326,169,495,37.458912,126.89859
금천구,1823, 상신정비공업 앞,202004,515,313,828,37.458912,126.89859
금천구,1823, 상신정비공업 앞,202005,547,389,936,37.458912,126.89859
금천구,1823, 상신정비공업 앞,202006,612,332,944,37.458912,126.89859
금천구,1824, 독산근린공원 입구,201901,275,242,517,37.46455,126.883728
금천구,1824, 독산근린공원 입구,201902,264,278,542,37.46455,126.883728
금천구,1824, 독산근린공원 입구,201903,522,499,1021,37.46455,126.883728
금천구,1824, 독산근린공원 입구,201904,960,1002,1962,37.46455,126.883728
금천구,1824, 독산근린공원 입구,201905,1439,1404,2843,37.46455,126.883728
금천구,1824, 독산근린공원 입구,201906,1406,1443,2849,37.46455,126.883728
금천구,1824, 독산근린공원 입구,201907,1318,1319,2637,37.46455,126.883728
금천구,1824, 독산근린공원 입구,201908,1424,1473,2897,37.46455,126.883728
금천구,1824, 독산근린공원 입구,201909,1433,1399,2832,37.46455,126.883728
금천구,1824, 독산근린공원 입구,201910,1795,1743,3538,37.46455,126.883728
금천구,1824, 독산근린공원 입구,201911,921,871,1792,37.46455,126.883728
금천구,1824, 독산근린공원 입구,201912,492,484,976,37.46455,126.883728
금천구,1824, 독산근린공원 입구,202001,495,520,1015,37.46455,126.883728
금천구,1824, 독산근린공원 입구,202002,597,597,1194,37.46455,126.883728
금천구,1824, 독산근린공원 입구,202003,1542,1560,3102,37.46455,126.883728
금천구,1824, 독산근린공원 입구,202004,2142,2124,4266,37.46455,126.883728
금천구,1824, 독산근린공원 입구,202005,2569,2579,5148,37.46455,126.883728
금천구,1824, 독산근린공원 입구,202006,2435,2502,4937,37.46455,126.883728
금천구,1825, 한신아파트 앞 육교 아래,201901,86,72,158,37.4547,126.891052
금천구,1825, 한신아파트 앞 육교 아래,201902,63,61,124,37.4547,126.891052
금천구,1825, 한신아파트 앞 육교 아래,201903,131,112,243,37.4547,126.891052
금천구,1825, 한신아파트 앞 육교 아래,201904,257,266,523,37.4547,126.891052
금천구,1825, 한신아파트 앞 육교 아래,201905,385,447,832,37.4547,126.891052
금천구,1825, 한신아파트 앞 육교 아래,201906,445,525,970,37.4547,126.891052
금천구,1825, 한신아파트 앞 육교 아래,201907,448,575,1023,37.4547,126.891052
금천구,1825, 한신아파트 앞 육교 아래,201908,475,568,1043,37.4547,126.891052
금천구,1825, 한신아파트 앞 육교 아래,201909,425,509,934,37.4547,126.891052
금천구,1825, 한신아파트 앞 육교 아래,201910,486,543,1029,37.4547,126.891052
금천구,1825, 한신아파트 앞 육교 아래,201911,269,329,598,37.4547,126.891052
금천구,1825, 한신아파트 앞 육교 아래,201912,160,205,365,37.4547,126.891052
금천구,1825, 한신아파트 앞 육교 아래,202001,177,204,381,37.4547,126.891052
금천구,1825, 한신아파트 앞 육교 아래,202002,140,181,321,37.4547,126.891052
금천구,1825, 한신아파트 앞 육교 아래,202003,365,376,741,37.4547,126.891052
금천구,1825, 한신아파트 앞 육교 아래,202004,606,646,1252,37.4547,126.891052
금천구,1825, 한신아파트 앞 육교 아래,202005,730,754,1484,37.4547,126.891052
금천구,1825, 한신아파트 앞 육교 아래,202006,779,847,1626,37.4547,126.891052
금천구,1826, 한신코아 앞,201901,147,115,262,37.456841,126.888344
금천구,1826, 한신코아 앞,201902,107,115,222,37.456841,126.888344
금천구,1826, 한신코아 앞,201903,188,200,388,37.456841,126.888344
금천구,1826, 한신코아 앞,201904,315,324,639,37.456841,126.888344
금천구,1826, 한신코아 앞,201905,484,463,947,37.456841,126.888344
금천구,1826, 한신코아 앞,201906,554,634,1188,37.456841,126.888344
금천구,1826, 한신코아 앞,201907,535,656,1191,37.456841,126.888344
금천구,1826, 한신코아 앞,201908,644,741,1385,37.456841,126.888344
금천구,1826, 한신코아 앞,201909,602,616,1218,37.456841,126.888344
금천구,1826, 한신코아 앞,201910,824,822,1646,37.456841,126.888344
금천구,1826, 한신코아 앞,201911,504,527,1031,37.456841,126.888344
금천구,1826, 한신코아 앞,201912,300,330,630,37.456841,126.888344
금천구,1826, 한신코아 앞,202001,258,270,528,37.456841,126.888344
금천구,1826, 한신코아 앞,202002,258,281,539,37.456841,126.888344
금천구,1826, 한신코아 앞,202003,485,470,955,37.456841,126.888344
금천구,1826, 한신코아 앞,202004,856,838,1694,37.456841,126.888344
금천구,1826, 한신코아 앞,202005,800,758,1558,37.456841,126.888344
금천구,1826, 한신코아 앞,202006,681,774,1455,37.456841,126.888344
금천구,1827, 독산보도육교 앞 자전거 보관소,201901,324,322,646,37.455849,126.893143
금천구,1827, 독산보도육교 앞 자전거 보관소,201902,374,406,780,37.455849,126.893143
금천구,1827, 독산보도육교 앞 자전거 보관소,201903,746,725,1471,37.455849,126.893143
금천구,1827, 독산보도육교 앞 자전거 보관소,201904,1618,1718,3336,37.455849,126.893143
금천구,1827, 독산보도육교 앞 자전거 보관소,201905,2253,2346,4599,37.455849,126.893143
금천구,1827, 독산보도육교 앞 자전거 보관소,201906,2351,2557,4908,37.455849,126.893143
금천구,1827, 독산보도육교 앞 자전거 보관소,201907,2164,2400,4564,37.455849,126.893143
금천구,1827, 독산보도육교 앞 자전거 보관소,201908,2226,2308,4534,37.455849,126.893143
금천구,1827, 독산보도육교 앞 자전거 보관소,201909,2238,2313,4551,37.455849,126.893143
금천구,1827, 독산보도육교 앞 자전거 보관소,201910,2593,2696,5289,37.455849,126.893143
금천구,1827, 독산보도육교 앞 자전거 보관소,201911,1346,1432,2778,37.455849,126.893143
금천구,1827, 독산보도육교 앞 자전거 보관소,201912,673,663,1336,37.455849,126.893143
금천구,1827, 독산보도육교 앞 자전거 보관소,202001,651,647,1298,37.455849,126.893143
금천구,1827, 독산보도육교 앞 자전거 보관소,202002,838,832,1670,37.455849,126.893143
금천구,1827, 독산보도육교 앞 자전거 보관소,202003,2817,2835,5652,37.455849,126.893143
금천구,1827, 독산보도육교 앞 자전거 보관소,202004,4403,4489,8892,37.455849,126.893143
금천구,1827, 독산보도육교 앞 자전거 보관소,202005,4255,4425,8680,37.455849,126.893143
금천구,1827, 독산보도육교 앞 자전거 보관소,202006,3921,4084,8005,37.455849,126.893143
금천구,1828, 한양수자인아파트 앞,201901,192,105,297,37.475319,126.898888
금천구,1828, 한양수자인아파트 앞,201902,163,106,269,37.475319,126.898888
금천구,1828, 한양수자인아파트 앞,201903,297,171,468,37.475319,126.898888
금천구,1828, 한양수자인아파트 앞,201904,441,286,727,37.475319,126.898888
금천구,1828, 한양수자인아파트 앞,201905,647,441,1088,37.475319,126.898888
금천구,1828, 한양수자인아파트 앞,201906,689,434,1123,37.475319,126.898888
금천구,1828, 한양수자인아파트 앞,201907,728,418,1146,37.475319,126.898888
금천구,1828, 한양수자인아파트 앞,201908,593,339,932,37.475319,126.898888
금천구,1828, 한양수자인아파트 앞,201909,435,334,769,37.475319,126.898888
금천구,1828, 한양수자인아파트 앞,201910,528,321,849,37.475319,126.898888
금천구,1828, 한양수자인아파트 앞,201911,484,268,752,37.475319,126.898888
금천구,1828, 한양수자인아파트 앞,201912,342,229,571,37.475319,126.898888
금천구,1828, 한양수자인아파트 앞,202001,257,181,438,37.475319,126.898888
금천구,1828, 한양수자인아파트 앞,202002,242,177,419,37.475319,126.898888
금천구,1828, 한양수자인아파트 앞,202003,309,192,501,37.475319,126.898888
금천구,1828, 한양수자인아파트 앞,202004,508,367,875,37.475319,126.898888
금천구,1828, 한양수자인아파트 앞,202005,526,378,904,37.475319,126.898888
금천구,1828, 한양수자인아파트 앞,202006,937,500,1437,37.475319,126.898888
금천구,1829, 홈플러스 금천점 앞,201901,227,300,527,37.469139,126.897202
금천구,1829, 홈플러스 금천점 앞,201902,184,251,435,37.469139,126.897202
금천구,1829, 홈플러스 금천점 앞,201903,357,499,856,37.469139,126.897202
금천구,1829, 홈플러스 금천점 앞,201904,629,751,1380,37.469139,126.897202
금천구,1829, 홈플러스 금천점 앞,201905,961,1080,2041,37.469139,126.897202
금천구,1829, 홈플러스 금천점 앞,201906,1222,1342,2564,37.469139,126.897202
금천구,1829, 홈플러스 금천점 앞,201907,1103,1199,2302,37.469139,126.897202
금천구,1829, 홈플러스 금천점 앞,201908,1007,1112,2119,37.469139,126.897202
금천구,1829, 홈플러스 금천점 앞,201909,1001,1038,2039,37.469139,126.897202
금천구,1829, 홈플러스 금천점 앞,201910,1266,1361,2627,37.469139,126.897202
금천구,1829, 홈플러스 금천점 앞,201911,803,908,1711,37.469139,126.897202
금천구,1829, 홈플러스 금천점 앞,201912,481,555,1036,37.469139,126.897202
금천구,1829, 홈플러스 금천점 앞,202001,484,501,985,37.469139,126.897202
금천구,1829, 홈플러스 금천점 앞,202002,488,513,1001,37.469139,126.897202
금천구,1829, 홈플러스 금천점 앞,202003,628,631,1259,37.469139,126.897202
금천구,1829, 홈플러스 금천점 앞,202004,1083,1115,2198,37.469139,126.897202
금천구,1829, 홈플러스 금천점 앞,202005,1154,1155,2309,37.469139,126.897202
금천구,1829, 홈플러스 금천점 앞,202006,1342,1393,2735,37.469139,126.897202
금천구,1830, 빅마켓 금천점 앞,201901,267,382,649,37.47023,126.895073
금천구,1830, 빅마켓 금천점 앞,201902,254,306,560,37.47023,126.895073
금천구,1830, 빅마켓 금천점 앞,201903,486,482,968,37.47023,126.895073
금천구,1830, 빅마켓 금천점 앞,201904,831,868,1699,37.47023,126.895073
금천구,1830, 빅마켓 금천점 앞,201905,1203,1173,2376,37.47023,126.895073
금천구,1830, 빅마켓 금천점 앞,201906,1218,1214,2432,37.47023,126.895073
금천구,1830, 빅마켓 금천점 앞,201907,1144,1098,2242,37.47023,126.895073
금천구,1830, 빅마켓 금천점 앞,201908,1055,1129,2184,37.47023,126.895073
금천구,1830, 빅마켓 금천점 앞,201909,1044,1048,2092,37.47023,126.895073
금천구,1830, 빅마켓 금천점 앞,201910,1253,1239,2492,37.47023,126.895073
금천구,1830, 빅마켓 금천점 앞,201911,917,902,1819,37.47023,126.895073
금천구,1830, 빅마켓 금천점 앞,201912,490,543,1033,37.47023,126.895073
금천구,1830, 빅마켓 금천점 앞,202001,439,481,920,37.47023,126.895073
금천구,1830, 빅마켓 금천점 앞,202002,429,454,883,37.47023,126.895073
금천구,1830, 빅마켓 금천점 앞,202003,558,564,1122,37.47023,126.895073
금천구,1830, 빅마켓 금천점 앞,202004,876,876,1752,37.47023,126.895073
금천구,1830, 빅마켓 금천점 앞,202005,1021,1021,2042,37.47023,126.895073
금천구,1830, 빅마켓 금천점 앞,202006,1319,1360,2679,37.47023,126.895073
금천구,1831, 메이퀸웨딩컨벤션 앞,201901,139,107,246,37.4725,126.897957
금천구,1831, 메이퀸웨딩컨벤션 앞,201902,115,98,213,37.4725,126.897957
금천구,1831, 메이퀸웨딩컨벤션 앞,201903,231,232,463,37.4725,126.897957
금천구,1831, 메이퀸웨딩컨벤션 앞,201904,267,281,548,37.4725,126.897957
금천구,1831, 메이퀸웨딩컨벤션 앞,201905,524,561,1085,37.4725,126.897957
금천구,1831, 메이퀸웨딩컨벤션 앞,201906,685,639,1324,37.4725,126.897957
금천구,1831, 메이퀸웨딩컨벤션 앞,201907,550,543,1093,37.4725,126.897957
금천구,1831, 메이퀸웨딩컨벤션 앞,201908,498,497,995,37.4725,126.897957
금천구,1831, 메이퀸웨딩컨벤션 앞,201909,450,454,904,37.4725,126.897957
금천구,1831, 메이퀸웨딩컨벤션 앞,201910,571,512,1083,37.4725,126.897957
금천구,1831, 메이퀸웨딩컨벤션 앞,201911,381,357,738,37.4725,126.897957
금천구,1831, 메이퀸웨딩컨벤션 앞,201912,200,178,378,37.4725,126.897957
금천구,1831, 메이퀸웨딩컨벤션 앞,202001,155,132,287,37.4725,126.897957
금천구,1831, 메이퀸웨딩컨벤션 앞,202002,149,149,298,37.4725,126.897957
금천구,1831, 메이퀸웨딩컨벤션 앞,202003,212,190,402,37.4725,126.897957
금천구,1831, 메이퀸웨딩컨벤션 앞,202004,422,406,828,37.4725,126.897957
금천구,1831, 메이퀸웨딩컨벤션 앞,202005,549,528,1077,37.4725,126.897957
금천구,1831, 메이퀸웨딩컨벤션 앞,202006,648,662,1310,37.4725,126.897957
금천구,1833, 독산역 1번출구 앞 자전거보관소,201901,352,350,702,37.466541,126.890282
금천구,1833, 독산역 1번출구 앞 자전거보관소,201902,275,265,540,37.466541,126.890282
금천구,1833, 독산역 1번출구 앞 자전거보관소,201903,503,527,1030,37.466541,126.890282
금천구,1833, 독산역 1번출구 앞 자전거보관소,201904,819,786,1605,37.466541,126.890282
금천구,1833, 독산역 1번출구 앞 자전거보관소,201905,1276,1253,2529,37.466541,126.890282
금천구,1833, 독산역 1번출구 앞 자전거보관소,201906,1249,1223,2472,37.466541,126.890282
금천구,1833, 독산역 1번출구 앞 자전거보관소,201907,1252,1267,2519,37.466541,126.890282
금천구,1833, 독산역 1번출구 앞 자전거보관소,201908,1158,1154,2312,37.466541,126.890282
금천구,1833, 독산역 1번출구 앞 자전거보관소,201909,1065,1072,2137,37.466541,126.890282
금천구,1833, 독산역 1번출구 앞 자전거보관소,201910,1388,1389,2777,37.466541,126.890282
금천구,1833, 독산역 1번출구 앞 자전거보관소,201911,1028,1051,2079,37.466541,126.890282
금천구,1833, 독산역 1번출구 앞 자전거보관소,201912,695,765,1460,37.466541,126.890282
금천구,1833, 독산역 1번출구 앞 자전거보관소,202001,600,638,1238,37.466541,126.890282
금천구,1833, 독산역 1번출구 앞 자전거보관소,202002,633,640,1273,37.466541,126.890282
금천구,1833, 독산역 1번출구 앞 자전거보관소,202003,659,653,1312,37.466541,126.890282
금천구,1833, 독산역 1번출구 앞 자전거보관소,202004,871,869,1740,37.466541,126.890282
금천구,1833, 독산역 1번출구 앞 자전거보관소,202005,953,948,1901,37.466541,126.890282
금천구,1833, 독산역 1번출구 앞 자전거보관소,202006,1520,1530,3050,37.466541,126.890282
금천구,1834, 월드메르디앙 벤처센터 2차,201901,381,457,838,37.479084,126.879044
금천구,1834, 월드메르디앙 벤처센터 2차,201902,368,362,730,37.479084,126.879044
금천구,1834, 월드메르디앙 벤처센터 2차,201903,796,856,1652,37.479084,126.879044
금천구,1834, 월드메르디앙 벤처센터 2차,201904,1397,1551,2948,37.479084,126.879044
금천구,1834, 월드메르디앙 벤처센터 2차,201905,1803,1905,3708,37.479084,126.879044
금천구,1834, 월드메르디앙 벤처센터 2차,201906,1772,1848,3620,37.479084,126.879044
금천구,1834, 월드메르디앙 벤처센터 2차,201907,1627,1756,3383,37.479084,126.879044
금천구,1834, 월드메르디앙 벤처센터 2차,201908,1515,1525,3040,37.479084,126.879044
금천구,1834, 월드메르디앙 벤처센터 2차,201909,1700,1939,3639,37.479084,126.879044
금천구,1834, 월드메르디앙 벤처센터 2차,201910,2092,2417,4509,37.479084,126.879044
금천구,1834, 월드메르디앙 벤처센터 2차,201911,1336,1480,2816,37.479084,126.879044
금천구,1834, 월드메르디앙 벤처센터 2차,201912,743,845,1588,37.479084,126.879044
금천구,1834, 월드메르디앙 벤처센터 2차,202001,754,793,1547,37.479084,126.879044
금천구,1834, 월드메르디앙 벤처센터 2차,202002,691,737,1428,37.479084,126.879044
금천구,1834, 월드메르디앙 벤처센터 2차,202003,1449,1548,2997,37.479084,126.879044
금천구,1834, 월드메르디앙 벤처센터 2차,202004,2028,2335,4363,37.479084,126.879044
금천구,1834, 월드메르디앙 벤처센터 2차,202005,1981,2232,4213,37.479084,126.879044
금천구,1834, 월드메르디앙 벤처센터 2차,202006,2170,2510,4680,37.479084,126.879044
금천구,1835, STX V타워,201901,237,259,496,37.47707,126.88443
금천구,1835, STX V타워,201902,183,196,379,37.47707,126.88443
금천구,1835, STX V타워,201903,384,418,802,37.47707,126.88443
금천구,1835, STX V타워,201904,534,552,1086,37.47707,126.88443
금천구,1835, STX V타워,201905,795,800,1595,37.47707,126.88443
금천구,1835, STX V타워,201906,601,635,1236,37.47707,126.88443
금천구,1835, STX V타워,201907,672,655,1327,37.47707,126.88443
금천구,1835, STX V타워,201908,573,558,1131,37.47707,126.88443
금천구,1835, STX V타워,201909,616,619,1235,37.47707,126.88443
금천구,1835, STX V타워,201910,850,862,1712,37.47707,126.88443
금천구,1835, STX V타워,201911,580,633,1213,37.47707,126.88443
금천구,1835, STX V타워,201912,411,413,824,37.47707,126.88443
금천구,1835, STX V타워,202001,373,377,750,37.47707,126.88443
금천구,1835, STX V타워,202002,308,315,623,37.47707,126.88443
금천구,1835, STX V타워,202003,535,538,1073,37.47707,126.88443
금천구,1835, STX V타워,202004,744,768,1512,37.47707,126.88443
금천구,1835, STX V타워,202005,816,806,1622,37.47707,126.88443
금천구,1835, STX V타워,202006,933,936,1869,37.47707,126.88443
금천구,1836, 금천구립 독산도서관,201901,105,27,132,37.467403,126.908142
금천구,1836, 금천구립 독산도서관,201902,103,28,131,37.467403,126.908142
금천구,1836, 금천구립 독산도서관,201903,142,71,213,37.467403,126.908142
금천구,1836, 금천구립 독산도서관,201904,190,102,292,37.467403,126.908142
금천구,1836, 금천구립 독산도서관,201905,229,109,338,37.467403,126.908142
금천구,1836, 금천구립 독산도서관,201906,239,122,361,37.467403,126.908142
금천구,1836, 금천구립 독산도서관,201907,239,96,335,37.467403,126.908142
금천구,1836, 금천구립 독산도서관,201908,214,97,311,37.467403,126.908142
금천구,1836, 금천구립 독산도서관,201909,129,72,201,37.467403,126.908142
금천구,1836, 금천구립 독산도서관,201910,96,45,141,37.467403,126.908142
금천구,1836, 금천구립 독산도서관,201911,149,65,214,37.467403,126.908142
금천구,1836, 금천구립 독산도서관,201912,90,32,122,37.467403,126.908142
금천구,1836, 금천구립 독산도서관,202001,3,2,5,37.467403,126.908142
금천구,1836, 금천구립 독산도서관,202006,84,35,119,37.467403,126.908142
금천구,1839, 수출의 다리 아래,201901,418,508,926,37.477058,126.885185
금천구,1839, 수출의 다리 아래,201902,365,369,734,37.477058,126.885185
금천구,1839, 수출의 다리 아래,201903,612,642,1254,37.477058,126.885185
금천구,1839, 수출의 다리 아래,201904,893,936,1829,37.477058,126.885185
금천구,1839, 수출의 다리 아래,201905,1347,1394,2741,37.477058,126.885185
금천구,1839, 수출의 다리 아래,201906,1168,1221,2389,37.477058,126.885185
금천구,1839, 수출의 다리 아래,201907,1172,1274,2446,37.477058,126.885185
금천구,1839, 수출의 다리 아래,201908,1171,1187,2358,37.477058,126.885185
금천구,1839, 수출의 다리 아래,201909,959,984,1943,37.477058,126.885185
금천구,1839, 수출의 다리 아래,201910,1289,1388,2677,37.477058,126.885185
금천구,1839, 수출의 다리 아래,201911,919,1004,1923,37.477058,126.885185
금천구,1839, 수출의 다리 아래,201912,559,612,1171,37.477058,126.885185
금천구,1839, 수출의 다리 아래,202001,539,557,1096,37.477058,126.885185
금천구,1839, 수출의 다리 아래,202002,532,546,1078,37.477058,126.885185
금천구,1839, 수출의 다리 아래,202003,592,583,1175,37.477058,126.885185
금천구,1839, 수출의 다리 아래,202004,910,915,1825,37.477058,126.885185
금천구,1839, 수출의 다리 아래,202005,1017,1014,2031,37.477058,126.885185
금천구,1839, 수출의 다리 아래,202006,1136,1115,2251,37.477058,126.885185
금천구,1840, 솔브레인이엔지 뒤편,201901,123,97,220,37.475101,126.888069
금천구,1840, 솔브레인이엔지 뒤편,201902,105,116,221,37.475101,126.888069
금천구,1840, 솔브레인이엔지 뒤편,201903,310,321,631,37.475101,126.888069
금천구,1840, 솔브레인이엔지 뒤편,201904,471,441,912,37.475101,126.888069
금천구,1840, 솔브레인이엔지 뒤편,201905,687,640,1327,37.475101,126.888069
금천구,1840, 솔브레인이엔지 뒤편,201906,754,658,1412,37.475101,126.888069
금천구,1840, 솔브레인이엔지 뒤편,201907,762,704,1466,37.475101,126.888069
금천구,1840, 솔브레인이엔지 뒤편,201908,601,544,1145,37.475101,126.888069
금천구,1840, 솔브레인이엔지 뒤편,201909,474,461,935,37.475101,126.888069
금천구,1840, 솔브레인이엔지 뒤편,201910,543,537,1080,37.475101,126.888069
금천구,1840, 솔브레인이엔지 뒤편,201911,371,367,738,37.475101,126.888069
금천구,1840, 솔브레인이엔지 뒤편,201912,215,214,429,37.475101,126.888069
금천구,1840, 솔브레인이엔지 뒤편,202001,206,201,407,37.475101,126.888069
금천구,1840, 솔브레인이엔지 뒤편,202002,207,202,409,37.475101,126.888069
금천구,1840, 솔브레인이엔지 뒤편,202003,250,246,496,37.475101,126.888069
금천구,1840, 솔브레인이엔지 뒤편,202004,396,391,787,37.475101,126.888069
금천구,1840, 솔브레인이엔지 뒤편,202005,474,474,948,37.475101,126.888069
금천구,1840, 솔브레인이엔지 뒤편,202006,749,707,1456,37.475101,126.888069
금천구,1841, 가산동 주민센터,201901,311,287,598,37.476952,126.891869
금천구,1841, 가산동 주민센터,201902,263,261,524,37.476952,126.891869
금천구,1841, 가산동 주민센터,201903,509,420,929,37.476952,126.891869
금천구,1841, 가산동 주민센터,201904,706,597,1303,37.476952,126.891869
금천구,1841, 가산동 주민센터,201905,1173,1001,2174,37.476952,126.891869
금천구,1841, 가산동 주민센터,201906,1346,1256,2602,37.476952,126.891869
금천구,1841, 가산동 주민센터,201907,1263,1135,2398,37.476952,126.891869
금천구,1841, 가산동 주민센터,201908,1098,1072,2170,37.476952,126.891869
금천구,1841, 가산동 주민센터,201909,932,803,1735,37.476952,126.891869
금천구,1841, 가산동 주민센터,201910,1035,896,1931,37.476952,126.891869
금천구,1841, 가산동 주민센터,201911,737,604,1341,37.476952,126.891869
금천구,1841, 가산동 주민센터,201912,449,408,857,37.476952,126.891869
금천구,1841, 가산동 주민센터,202001,406,380,786,37.476952,126.891869
금천구,1841, 가산동 주민센터,202002,388,349,737,37.476952,126.891869
금천구,1841, 가산동 주민센터,202003,406,372,778,37.476952,126.891869
금천구,1841, 가산동 주민센터,202004,763,692,1455,37.476952,126.891869
금천구,1841, 가산동 주민센터,202005,1020,968,1988,37.476952,126.891869
금천구,1841, 가산동 주민센터,202006,1285,1148,2433,37.476952,126.891869
금천구,1842, 한울중학교,201901,68,24,92,37.462574,126.90686
금천구,1842, 한울중학교,201902,70,45,115,37.462574,126.90686
금천구,1842, 한울중학교,201903,103,61,164,37.462574,126.90686
금천구,1842, 한울중학교,201904,259,141,400,37.462574,126.90686
금천구,1842, 한울중학교,201905,398,241,639,37.462574,126.90686
금천구,1842, 한울중학교,201906,533,297,830,37.462574,126.90686
금천구,1842, 한울중학교,201907,489,263,752,37.462574,126.90686
금천구,1842, 한울중학교,201908,433,280,713,37.462574,126.90686
금천구,1842, 한울중학교,201909,345,269,614,37.462574,126.90686
금천구,1842, 한울중학교,201910,463,326,789,37.462574,126.90686
금천구,1842, 한울중학교,201911,360,215,575,37.462574,126.90686
금천구,1842, 한울중학교,201912,145,94,239,37.462574,126.90686
금천구,1842, 한울중학교,202001,124,93,217,37.462574,126.90686
금천구,1842, 한울중학교,202002,109,99,208,37.462574,126.90686
금천구,1842, 한울중학교,202003,143,137,280,37.462574,126.90686
금천구,1842, 한울중학교,202004,304,287,591,37.462574,126.90686
금천구,1842, 한울중학교,202005,344,338,682,37.462574,126.90686
금천구,1842, 한울중학교,202006,392,347,739,37.462574,126.90686
금천구,1843, 독산고등학교,201901,172,171,343,37.477097,126.911133
금천구,1843, 독산고등학교,201902,130,128,258,37.477097,126.911133
금천구,1843, 독산고등학교,201903,220,206,426,37.477097,126.911133
금천구,1843, 독산고등학교,201904,312,285,597,37.477097,126.911133
금천구,1843, 독산고등학교,201905,513,416,929,37.477097,126.911133
금천구,1843, 독산고등학교,201906,604,500,1104,37.477097,126.911133
금천구,1843, 독산고등학교,201907,560,463,1023,37.477097,126.911133
금천구,1843, 독산고등학교,201908,565,500,1065,37.477097,126.911133
금천구,1843, 독산고등학교,201909,467,430,897,37.477097,126.911133
금천구,1843, 독산고등학교,201910,631,501,1132,37.477097,126.911133
금천구,1843, 독산고등학교,201911,495,331,826,37.477097,126.911133
금천구,1843, 독산고등학교,201912,337,270,607,37.477097,126.911133
금천구,1843, 독산고등학교,202001,266,241,507,37.477097,126.911133
금천구,1843, 독산고등학교,202002,188,172,360,37.477097,126.911133
금천구,1843, 독산고등학교,202003,255,201,456,37.477097,126.911133
금천구,1843, 독산고등학교,202004,430,381,811,37.477097,126.911133
금천구,1843, 독산고등학교,202005,533,458,991,37.477097,126.911133
금천구,1843, 독산고등학교,202006,604,503,1107,37.477097,126.911133
금천구,1845, 롯데캐슬골드파크1차 서문,201901,150,138,288,37.460289,126.892189
금천구,1845, 롯데캐슬골드파크1차 서문,201902,134,124,258,37.460289,126.892189
금천구,1845, 롯데캐슬골드파크1차 서문,201903,258,208,466,37.460289,126.892189
금천구,1845, 롯데캐슬골드파크1차 서문,201904,447,348,795,37.460289,126.892189
금천구,1845, 롯데캐슬골드파크1차 서문,201905,569,474,1043,37.460289,126.892189
금천구,1845, 롯데캐슬골드파크1차 서문,201906,628,591,1219,37.460289,126.892189
금천구,1845, 롯데캐슬골드파크1차 서문,201907,684,651,1335,37.460289,126.892189
금천구,1845, 롯데캐슬골드파크1차 서문,201908,586,588,1174,37.460289,126.892189
금천구,1845, 롯데캐슬골드파크1차 서문,201909,551,523,1074,37.460289,126.892189
금천구,1845, 롯데캐슬골드파크1차 서문,201910,682,640,1322,37.460289,126.892189
금천구,1845, 롯데캐슬골드파크1차 서문,201911,343,312,655,37.460289,126.892189
금천구,1845, 롯데캐슬골드파크1차 서문,201912,238,200,438,37.460289,126.892189
금천구,1845, 롯데캐슬골드파크1차 서문,202001,261,235,496,37.460289,126.892189
금천구,1845, 롯데캐슬골드파크1차 서문,202002,216,211,427,37.460289,126.892189
금천구,1845, 롯데캐슬골드파크1차 서문,202003,264,250,514,37.460289,126.892189
금천구,1845, 롯데캐슬골드파크1차 서문,202004,474,449,923,37.460289,126.892189
금천구,1845, 롯데캐슬골드파크1차 서문,202005,614,576,1190,37.460289,126.892189
금천구,1845, 롯데캐슬골드파크1차 서문,202006,760,760,1520,37.460289,126.892189
금천구,1846, 롯데캐슬골드파크1차 동문,201901,159,199,358,37.460171,126.896042
금천구,1846, 롯데캐슬골드파크1차 동문,201902,143,198,341,37.460171,126.896042
금천구,1846, 롯데캐슬골드파크1차 동문,201903,344,368,712,37.460171,126.896042
금천구,1846, 롯데캐슬골드파크1차 동문,201904,644,717,1361,37.460171,126.896042
금천구,1846, 롯데캐슬골드파크1차 동문,201905,1288,1365,2653,37.460171,126.896042
금천구,1846, 롯데캐슬골드파크1차 동문,201906,1466,1476,2942,37.460171,126.896042
금천구,1846, 롯데캐슬골드파크1차 동문,201907,1362,1355,2717,37.460171,126.896042
금천구,1846, 롯데캐슬골드파크1차 동문,201908,1256,1324,2580,37.460171,126.896042
금천구,1846, 롯데캐슬골드파크1차 동문,201909,1100,1077,2177,37.460171,126.896042
금천구,1846, 롯데캐슬골드파크1차 동문,201910,1318,1269,2587,37.460171,126.896042
금천구,1846, 롯데캐슬골드파크1차 동문,201911,821,787,1608,37.460171,126.896042
금천구,1846, 롯데캐슬골드파크1차 동문,201912,498,455,953,37.460171,126.896042
금천구,1846, 롯데캐슬골드파크1차 동문,202001,375,379,754,37.460171,126.896042
금천구,1846, 롯데캐슬골드파크1차 동문,202002,376,353,729,37.460171,126.896042
금천구,1846, 롯데캐슬골드파크1차 동문,202003,507,489,996,37.460171,126.896042
금천구,1846, 롯데캐슬골드파크1차 동문,202004,1015,1018,2033,37.460171,126.896042
금천구,1846, 롯데캐슬골드파크1차 동문,202005,1225,1220,2445,37.460171,126.896042
금천구,1846, 롯데캐슬골드파크1차 동문,202006,1128,1217,2345,37.460171,126.896042
금천구,1847, 독산주공 14단지 버스정류소,201901,69,70,139,37.461033,126.8871
금천구,1847, 독산주공 14단지 버스정류소,201902,56,65,121,37.461033,126.8871
금천구,1847, 독산주공 14단지 버스정류소,201903,93,96,189,37.461033,126.8871
금천구,1847, 독산주공 14단지 버스정류소,201904,167,133,300,37.461033,126.8871
금천구,1847, 독산주공 14단지 버스정류소,201905,186,189,375,37.461033,126.8871
금천구,1847, 독산주공 14단지 버스정류소,201906,269,294,563,37.461033,126.8871
금천구,1847, 독산주공 14단지 버스정류소,201907,250,257,507,37.461033,126.8871
금천구,1847, 독산주공 14단지 버스정류소,201908,268,285,553,37.461033,126.8871
금천구,1847, 독산주공 14단지 버스정류소,201909,281,273,554,37.461033,126.8871
금천구,1847, 독산주공 14단지 버스정류소,201910,325,306,631,37.461033,126.8871
금천구,1847, 독산주공 14단지 버스정류소,201911,176,161,337,37.461033,126.8871
금천구,1847, 독산주공 14단지 버스정류소,201912,87,81,168,37.461033,126.8871
금천구,1847, 독산주공 14단지 버스정류소,202001,109,104,213,37.461033,126.8871
금천구,1847, 독산주공 14단지 버스정류소,202002,108,110,218,37.461033,126.8871
금천구,1847, 독산주공 14단지 버스정류소,202003,205,181,386,37.461033,126.8871
금천구,1847, 독산주공 14단지 버스정류소,202004,311,268,579,37.461033,126.8871
금천구,1847, 독산주공 14단지 버스정류소,202005,340,312,652,37.461033,126.8871
금천구,1847, 독산주공 14단지 버스정류소,202006,367,331,698,37.461033,126.8871
금천구,1848, 벽산 디지털밸리 5차,201901,192,217,409,37.476276,126.885391
금천구,1848, 벽산 디지털밸리 5차,201902,183,231,414,37.476276,126.885391
금천구,1848, 벽산 디지털밸리 5차,201903,334,510,844,37.476276,126.885391
금천구,1848, 벽산 디지털밸리 5차,201904,511,755,1266,37.476276,126.885391
금천구,1848, 벽산 디지털밸리 5차,201905,804,1060,1864,37.476276,126.885391
금천구,1848, 벽산 디지털밸리 5차,201906,865,1052,1917,37.476276,126.885391
금천구,1848, 벽산 디지털밸리 5차,201907,845,1138,1983,37.476276,126.885391
금천구,1848, 벽산 디지털밸리 5차,201908,921,948,1869,37.476276,126.885391
금천구,1848, 벽산 디지털밸리 5차,201909,792,874,1666,37.476276,126.885391
금천구,1848, 벽산 디지털밸리 5차,201910,939,1092,2031,37.476276,126.885391
금천구,1848, 벽산 디지털밸리 5차,201911,609,793,1402,37.476276,126.885391
금천구,1848, 벽산 디지털밸리 5차,201912,428,488,916,37.476276,126.885391
금천구,1848, 벽산 디지털밸리 5차,202001,368,478,846,37.476276,126.885391
금천구,1848, 벽산 디지털밸리 5차,202002,401,441,842,37.476276,126.885391
금천구,1848, 벽산 디지털밸리 5차,202003,419,430,849,37.476276,126.885391
금천구,1848, 벽산 디지털밸리 5차,202004,497,583,1080,37.476276,126.885391
금천구,1848, 벽산 디지털밸리 5차,202005,592,666,1258,37.476276,126.885391
금천구,1848, 벽산 디지털밸리 5차,202006,1002,1139,2141,37.476276,126.885391
금천구,1849, 대륭포스트타워5차,201901,107,84,191,37.481354,126.88694
금천구,1849, 대륭포스트타워5차,201902,72,80,152,37.481354,126.88694
금천구,1849, 대륭포스트타워5차,201903,144,126,270,37.481354,126.88694
금천구,1849, 대륭포스트타워5차,201904,237,227,464,37.481354,126.88694
금천구,1849, 대륭포스트타워5차,201905,282,281,563,37.481354,126.88694
금천구,1849, 대륭포스트타워5차,201906,383,348,731,37.481354,126.88694
금천구,1849, 대륭포스트타워5차,201907,489,360,849,37.481354,126.88694
금천구,1849, 대륭포스트타워5차,201908,431,319,750,37.481354,126.88694
금천구,1849, 대륭포스트타워5차,201909,378,272,650,37.481354,126.88694
금천구,1849, 대륭포스트타워5차,201910,406,371,777,37.481354,126.88694
금천구,1849, 대륭포스트타워5차,201911,285,289,574,37.481354,126.88694
금천구,1849, 대륭포스트타워5차,201912,164,171,335,37.481354,126.88694
금천구,1849, 대륭포스트타워5차,202001,182,210,392,37.481354,126.88694
금천구,1849, 대륭포스트타워5차,202002,183,200,383,37.481354,126.88694
금천구,1849, 대륭포스트타워5차,202003,245,243,488,37.481354,126.88694
금천구,1849, 대륭포스트타워5차,202004,421,425,846,37.481354,126.88694
금천구,1849, 대륭포스트타워5차,202005,409,408,817,37.481354,126.88694
금천구,1849, 대륭포스트타워5차,202006,480,468,948,37.481354,126.88694
금천구,1850, 코오롱테크노밸리,201901,191,191,382,37.48016,126.886368
금천구,1850, 코오롱테크노밸리,201902,166,153,319,37.48016,126.886368
금천구,1850, 코오롱테크노밸리,201903,267,292,559,37.48016,126.886368
금천구,1850, 코오롱테크노밸리,201904,302,298,600,37.48016,126.886368
금천구,1850, 코오롱테크노밸리,201905,562,546,1108,37.48016,126.886368
금천구,1850, 코오롱테크노밸리,201906,590,568,1158,37.48016,126.886368
금천구,1850, 코오롱테크노밸리,201907,673,633,1306,37.48016,126.886368
금천구,1850, 코오롱테크노밸리,201908,578,598,1176,37.48016,126.886368
금천구,1850, 코오롱테크노밸리,201909,534,532,1066,37.48016,126.886368
금천구,1850, 코오롱테크노밸리,201910,632,630,1262,37.48016,126.886368
금천구,1850, 코오롱테크노밸리,201911,505,527,1032,37.48016,126.886368
금천구,1850, 코오롱테크노밸리,201912,325,334,659,37.48016,126.886368
금천구,1850, 코오롱테크노밸리,202001,302,314,616,37.48016,126.886368
금천구,1850, 코오롱테크노밸리,202002,310,323,633,37.48016,126.886368
금천구,1850, 코오롱테크노밸리,202003,333,329,662,37.48016,126.886368
금천구,1850, 코오롱테크노밸리,202004,478,483,961,37.48016,126.886368
금천구,1850, 코오롱테크노밸리,202005,546,539,1085,37.48016,126.886368
금천구,1850, 코오롱테크노밸리,202006,479,472,951,37.48016,126.886368
금천구,1851, 가산디지털단지 7번출구,201901,483,537,1020,37.481232,126.881485
금천구,1851, 가산디지털단지 7번출구,201902,380,426,806,37.481232,126.881485
금천구,1851, 가산디지털단지 7번출구,201903,794,837,1631,37.481232,126.881485
금천구,1851, 가산디지털단지 7번출구,201904,1237,1196,2433,37.481232,126.881485
금천구,1851, 가산디지털단지 7번출구,201905,1689,1672,3361,37.481232,126.881485
금천구,1851, 가산디지털단지 7번출구,201906,1834,1803,3637,37.481232,126.881485
금천구,1851, 가산디지털단지 7번출구,201907,1901,1880,3781,37.481232,126.881485
금천구,1851, 가산디지털단지 7번출구,201908,1650,1653,3303,37.481232,126.881485
금천구,1851, 가산디지털단지 7번출구,201909,1516,1510,3026,37.481232,126.881485
금천구,1851, 가산디지털단지 7번출구,201910,2218,2221,4439,37.481232,126.881485
금천구,1851, 가산디지털단지 7번출구,201911,1573,1580,3153,37.481232,126.881485
금천구,1851, 가산디지털단지 7번출구,201912,899,938,1837,37.481232,126.881485
금천구,1851, 가산디지털단지 7번출구,202001,755,764,1519,37.481232,126.881485
금천구,1851, 가산디지털단지 7번출구,202002,878,870,1748,37.481232,126.881485
금천구,1851, 가산디지털단지 7번출구,202003,1080,1081,2161,37.481232,126.881485
금천구,1851, 가산디지털단지 7번출구,202004,1476,1481,2957,37.481232,126.881485
금천구,1851, 가산디지털단지 7번출구,202005,1646,1629,3275,37.481232,126.881485
금천구,1851, 가산디지털단지 7번출구,202006,2193,2182,4375,37.481232,126.881485
금천구,1852, 혜명양로원 담장 옆,201901,52,53,105,37.451771,126.913399
금천구,1852, 혜명양로원 담장 옆,201902,64,47,111,37.451771,126.913399
금천구,1852, 혜명양로원 담장 옆,201903,169,100,269,37.451771,126.913399
금천구,1852, 혜명양로원 담장 옆,201904,254,159,413,37.451771,126.913399
금천구,1852, 혜명양로원 담장 옆,201905,402,263,665,37.451771,126.913399
금천구,1852, 혜명양로원 담장 옆,201906,360,270,630,37.451771,126.913399
금천구,1852, 혜명양로원 담장 옆,201907,369,223,592,37.451771,126.913399
금천구,1852, 혜명양로원 담장 옆,201908,352,252,604,37.451771,126.913399
금천구,1852, 혜명양로원 담장 옆,201909,316,245,561,37.451771,126.913399
금천구,1852, 혜명양로원 담장 옆,201910,394,313,707,37.451771,126.913399
금천구,1852, 혜명양로원 담장 옆,201911,297,228,525,37.451771,126.913399
금천구,1852, 혜명양로원 담장 옆,201912,153,98,251,37.451771,126.913399
금천구,1852, 혜명양로원 담장 옆,202001,128,101,229,37.451771,126.913399
금천구,1852, 혜명양로원 담장 옆,202002,110,86,196,37.451771,126.913399
금천구,1852, 혜명양로원 담장 옆,202003,209,197,406,37.451771,126.913399
금천구,1852, 혜명양로원 담장 옆,202004,418,399,817,37.451771,126.913399
금천구,1852, 혜명양로원 담장 옆,202005,488,463,951,37.451771,126.913399
금천구,1852, 혜명양로원 담장 옆,202006,540,526,1066,37.451771,126.913399
금천구,1853, 서울디자인직업전문학교 앞,201901,68,74,142,37.472481,126.895866
금천구,1853, 서울디자인직업전문학교 앞,201902,56,48,104,37.472481,126.895866
금천구,1853, 서울디자인직업전문학교 앞,201903,121,108,229,37.472481,126.895866
금천구,1853, 서울디자인직업전문학교 앞,201904,186,167,353,37.472481,126.895866
금천구,1853, 서울디자인직업전문학교 앞,201905,295,279,574,37.472481,126.895866
금천구,1853, 서울디자인직업전문학교 앞,201906,296,276,572,37.472481,126.895866
금천구,1853, 서울디자인직업전문학교 앞,201907,371,358,729,37.472481,126.895866
금천구,1853, 서울디자인직업전문학교 앞,201908,346,327,673,37.472481,126.895866
금천구,1853, 서울디자인직업전문학교 앞,201909,241,237,478,37.472481,126.895866
금천구,1853, 서울디자인직업전문학교 앞,201910,289,272,561,37.472481,126.895866
금천구,1853, 서울디자인직업전문학교 앞,201911,229,248,477,37.472481,126.895866
금천구,1853, 서울디자인직업전문학교 앞,201912,154,146,300,37.472481,126.895866
금천구,1853, 서울디자인직업전문학교 앞,202001,176,152,328,37.472481,126.895866
금천구,1853, 서울디자인직업전문학교 앞,202002,114,103,217,37.472481,126.895866
금천구,1853, 서울디자인직업전문학교 앞,202003,178,174,352,37.472481,126.895866
금천구,1853, 서울디자인직업전문학교 앞,202004,223,214,437,37.472481,126.895866
금천구,1853, 서울디자인직업전문학교 앞,202005,275,254,529,37.472481,126.895866
금천구,1853, 서울디자인직업전문학교 앞,202006,317,284,601,37.472481,126.895866
금천구,1854, 가산아네스트 오피스텔 앞,201901,113,41,154,37.47818,126.897408
금천구,1854, 가산아네스트 오피스텔 앞,201902,123,58,181,37.47818,126.897408
금천구,1854, 가산아네스트 오피스텔 앞,201903,174,79,253,37.47818,126.897408
금천구,1854, 가산아네스트 오피스텔 앞,201904,315,134,449,37.47818,126.897408
금천구,1854, 가산아네스트 오피스텔 앞,201905,517,256,773,37.47818,126.897408
금천구,1854, 가산아네스트 오피스텔 앞,201906,562,284,846,37.47818,126.897408
금천구,1854, 가산아네스트 오피스텔 앞,201907,598,315,913,37.47818,126.897408
금천구,1854, 가산아네스트 오피스텔 앞,201908,561,263,824,37.47818,126.897408
금천구,1854, 가산아네스트 오피스텔 앞,201909,475,229,704,37.47818,126.897408
금천구,1854, 가산아네스트 오피스텔 앞,201910,709,303,1012,37.47818,126.897408
금천구,1854, 가산아네스트 오피스텔 앞,201911,555,225,780,37.47818,126.897408
금천구,1854, 가산아네스트 오피스텔 앞,201912,225,106,331,37.47818,126.897408
금천구,1854, 가산아네스트 오피스텔 앞,202001,218,114,332,37.47818,126.897408
금천구,1854, 가산아네스트 오피스텔 앞,202002,201,120,321,37.47818,126.897408
금천구,1854, 가산아네스트 오피스텔 앞,202003,336,187,523,37.47818,126.897408
금천구,1854, 가산아네스트 오피스텔 앞,202004,462,228,690,37.47818,126.897408
금천구,1854, 가산아네스트 오피스텔 앞,202005,485,245,730,37.47818,126.897408
금천구,1854, 가산아네스트 오피스텔 앞,202006,829,351,1180,37.47818,126.897408
금천구,1855, 성지아파트 옆 도로변,201901,27,25,52,37.451321,126.897621
금천구,1855, 성지아파트 옆 도로변,201902,20,25,45,37.451321,126.897621
금천구,1855, 성지아파트 옆 도로변,201903,45,50,95,37.451321,126.897621
금천구,1855, 성지아파트 옆 도로변,201904,59,69,128,37.451321,126.897621
금천구,1855, 성지아파트 옆 도로변,201905,50,58,108,37.451321,126.897621
금천구,1855, 성지아파트 옆 도로변,201906,92,96,188,37.451321,126.897621
금천구,1855, 성지아파트 옆 도로변,201907,81,83,164,37.451321,126.897621
금천구,1855, 성지아파트 옆 도로변,201908,73,71,144,37.451321,126.897621
금천구,1855, 성지아파트 옆 도로변,201909,97,101,198,37.451321,126.897621
금천구,1855, 성지아파트 옆 도로변,201910,158,167,325,37.451321,126.897621
금천구,1855, 성지아파트 옆 도로변,201911,113,116,229,37.451321,126.897621
금천구,1855, 성지아파트 옆 도로변,201912,74,86,160,37.451321,126.897621
금천구,1855, 성지아파트 옆 도로변,202001,59,61,120,37.451321,126.897621
금천구,1855, 성지아파트 옆 도로변,202002,39,51,90,37.451321,126.897621
금천구,1855, 성지아파트 옆 도로변,202003,65,63,128,37.451321,126.897621
금천구,1855, 성지아파트 옆 도로변,202004,103,92,195,37.451321,126.897621
금천구,1855, 성지아파트 옆 도로변,202005,192,179,371,37.451321,126.897621
금천구,1855, 성지아파트 옆 도로변,202006,174,203,377,37.451321,126.897621
금천구,1856, 모두의학교,201901,115,102,217,37.478409,126.907372
금천구,1856, 모두의학교,201902,125,113,238,37.478409,126.907372
금천구,1856, 모두의학교,201903,235,233,468,37.478409,126.907372
금천구,1856, 모두의학교,201904,311,312,623,37.478409,126.907372
금천구,1856, 모두의학교,201905,582,599,1181,37.478409,126.907372
금천구,1856, 모두의학교,201906,838,841,1679,37.478409,126.907372
금천구,1856, 모두의학교,201907,803,823,1626,37.478409,126.907372
금천구,1856, 모두의학교,201908,743,749,1492,37.478409,126.907372
금천구,1856, 모두의학교,201909,638,625,1263,37.478409,126.907372
금천구,1856, 모두의학교,201910,724,669,1393,37.478409,126.907372
금천구,1856, 모두의학교,201911,492,437,929,37.478409,126.907372
금천구,1856, 모두의학교,201912,363,365,728,37.478409,126.907372
금천구,1856, 모두의학교,202001,276,253,529,37.478409,126.907372
금천구,1856, 모두의학교,202002,308,298,606,37.478409,126.907372
금천구,1856, 모두의학교,202003,451,417,868,37.478409,126.907372
금천구,1856, 모두의학교,202004,554,543,1097,37.478409,126.907372
금천구,1856, 모두의학교,202005,758,724,1482,37.478409,126.907372
금천구,1856, 모두의학교,202006,854,883,1737,37.478409,126.907372
금천구,1857, 주공14단지,201901,96,73,169,37.46056,126.887093
금천구,1857, 주공14단지,201902,99,71,170,37.46056,126.887093
금천구,1857, 주공14단지,201903,183,174,357,37.46056,126.887093
금천구,1857, 주공14단지,201904,194,215,409,37.46056,126.887093
금천구,1857, 주공14단지,201905,236,255,491,37.46056,126.887093
금천구,1857, 주공14단지,201906,288,309,597,37.46056,126.887093
금천구,1857, 주공14단지,201907,324,348,672,37.46056,126.887093
금천구,1857, 주공14단지,201908,282,345,627,37.46056,126.887093
금천구,1857, 주공14단지,201909,273,266,539,37.46056,126.887093
금천구,1857, 주공14단지,201910,372,355,727,37.46056,126.887093
금천구,1857, 주공14단지,201911,216,214,430,37.46056,126.887093
금천구,1857, 주공14단지,201912,204,200,404,37.46056,126.887093
금천구,1857, 주공14단지,202001,141,131,272,37.46056,126.887093
금천구,1857, 주공14단지,202002,167,175,342,37.46056,126.887093
금천구,1857, 주공14단지,202003,243,232,475,37.46056,126.887093
금천구,1857, 주공14단지,202004,320,325,645,37.46056,126.887093
금천구,1857, 주공14단지,202005,336,336,672,37.46056,126.887093
금천구,1857, 주공14단지,202006,343,369,712,37.46056,126.887093
금천구,1858, 석수역1번출구 앞 (SK주유소),201901,44,67,111,37.437271,126.902687
금천구,1858, 석수역1번출구 앞 (SK주유소),201902,44,68,112,37.437271,126.902687
금천구,1858, 석수역1번출구 앞 (SK주유소),201903,111,130,241,37.437271,126.902687
금천구,1858, 석수역1번출구 앞 (SK주유소),201904,197,228,425,37.437271,126.902687
금천구,1858, 석수역1번출구 앞 (SK주유소),201905,312,486,798,37.437271,126.902687
금천구,1858, 석수역1번출구 앞 (SK주유소),201906,360,547,907,37.437271,126.902687
금천구,1858, 석수역1번출구 앞 (SK주유소),201907,292,420,712,37.437271,126.902687
금천구,1858, 석수역1번출구 앞 (SK주유소),201908,325,483,808,37.437271,126.902687
금천구,1858, 석수역1번출구 앞 (SK주유소),201909,416,522,938,37.437271,126.902687
금천구,1858, 석수역1번출구 앞 (SK주유소),201910,442,541,983,37.437271,126.902687
금천구,1858, 석수역1번출구 앞 (SK주유소),201911,214,279,493,37.437271,126.902687
금천구,1858, 석수역1번출구 앞 (SK주유소),201912,74,102,176,37.437271,126.902687
금천구,1858, 석수역1번출구 앞 (SK주유소),202001,97,109,206,37.437271,126.902687
금천구,1858, 석수역1번출구 앞 (SK주유소),202002,118,148,266,37.437271,126.902687
금천구,1858, 석수역1번출구 앞 (SK주유소),202003,467,567,1034,37.437271,126.902687
금천구,1858, 석수역1번출구 앞 (SK주유소),202004,949,1108,2057,37.437271,126.902687
금천구,1858, 석수역1번출구 앞 (SK주유소),202005,855,985,1840,37.437271,126.902687
금천구,1858, 석수역1번출구 앞 (SK주유소),202006,734,916,1650,37.437271,126.902687
금천구,1859, 대륭테크노타운 18차,201903,110,88,198,37.467999,126.886841
금천구,1859, 대륭테크노타운 18차,201904,309,295,604,37.467999,126.886841
금천구,1859, 대륭테크노타운 18차,201905,460,450,910,37.467999,126.886841
금천구,1859, 대륭테크노타운 18차,201906,519,488,1007,37.467999,126.886841
금천구,1859, 대륭테크노타운 18차,201907,487,422,909,37.467999,126.886841
금천구,1859, 대륭테크노타운 18차,201908,327,258,585,37.467999,126.886841
금천구,1859, 대륭테크노타운 18차,201909,424,423,847,37.467999,126.886841
금천구,1859, 대륭테크노타운 18차,201910,619,614,1233,37.467999,126.886841
금천구,1859, 대륭테크노타운 18차,201911,529,535,1064,37.467999,126.886841
금천구,1859, 대륭테크노타운 18차,201912,245,252,497,37.467999,126.886841
금천구,1859, 대륭테크노타운 18차,202001,186,180,366,37.467999,126.886841
금천구,1859, 대륭테크노타운 18차,202002,228,232,460,37.467999,126.886841
금천구,1859, 대륭테크노타운 18차,202003,355,348,703,37.467999,126.886841
금천구,1859, 대륭테크노타운 18차,202004,437,441,878,37.467999,126.886841
금천구,1859, 대륭테크노타운 18차,202005,535,530,1065,37.467999,126.886841
금천구,1859, 대륭테크노타운 18차,202006,833,728,1561,37.467999,126.886841
금천구,1861,IBK기업은행 석수역 지점 앞,202003,1,1,2,37.436981,126.903297
금천구,1861,IBK기업은행 석수역 지점 앞,202005,28,15,43,37.436981,126.903297
금천구,1861,IBK기업은행 석수역 지점 앞,202006,192,142,334,37.436981,126.903297
금천구,1862,스타즈호텔독산 빌딩 앞,202003,1,1,2,37.461346,126.897583
금천구,1862,스타즈호텔독산 빌딩 앞,202005,76,63,139,37.461346,126.897583
금천구,1862,스타즈호텔독산 빌딩 앞,202006,669,598,1267,37.461346,126.897583
금천구,1863,위너스 스포츠클럽 골프연습장옆,202003,1,1,2,37.460537,126.898605
금천구,1863,위너스 스포츠클럽 골프연습장옆,202005,32,22,54,37.460537,126.898605
금천구,1863,위너스 스포츠클럽 골프연습장옆,202006,252,221,473,37.460537,126.898605
금천구,1864,산호시티빌 옆,202003,1,1,2,37.45652,126.899551
금천구,1864,산호시티빌 옆,202005,17,16,33,37.45652,126.899551
금천구,1864,산호시티빌 옆,202006,226,123,349,37.45652,126.899551
금천구,1865,금천구청앞(M빌딩),202003,2,2,4,37.456333,126.896454
금천구,1865,금천구청앞(M빌딩),202004,0,2,2,37.456333,126.896454
금천구,1865,금천구청앞(M빌딩),202005,28,16,44,37.456333,126.896454
금천구,1865,금천구청앞(M빌딩),202006,315,259,574,37.456333,126.896454
금천구,1866,서울안천초등학교 옆,202003,1,2,3,37.457779,126.889427
금천구,1866,서울안천초등학교 옆,202005,41,24,65,37.457779,126.889427
금천구,1866,서울안천초등학교 옆,202006,209,162,371,37.457779,126.889427
금천구,1867,대륭포스트타워6차 앞,202003,1,0,1,37.480888,126.883804
금천구,1867,대륭포스트타워6차 앞,202005,134,131,265,37.480888,126.883804
금천구,1867,대륭포스트타워6차 앞,202006,1440,1426,2866,37.480888,126.883804
금천구,1868,우리은행 시흥남자동화점 앞,202003,1,1,2,37.447853,126.902885
금천구,1868,우리은행 시흥남자동화점 앞,202005,25,24,49,37.447853,126.902885
금천구,1868,우리은행 시흥남자동화점 앞,202006,338,277,615,37.447853,126.902885
금천구,1869,롯데캐슬골드파크3차 301동 앞,202003,1,1,2,37.459019,126.896713
금천구,1869,롯데캐슬골드파크3차 301동 앞,202004,1,1,2,37.459019,126.896713
금천구,1869,롯데캐슬골드파크3차 301동 앞,202005,49,47,96,37.459019,126.896713
금천구,1869,롯데캐슬골드파크3차 301동 앞,202006,533,514,1047,37.459019,126.896713
금천구,1870,독산3동주민센터 앞,202003,1,2,3,37.475071,126.903359
금천구,1870,독산3동주민센터 앞,202004,2,1,3,37.475071,126.903359
금천구,1870,독산3동주민센터 앞,202005,49,48,97,37.475071,126.903359
금천구,1870,독산3동주민센터 앞,202006,461,353,814,37.475071,126.903359
구로구,1901, 신도림동주민센터 앞,201901,277,304,581,37.507332,126.87973
구로구,1901, 신도림동주민센터 앞,201902,243,264,507,37.507332,126.87973
구로구,1901, 신도림동주민센터 앞,201903,445,484,929,37.507332,126.87973
구로구,1901, 신도림동주민센터 앞,201904,669,772,1441,37.507332,126.87973
구로구,1901, 신도림동주민센터 앞,201905,1117,1154,2271,37.507332,126.87973
구로구,1901, 신도림동주민센터 앞,201906,1266,1321,2587,37.507332,126.87973
구로구,1901, 신도림동주민센터 앞,201907,1300,1329,2629,37.507332,126.87973
구로구,1901, 신도림동주민센터 앞,201908,1088,1203,2291,37.507332,126.87973
구로구,1901, 신도림동주민센터 앞,201909,1195,1211,2406,37.507332,126.87973
구로구,1901, 신도림동주민센터 앞,201910,1799,1791,3590,37.507332,126.87973
구로구,1901, 신도림동주민센터 앞,201911,1014,1024,2038,37.507332,126.87973
구로구,1901, 신도림동주민센터 앞,201912,494,511,1005,37.507332,126.87973
구로구,1901, 신도림동주민센터 앞,202001,497,493,990,37.507332,126.87973
구로구,1901, 신도림동주민센터 앞,202002,502,520,1022,37.507332,126.87973
구로구,1901, 신도림동주민센터 앞,202003,805,818,1623,37.507332,126.87973
구로구,1901, 신도림동주민센터 앞,202004,1306,1289,2595,37.507332,126.87973
구로구,1901, 신도림동주민센터 앞,202005,1477,1478,2955,37.507332,126.87973
구로구,1901, 신도림동주민센터 앞,202006,1705,1735,3440,37.507332,126.87973
구로구,1904, 도림천역 1번 출구 앞,201901,478,402,880,37.51424,126.882874
구로구,1904, 도림천역 1번 출구 앞,201902,342,323,665,37.51424,126.882874
구로구,1904, 도림천역 1번 출구 앞,201903,619,543,1162,37.51424,126.882874
구로구,1904, 도림천역 1번 출구 앞,201904,1183,1114,2297,37.51424,126.882874
구로구,1904, 도림천역 1번 출구 앞,201905,1489,1400,2889,37.51424,126.882874
구로구,1904, 도림천역 1번 출구 앞,201906,2093,1942,4035,37.51424,126.882874
구로구,1904, 도림천역 1번 출구 앞,201907,2097,1962,4059,37.51424,126.882874
구로구,1904, 도림천역 1번 출구 앞,201908,2119,1986,4105,37.51424,126.882874
구로구,1904, 도림천역 1번 출구 앞,201909,1852,1810,3662,37.51424,126.882874
구로구,1904, 도림천역 1번 출구 앞,201910,2211,2118,4329,37.51424,126.882874
구로구,1904, 도림천역 1번 출구 앞,201911,1356,1252,2608,37.51424,126.882874
구로구,1904, 도림천역 1번 출구 앞,201912,690,585,1275,37.51424,126.882874
구로구,1904, 도림천역 1번 출구 앞,202001,729,685,1414,37.51424,126.882874
구로구,1904, 도림천역 1번 출구 앞,202002,645,596,1241,37.51424,126.882874
구로구,1904, 도림천역 1번 출구 앞,202003,1412,1363,2775,37.51424,126.882874
구로구,1904, 도림천역 1번 출구 앞,202004,1929,1817,3746,37.51424,126.882874
구로구,1904, 도림천역 1번 출구 앞,202005,1965,1865,3830,37.51424,126.882874
구로구,1904, 도림천역 1번 출구 앞,202006,1936,1870,3806,37.51424,126.882874
구로구,1906, 신도림역 1번 출구 앞,201901,1188,1105,2293,37.50972,126.890099
구로구,1906, 신도림역 1번 출구 앞,201902,1211,1145,2356,37.50972,126.890099
구로구,1906, 신도림역 1번 출구 앞,201903,2438,2125,4563,37.50972,126.890099
구로구,1906, 신도림역 1번 출구 앞,201904,4221,3704,7925,37.50972,126.890099
구로구,1906, 신도림역 1번 출구 앞,201905,6232,6070,12302,37.50972,126.890099
구로구,1906, 신도림역 1번 출구 앞,201906,6532,6353,12885,37.50972,126.890099
구로구,1906, 신도림역 1번 출구 앞,201907,5851,5679,11530,37.50972,126.890099
구로구,1906, 신도림역 1번 출구 앞,201908,5555,5338,10893,37.50972,126.890099
구로구,1906, 신도림역 1번 출구 앞,201909,5663,5587,11250,37.50972,126.890099
구로구,1906, 신도림역 1번 출구 앞,201910,7082,7094,14176,37.50972,126.890099
구로구,1906, 신도림역 1번 출구 앞,201911,3843,3851,7694,37.50972,126.890099
구로구,1906, 신도림역 1번 출구 앞,201912,1972,1973,3945,37.50972,126.890099
구로구,1906, 신도림역 1번 출구 앞,202001,1840,1807,3647,37.50972,126.890099
구로구,1906, 신도림역 1번 출구 앞,202002,1864,1836,3700,37.50972,126.890099
구로구,1906, 신도림역 1번 출구 앞,202003,3805,3727,7532,37.50972,126.890099
구로구,1906, 신도림역 1번 출구 앞,202004,6569,6513,13082,37.50972,126.890099
구로구,1906, 신도림역 1번 출구 앞,202005,7741,7751,15492,37.50972,126.890099
구로구,1906, 신도림역 1번 출구 앞,202006,7999,7941,15940,37.50972,126.890099
구로구,1907, 구일우성(아) 육교 밑,201901,270,248,518,37.489632,126.876259
구로구,1907, 구일우성(아) 육교 밑,201902,236,196,432,37.489632,126.876259
구로구,1907, 구일우성(아) 육교 밑,201903,427,379,806,37.489632,126.876259
구로구,1907, 구일우성(아) 육교 밑,201904,469,398,867,37.489632,126.876259
구로구,1907, 구일우성(아) 육교 밑,201905,661,591,1252,37.489632,126.876259
구로구,1907, 구일우성(아) 육교 밑,201906,761,686,1447,37.489632,126.876259
구로구,1907, 구일우성(아) 육교 밑,201907,768,697,1465,37.489632,126.876259
구로구,1907, 구일우성(아) 육교 밑,201908,838,756,1594,37.489632,126.876259
구로구,1907, 구일우성(아) 육교 밑,201909,790,714,1504,37.489632,126.876259
구로구,1907, 구일우성(아) 육교 밑,201910,976,870,1846,37.489632,126.876259
구로구,1907, 구일우성(아) 육교 밑,201911,643,579,1222,37.489632,126.876259
구로구,1907, 구일우성(아) 육교 밑,201912,440,399,839,37.489632,126.876259
구로구,1907, 구일우성(아) 육교 밑,202001,410,388,798,37.489632,126.876259
구로구,1907, 구일우성(아) 육교 밑,202002,374,335,709,37.489632,126.876259
구로구,1907, 구일우성(아) 육교 밑,202003,443,418,861,37.489632,126.876259
구로구,1907, 구일우성(아) 육교 밑,202004,739,657,1396,37.489632,126.876259
구로구,1907, 구일우성(아) 육교 밑,202005,843,715,1558,37.489632,126.876259
구로구,1907, 구일우성(아) 육교 밑,202006,1092,965,2057,37.489632,126.876259
구로구,1908, 해원리바파크 육교 밑,201901,446,470,916,37.495285,126.872162
구로구,1908, 해원리바파크 육교 밑,201902,380,381,761,37.495285,126.872162
구로구,1908, 해원리바파크 육교 밑,201903,752,737,1489,37.495285,126.872162
구로구,1908, 해원리바파크 육교 밑,201904,994,918,1912,37.495285,126.872162
구로구,1908, 해원리바파크 육교 밑,201905,1254,1268,2522,37.495285,126.872162
구로구,1908, 해원리바파크 육교 밑,201906,1416,1296,2712,37.495285,126.872162
구로구,1908, 해원리바파크 육교 밑,201907,1402,1411,2813,37.495285,126.872162
구로구,1908, 해원리바파크 육교 밑,201908,1418,1440,2858,37.495285,126.872162
구로구,1908, 해원리바파크 육교 밑,201909,1361,1315,2676,37.495285,126.872162
구로구,1908, 해원리바파크 육교 밑,201910,1770,1701,3471,37.495285,126.872162
구로구,1908, 해원리바파크 육교 밑,201911,1186,1131,2317,37.495285,126.872162
구로구,1908, 해원리바파크 육교 밑,201912,738,683,1421,37.495285,126.872162
구로구,1908, 해원리바파크 육교 밑,202001,585,543,1128,37.495285,126.872162
구로구,1908, 해원리바파크 육교 밑,202002,580,524,1104,37.495285,126.872162
구로구,1908, 해원리바파크 육교 밑,202003,967,840,1807,37.495285,126.872162
구로구,1908, 해원리바파크 육교 밑,202004,1215,1044,2259,37.495285,126.872162
구로구,1908, 해원리바파크 육교 밑,202005,1304,1158,2462,37.495285,126.872162
구로구,1908, 해원리바파크 육교 밑,202006,1599,1513,3112,37.495285,126.872162
구로구,1910, 낙원교회 맞은편,201901,95,114,209,37.497505,126.884377
구로구,1910, 낙원교회 맞은편,201902,107,108,215,37.497505,126.884377
구로구,1910, 낙원교회 맞은편,201903,149,120,269,37.497505,126.884377
구로구,1910, 낙원교회 맞은편,201904,209,192,401,37.497505,126.884377
구로구,1910, 낙원교회 맞은편,201905,318,319,637,37.497505,126.884377
구로구,1910, 낙원교회 맞은편,201906,413,386,799,37.497505,126.884377
구로구,1910, 낙원교회 맞은편,201907,429,433,862,37.497505,126.884377
구로구,1910, 낙원교회 맞은편,201908,372,411,783,37.497505,126.884377
구로구,1910, 낙원교회 맞은편,201909,332,327,659,37.497505,126.884377
구로구,1910, 낙원교회 맞은편,201910,392,397,789,37.497505,126.884377
구로구,1910, 낙원교회 맞은편,201911,310,305,615,37.497505,126.884377
구로구,1910, 낙원교회 맞은편,201912,168,173,341,37.497505,126.884377
구로구,1910, 낙원교회 맞은편,202001,165,164,329,37.497505,126.884377
구로구,1910, 낙원교회 맞은편,202002,134,145,279,37.497505,126.884377
구로구,1910, 낙원교회 맞은편,202003,138,141,279,37.497505,126.884377
구로구,1910, 낙원교회 맞은편,202006,0,2,2,37.497505,126.884377
구로구,1911, 구로디지털단지역 앞,201901,1261,1329,2590,37.48494,126.901321
구로구,1911, 구로디지털단지역 앞,201902,1051,1123,2174,37.48494,126.901321
구로구,1911, 구로디지털단지역 앞,201903,2207,2235,4442,37.48494,126.901321
구로구,1911, 구로디지털단지역 앞,201904,3217,3292,6509,37.48494,126.901321
구로구,1911, 구로디지털단지역 앞,201905,4829,4818,9647,37.48494,126.901321
구로구,1911, 구로디지털단지역 앞,201906,5164,5209,10373,37.48494,126.901321
구로구,1911, 구로디지털단지역 앞,201907,5168,5160,10328,37.48494,126.901321
구로구,1911, 구로디지털단지역 앞,201908,4726,4716,9442,37.48494,126.901321
구로구,1911, 구로디지털단지역 앞,201909,4445,4427,8872,37.48494,126.901321
구로구,1911, 구로디지털단지역 앞,201910,5586,5573,11159,37.48494,126.901321
구로구,1911, 구로디지털단지역 앞,201911,3807,3802,7609,37.48494,126.901321
구로구,1911, 구로디지털단지역 앞,201912,2303,2311,4614,37.48494,126.901321
구로구,1911, 구로디지털단지역 앞,202001,2035,2024,4059,37.48494,126.901321
구로구,1911, 구로디지털단지역 앞,202002,1998,2017,4015,37.48494,126.901321
구로구,1911, 구로디지털단지역 앞,202003,2817,2801,5618,37.48494,126.901321
구로구,1911, 구로디지털단지역 앞,202004,4759,4747,9506,37.48494,126.901321
구로구,1911, 구로디지털단지역 앞,202005,5412,5392,10804,37.48494,126.901321
구로구,1911, 구로디지털단지역 앞,202006,6716,6748,13464,37.48494,126.901321
구로구,1912, 한신휴아파트 앞,201901,315,343,658,37.4888,126.890663
구로구,1912, 한신휴아파트 앞,201902,282,299,581,37.4888,126.890663
구로구,1912, 한신휴아파트 앞,201903,498,516,1014,37.4888,126.890663
구로구,1912, 한신휴아파트 앞,201904,751,766,1517,37.4888,126.890663
구로구,1912, 한신휴아파트 앞,201905,1163,1134,2297,37.4888,126.890663
구로구,1912, 한신휴아파트 앞,201906,1577,1401,2978,37.4888,126.890663
구로구,1912, 한신휴아파트 앞,201907,1733,1579,3312,37.4888,126.890663
구로구,1912, 한신휴아파트 앞,201908,1613,1568,3181,37.4888,126.890663
구로구,1912, 한신휴아파트 앞,201909,1387,1289,2676,37.4888,126.890663
구로구,1912, 한신휴아파트 앞,201910,1778,1656,3434,37.4888,126.890663
구로구,1912, 한신휴아파트 앞,201911,1212,1133,2345,37.4888,126.890663
구로구,1912, 한신휴아파트 앞,201912,693,640,1333,37.4888,126.890663
구로구,1912, 한신휴아파트 앞,202001,540,487,1027,37.4888,126.890663
구로구,1912, 한신휴아파트 앞,202002,533,536,1069,37.4888,126.890663
구로구,1912, 한신휴아파트 앞,202003,848,823,1671,37.4888,126.890663
구로구,1912, 한신휴아파트 앞,202004,1275,1252,2527,37.4888,126.890663
구로구,1912, 한신휴아파트 앞,202005,1557,1510,3067,37.4888,126.890663
구로구,1912, 한신휴아파트 앞,202006,2109,2068,4177,37.4888,126.890663
구로구,1913, 구로리공원,201901,218,227,445,37.491032,126.892151
구로구,1913, 구로리공원,201902,196,216,412,37.491032,126.892151
구로구,1913, 구로리공원,201903,302,351,653,37.491032,126.892151
구로구,1913, 구로리공원,201904,449,474,923,37.491032,126.892151
구로구,1913, 구로리공원,201905,774,740,1514,37.491032,126.892151
구로구,1913, 구로리공원,201906,843,813,1656,37.491032,126.892151
구로구,1913, 구로리공원,201907,930,900,1830,37.491032,126.892151
구로구,1913, 구로리공원,201908,829,858,1687,37.491032,126.892151
구로구,1913, 구로리공원,201909,792,868,1660,37.491032,126.892151
구로구,1913, 구로리공원,201910,1010,1082,2092,37.491032,126.892151
구로구,1913, 구로리공원,201911,593,720,1313,37.491032,126.892151
구로구,1913, 구로리공원,201912,269,369,638,37.491032,126.892151
구로구,1913, 구로리공원,202001,333,406,739,37.491032,126.892151
구로구,1913, 구로리공원,202002,291,306,597,37.491032,126.892151
구로구,1913, 구로리공원,202003,467,515,982,37.491032,126.892151
구로구,1913, 구로리공원,202004,773,813,1586,37.491032,126.892151
구로구,1913, 구로리공원,202005,899,916,1815,37.491032,126.892151
구로구,1913, 구로리공원,202006,1074,1099,2173,37.491032,126.892151
구로구,1914, 대림역4번출구,201901,392,351,743,37.494404,126.894447
구로구,1914, 대림역4번출구,201902,372,351,723,37.494404,126.894447
구로구,1914, 대림역4번출구,201903,411,361,772,37.494404,126.894447
구로구,1914, 대림역4번출구,201904,963,894,1857,37.494404,126.894447
구로구,1914, 대림역4번출구,201905,1590,1530,3120,37.494404,126.894447
구로구,1914, 대림역4번출구,201906,1943,1921,3864,37.494404,126.894447
구로구,1914, 대림역4번출구,201907,1924,1832,3756,37.494404,126.894447
구로구,1914, 대림역4번출구,201908,1779,1807,3586,37.494404,126.894447
구로구,1914, 대림역4번출구,201909,1676,1658,3334,37.494404,126.894447
구로구,1914, 대림역4번출구,201910,1951,1944,3895,37.494404,126.894447
구로구,1914, 대림역4번출구,201911,1288,1277,2565,37.494404,126.894447
구로구,1914, 대림역4번출구,201912,734,732,1466,37.494404,126.894447
구로구,1914, 대림역4번출구,202001,586,559,1145,37.494404,126.894447
구로구,1914, 대림역4번출구,202002,532,532,1064,37.494404,126.894447
구로구,1914, 대림역4번출구,202003,856,857,1713,37.494404,126.894447
구로구,1914, 대림역4번출구,202004,1654,1646,3300,37.494404,126.894447
구로구,1914, 대림역4번출구,202005,1925,1949,3874,37.494404,126.894447
구로구,1914, 대림역4번출구,202006,2439,2442,4881,37.494404,126.894447
구로구,1916, 구로중학교앞,201901,98,79,177,37.494141,126.889984
구로구,1916, 구로중학교앞,201902,95,73,168,37.494141,126.889984
구로구,1916, 구로중학교앞,201903,164,141,305,37.494141,126.889984
구로구,1916, 구로중학교앞,201904,276,258,534,37.494141,126.889984
구로구,1916, 구로중학교앞,201905,390,353,743,37.494141,126.889984
구로구,1916, 구로중학교앞,201906,552,509,1061,37.494141,126.889984
구로구,1916, 구로중학교앞,201907,554,498,1052,37.494141,126.889984
구로구,1916, 구로중학교앞,201908,583,460,1043,37.494141,126.889984
구로구,1916, 구로중학교앞,201909,436,405,841,37.494141,126.889984
구로구,1916, 구로중학교앞,201910,516,484,1000,37.494141,126.889984
구로구,1916, 구로중학교앞,201911,303,316,619,37.494141,126.889984
구로구,1916, 구로중학교앞,201912,165,191,356,37.494141,126.889984
구로구,1916, 구로중학교앞,202001,114,119,233,37.494141,126.889984
구로구,1916, 구로중학교앞,202002,115,118,233,37.494141,126.889984
구로구,1916, 구로중학교앞,202003,229,214,443,37.494141,126.889984
구로구,1916, 구로중학교앞,202004,334,332,666,37.494141,126.889984
구로구,1916, 구로중학교앞,202005,433,429,862,37.494141,126.889984
구로구,1916, 구로중학교앞,202006,614,568,1182,37.494141,126.889984
구로구,1920, 서울미래초등학교 사거리,201901,205,205,410,37.504379,126.888298
구로구,1920, 서울미래초등학교 사거리,201902,237,219,456,37.504379,126.888298
구로구,1920, 서울미래초등학교 사거리,201903,464,425,889,37.504379,126.888298
구로구,1920, 서울미래초등학교 사거리,201904,717,638,1355,37.504379,126.888298
구로구,1920, 서울미래초등학교 사거리,201905,966,887,1853,37.504379,126.888298
구로구,1920, 서울미래초등학교 사거리,201906,1447,1183,2630,37.504379,126.888298
구로구,1920, 서울미래초등학교 사거리,201907,1670,1375,3045,37.504379,126.888298
구로구,1920, 서울미래초등학교 사거리,201908,1716,1447,3163,37.504379,126.888298
구로구,1920, 서울미래초등학교 사거리,201909,1386,1170,2556,37.504379,126.888298
구로구,1920, 서울미래초등학교 사거리,201910,1790,1456,3246,37.504379,126.888298
구로구,1920, 서울미래초등학교 사거리,201911,1068,875,1943,37.504379,126.888298
구로구,1920, 서울미래초등학교 사거리,201912,519,420,939,37.504379,126.888298
구로구,1920, 서울미래초등학교 사거리,202001,608,543,1151,37.504379,126.888298
구로구,1920, 서울미래초등학교 사거리,202002,551,524,1075,37.504379,126.888298
구로구,1920, 서울미래초등학교 사거리,202003,879,871,1750,37.504379,126.888298
구로구,1920, 서울미래초등학교 사거리,202004,1172,1156,2328,37.504379,126.888298
구로구,1920, 서울미래초등학교 사거리,202005,1220,1200,2420,37.504379,126.888298
구로구,1920, 서울미래초등학교 사거리,202006,1601,1528,3129,37.504379,126.888298
구로구,1924, 삼부르네상스파크빌,201901,325,141,466,37.478741,126.895096
구로구,1924, 삼부르네상스파크빌,201902,317,171,488,37.478741,126.895096
구로구,1924, 삼부르네상스파크빌,201903,494,299,793,37.478741,126.895096
구로구,1924, 삼부르네상스파크빌,201904,567,329,896,37.478741,126.895096
구로구,1924, 삼부르네상스파크빌,201905,633,441,1074,37.478741,126.895096
구로구,1924, 삼부르네상스파크빌,201906,903,566,1469,37.478741,126.895096
구로구,1924, 삼부르네상스파크빌,201907,858,538,1396,37.478741,126.895096
구로구,1924, 삼부르네상스파크빌,201908,753,471,1224,37.478741,126.895096
구로구,1924, 삼부르네상스파크빌,201909,250,270,520,37.478741,126.895096
구로구,1924, 삼부르네상스파크빌,201910,475,329,804,37.478741,126.895096
구로구,1924, 삼부르네상스파크빌,201911,407,256,663,37.478741,126.895096
구로구,1924, 삼부르네상스파크빌,201912,318,207,525,37.478741,126.895096
구로구,1924, 삼부르네상스파크빌,202001,269,172,441,37.478741,126.895096
구로구,1924, 삼부르네상스파크빌,202002,241,154,395,37.478741,126.895096
구로구,1924, 삼부르네상스파크빌,202003,312,172,484,37.478741,126.895096
구로구,1924, 삼부르네상스파크빌,202004,480,289,769,37.478741,126.895096
구로구,1924, 삼부르네상스파크빌,202005,481,348,829,37.478741,126.895096
구로구,1924, 삼부르네상스파크빌,202006,1012,495,1507,37.478741,126.895096
구로구,1925, 동양미래대학교 정문 옆,201901,560,491,1051,37.499889,126.867699
구로구,1925, 동양미래대학교 정문 옆,201902,498,552,1050,37.499889,126.867699
구로구,1925, 동양미래대학교 정문 옆,201903,1172,1178,2350,37.499889,126.867699
구로구,1925, 동양미래대학교 정문 옆,201904,2130,2242,4372,37.499889,126.867699
구로구,1925, 동양미래대학교 정문 옆,201905,3429,3364,6793,37.499889,126.867699
구로구,1925, 동양미래대학교 정문 옆,201906,3645,3590,7235,37.499889,126.867699
구로구,1925, 동양미래대학교 정문 옆,201907,3246,3183,6429,37.499889,126.867699
구로구,1925, 동양미래대학교 정문 옆,201908,3108,2954,6062,37.499889,126.867699
구로구,1925, 동양미래대학교 정문 옆,201909,3287,3289,6576,37.499889,126.867699
구로구,1925, 동양미래대학교 정문 옆,201910,4043,4055,8098,37.499889,126.867699
구로구,1925, 동양미래대학교 정문 옆,201911,2576,2537,5113,37.499889,126.867699
구로구,1925, 동양미래대학교 정문 옆,201912,1219,1211,2430,37.499889,126.867699
구로구,1925, 동양미래대학교 정문 옆,202001,975,973,1948,37.499889,126.867699
구로구,1925, 동양미래대학교 정문 옆,202002,1041,1083,2124,37.499889,126.867699
구로구,1925, 동양미래대학교 정문 옆,202003,2564,2578,5142,37.499889,126.867699
구로구,1925, 동양미래대학교 정문 옆,202004,3896,3949,7845,37.499889,126.867699
구로구,1925, 동양미래대학교 정문 옆,202005,4246,4272,8518,37.499889,126.867699
구로구,1925, 동양미래대학교 정문 옆,202006,4467,4472,8939,37.499889,126.867699
구로구,1928, 고척스카이돔구장 광장,201901,277,257,534,37.49947,126.868401
구로구,1928, 고척스카이돔구장 광장,201902,215,221,436,37.49947,126.868401
구로구,1928, 고척스카이돔구장 광장,201903,449,423,872,37.49947,126.868401
구로구,1928, 고척스카이돔구장 광장,201904,783,726,1509,37.49947,126.868401
구로구,1928, 고척스카이돔구장 광장,201905,1197,1142,2339,37.49947,126.868401
구로구,1928, 고척스카이돔구장 광장,201906,1211,1161,2372,37.49947,126.868401
구로구,1928, 고척스카이돔구장 광장,201907,1199,1131,2330,37.49947,126.868401
구로구,1928, 고척스카이돔구장 광장,201908,1200,1144,2344,37.49947,126.868401
구로구,1928, 고척스카이돔구장 광장,201909,1102,1068,2170,37.49947,126.868401
구로구,1928, 고척스카이돔구장 광장,201910,1385,1361,2746,37.49947,126.868401
구로구,1928, 고척스카이돔구장 광장,201911,944,922,1866,37.49947,126.868401
구로구,1928, 고척스카이돔구장 광장,201912,512,493,1005,37.49947,126.868401
구로구,1928, 고척스카이돔구장 광장,202001,424,400,824,37.49947,126.868401
구로구,1928, 고척스카이돔구장 광장,202002,379,375,754,37.49947,126.868401
구로구,1928, 고척스카이돔구장 광장,202003,692,672,1364,37.49947,126.868401
구로구,1928, 고척스카이돔구장 광장,202004,1178,1200,2378,37.49947,126.868401
구로구,1928, 고척스카이돔구장 광장,202005,1273,1271,2544,37.49947,126.868401
구로구,1928, 고척스카이돔구장 광장,202006,1181,1120,2301,37.49947,126.868401
구로구,1929, 고척근린공원 고척도서관 앞,201901,215,201,416,37.505135,126.85276
구로구,1929, 고척근린공원 고척도서관 앞,201902,249,199,448,37.505135,126.85276
구로구,1929, 고척근린공원 고척도서관 앞,201903,438,367,805,37.505135,126.85276
구로구,1929, 고척근린공원 고척도서관 앞,201904,674,616,1290,37.505135,126.85276
구로구,1929, 고척근린공원 고척도서관 앞,201905,865,791,1656,37.505135,126.85276
구로구,1929, 고척근린공원 고척도서관 앞,201906,1140,1032,2172,37.505135,126.85276
구로구,1929, 고척근린공원 고척도서관 앞,201907,1128,998,2126,37.505135,126.85276
구로구,1929, 고척근린공원 고척도서관 앞,201908,953,788,1741,37.505135,126.85276
구로구,1929, 고척근린공원 고척도서관 앞,201909,844,807,1651,37.505135,126.85276
구로구,1929, 고척근린공원 고척도서관 앞,201910,1006,907,1913,37.505135,126.85276
구로구,1929, 고척근린공원 고척도서관 앞,201911,664,624,1288,37.505135,126.85276
구로구,1929, 고척근린공원 고척도서관 앞,201912,382,360,742,37.505135,126.85276
구로구,1929, 고척근린공원 고척도서관 앞,202001,371,373,744,37.505135,126.85276
구로구,1929, 고척근린공원 고척도서관 앞,202002,309,290,599,37.505135,126.85276
구로구,1929, 고척근린공원 고척도서관 앞,202003,324,296,620,37.505135,126.85276
구로구,1929, 고척근린공원 고척도서관 앞,202004,732,724,1456,37.505135,126.85276
구로구,1929, 고척근린공원 고척도서관 앞,202005,977,963,1940,37.505135,126.85276
구로구,1929, 고척근린공원 고척도서관 앞,202006,856,821,1677,37.505135,126.85276
구로구,1930, 개봉지구대 개봉치안센터,201901,129,122,251,37.497684,126.853729
구로구,1930, 개봉지구대 개봉치안센터,201902,140,135,275,37.497684,126.853729
구로구,1930, 개봉지구대 개봉치안센터,201903,226,217,443,37.497684,126.853729
구로구,1930, 개봉지구대 개봉치안센터,201904,337,326,663,37.497684,126.853729
구로구,1930, 개봉지구대 개봉치안센터,201905,504,507,1011,37.497684,126.853729
구로구,1930, 개봉지구대 개봉치안센터,201906,488,521,1009,37.497684,126.853729
구로구,1930, 개봉지구대 개봉치안센터,201907,465,497,962,37.497684,126.853729
구로구,1930, 개봉지구대 개봉치안센터,201908,508,529,1037,37.497684,126.853729
구로구,1930, 개봉지구대 개봉치안센터,201909,505,536,1041,37.497684,126.853729
구로구,1930, 개봉지구대 개봉치안센터,201910,542,561,1103,37.497684,126.853729
구로구,1930, 개봉지구대 개봉치안센터,201911,347,365,712,37.497684,126.853729
구로구,1930, 개봉지구대 개봉치안센터,201912,242,226,468,37.497684,126.853729
구로구,1930, 개봉지구대 개봉치안센터,202001,181,186,367,37.497684,126.853729
구로구,1930, 개봉지구대 개봉치안센터,202002,268,277,545,37.497684,126.853729
구로구,1930, 개봉지구대 개봉치안센터,202003,348,339,687,37.497684,126.853729
구로구,1930, 개봉지구대 개봉치안센터,202004,502,511,1013,37.497684,126.853729
구로구,1930, 개봉지구대 개봉치안센터,202005,632,634,1266,37.497684,126.853729
구로구,1930, 개봉지구대 개봉치안센터,202006,670,658,1328,37.497684,126.853729
구로구,1931, 개봉역(북측광장),201901,266,275,541,37.494995,126.858253
구로구,1931, 개봉역(북측광장),201902,210,212,422,37.494995,126.858253
구로구,1931, 개봉역(북측광장),201903,422,522,944,37.494995,126.858253
구로구,1931, 개봉역(북측광장),201904,674,704,1378,37.494995,126.858253
구로구,1931, 개봉역(북측광장),201905,1102,1153,2255,37.494995,126.858253
구로구,1931, 개봉역(북측광장),201906,1338,1553,2891,37.494995,126.858253
구로구,1931, 개봉역(북측광장),201907,1253,1489,2742,37.494995,126.858253
구로구,1931, 개봉역(북측광장),201908,1201,1427,2628,37.494995,126.858253
구로구,1931, 개봉역(북측광장),201909,1204,1294,2498,37.494995,126.858253
구로구,1931, 개봉역(북측광장),201910,1570,1743,3313,37.494995,126.858253
구로구,1931, 개봉역(북측광장),201911,1005,1140,2145,37.494995,126.858253
구로구,1931, 개봉역(북측광장),201912,542,639,1181,37.494995,126.858253
구로구,1931, 개봉역(북측광장),202001,490,531,1021,37.494995,126.858253
구로구,1931, 개봉역(북측광장),202002,451,516,967,37.494995,126.858253
구로구,1931, 개봉역(북측광장),202003,846,880,1726,37.494995,126.858253
구로구,1931, 개봉역(북측광장),202004,1460,1500,2960,37.494995,126.858253
구로구,1931, 개봉역(북측광장),202005,1697,1764,3461,37.494995,126.858253
구로구,1931, 개봉역(북측광장),202006,1926,2140,4066,37.494995,126.858253
구로구,1933, 개봉푸르지오아파트 상가,201901,198,229,427,37.501583,126.84687
구로구,1933, 개봉푸르지오아파트 상가,201902,173,218,391,37.501583,126.84687
구로구,1933, 개봉푸르지오아파트 상가,201903,333,401,734,37.501583,126.84687
구로구,1933, 개봉푸르지오아파트 상가,201904,591,748,1339,37.501583,126.84687
구로구,1933, 개봉푸르지오아파트 상가,201905,982,1213,2195,37.501583,126.84687
구로구,1933, 개봉푸르지오아파트 상가,201906,1099,1459,2558,37.501583,126.84687
구로구,1933, 개봉푸르지오아파트 상가,201907,1039,1332,2371,37.501583,126.84687
구로구,1933, 개봉푸르지오아파트 상가,201908,992,1234,2226,37.501583,126.84687
구로구,1933, 개봉푸르지오아파트 상가,201909,1012,1292,2304,37.501583,126.84687
구로구,1933, 개봉푸르지오아파트 상가,201910,1183,1310,2493,37.501583,126.84687
구로구,1933, 개봉푸르지오아파트 상가,201911,773,846,1619,37.501583,126.84687
구로구,1933, 개봉푸르지오아파트 상가,201912,427,444,871,37.501583,126.84687
구로구,1933, 개봉푸르지오아파트 상가,202001,394,408,802,37.501583,126.84687
구로구,1933, 개봉푸르지오아파트 상가,202002,364,368,732,37.501583,126.84687
구로구,1933, 개봉푸르지오아파트 상가,202003,672,697,1369,37.501583,126.84687
구로구,1933, 개봉푸르지오아파트 상가,202004,1217,1297,2514,37.501583,126.84687
구로구,1933, 개봉푸르지오아파트 상가,202005,1602,1741,3343,37.501583,126.84687
구로구,1933, 개봉푸르지오아파트 상가,202006,1643,1803,3446,37.501583,126.84687
구로구,1936, 개봉역 1번 출구 자전거보관서쪽,201901,100,90,190,37.494282,126.859215
구로구,1936, 개봉역 1번 출구 자전거보관서쪽,201902,77,122,199,37.494282,126.859215
구로구,1936, 개봉역 1번 출구 자전거보관서쪽,201903,208,238,446,37.494282,126.859215
구로구,1936, 개봉역 1번 출구 자전거보관서쪽,201904,299,381,680,37.494282,126.859215
구로구,1936, 개봉역 1번 출구 자전거보관서쪽,201905,422,582,1004,37.494282,126.859215
구로구,1936, 개봉역 1번 출구 자전거보관서쪽,201906,488,586,1074,37.494282,126.859215
구로구,1936, 개봉역 1번 출구 자전거보관서쪽,201907,468,587,1055,37.494282,126.859215
구로구,1936, 개봉역 1번 출구 자전거보관서쪽,201908,495,596,1091,37.494282,126.859215
구로구,1936, 개봉역 1번 출구 자전거보관서쪽,201909,481,526,1007,37.494282,126.859215
구로구,1936, 개봉역 1번 출구 자전거보관서쪽,201910,593,729,1322,37.494282,126.859215
구로구,1936, 개봉역 1번 출구 자전거보관서쪽,201911,395,419,814,37.494282,126.859215
구로구,1936, 개봉역 1번 출구 자전거보관서쪽,201912,213,250,463,37.494282,126.859215
구로구,1936, 개봉역 1번 출구 자전거보관서쪽,202001,228,267,495,37.494282,126.859215
구로구,1936, 개봉역 1번 출구 자전거보관서쪽,202002,217,218,435,37.494282,126.859215
구로구,1936, 개봉역 1번 출구 자전거보관서쪽,202003,472,472,944,37.494282,126.859215
구로구,1936, 개봉역 1번 출구 자전거보관서쪽,202004,864,860,1724,37.494282,126.859215
구로구,1936, 개봉역 1번 출구 자전거보관서쪽,202005,910,901,1811,37.494282,126.859215
구로구,1936, 개봉역 1번 출구 자전거보관서쪽,202006,1031,1045,2076,37.494282,126.859215
구로구,1937, 한진아파트 입구,201901,131,123,254,37.486061,126.852013
구로구,1937, 한진아파트 입구,201902,125,142,267,37.486061,126.852013
구로구,1937, 한진아파트 입구,201903,234,271,505,37.486061,126.852013
구로구,1937, 한진아파트 입구,201904,426,427,853,37.486061,126.852013
구로구,1937, 한진아파트 입구,201905,635,717,1352,37.486061,126.852013
구로구,1937, 한진아파트 입구,201906,646,730,1376,37.486061,126.852013
구로구,1937, 한진아파트 입구,201907,601,676,1277,37.486061,126.852013
구로구,1937, 한진아파트 입구,201908,635,733,1368,37.486061,126.852013
구로구,1937, 한진아파트 입구,201909,740,756,1496,37.486061,126.852013
구로구,1937, 한진아파트 입구,201910,764,822,1586,37.486061,126.852013
구로구,1937, 한진아파트 입구,201911,409,414,823,37.486061,126.852013
구로구,1937, 한진아파트 입구,201912,250,245,495,37.486061,126.852013
구로구,1937, 한진아파트 입구,202001,234,229,463,37.486061,126.852013
구로구,1937, 한진아파트 입구,202002,227,240,467,37.486061,126.852013
구로구,1937, 한진아파트 입구,202003,526,516,1042,37.486061,126.852013
구로구,1937, 한진아파트 입구,202004,839,865,1704,37.486061,126.852013
구로구,1937, 한진아파트 입구,202005,1083,1086,2169,37.486061,126.852013
구로구,1937, 한진아파트 입구,202006,1298,1343,2641,37.486061,126.852013
구로구,1941, 오류동역 2번출구,201901,146,186,332,37.493938,126.844055
구로구,1941, 오류동역 2번출구,201902,115,158,273,37.493938,126.844055
구로구,1941, 오류동역 2번출구,201903,244,348,592,37.493938,126.844055
구로구,1941, 오류동역 2번출구,201904,407,580,987,37.493938,126.844055
구로구,1941, 오류동역 2번출구,201905,743,938,1681,37.493938,126.844055
구로구,1941, 오류동역 2번출구,201906,846,1063,1909,37.493938,126.844055
구로구,1941, 오류동역 2번출구,201907,763,963,1726,37.493938,126.844055
구로구,1941, 오류동역 2번출구,201908,721,1000,1721,37.493938,126.844055
구로구,1941, 오류동역 2번출구,201909,775,1017,1792,37.493938,126.844055
구로구,1941, 오류동역 2번출구,201910,956,1179,2135,37.493938,126.844055
구로구,1941, 오류동역 2번출구,201911,644,811,1455,37.493938,126.844055
구로구,1941, 오류동역 2번출구,201912,447,493,940,37.493938,126.844055
구로구,1941, 오류동역 2번출구,202001,442,539,981,37.493938,126.844055
구로구,1941, 오류동역 2번출구,202002,433,494,927,37.493938,126.844055
구로구,1941, 오류동역 2번출구,202003,638,671,1309,37.493938,126.844055
구로구,1941, 오류동역 2번출구,202004,1038,1081,2119,37.493938,126.844055
구로구,1941, 오류동역 2번출구,202005,1221,1315,2536,37.493938,126.844055
구로구,1941, 오류동역 2번출구,202006,1411,1658,3069,37.493938,126.844055
구로구,1943, 온수역 북측,201901,50,40,90,37.49279,126.824524
구로구,1943, 온수역 북측,201902,45,54,99,37.49279,126.824524
구로구,1943, 온수역 북측,201903,107,90,197,37.49279,126.824524
구로구,1943, 온수역 북측,201904,216,249,465,37.49279,126.824524
구로구,1943, 온수역 북측,201905,369,390,759,37.49279,126.824524
구로구,1943, 온수역 북측,201906,457,475,932,37.49279,126.824524
구로구,1943, 온수역 북측,201907,354,387,741,37.49279,126.824524
구로구,1943, 온수역 북측,201908,359,402,761,37.49279,126.824524
구로구,1943, 온수역 북측,201909,387,385,772,37.49279,126.824524
구로구,1943, 온수역 북측,201910,468,448,916,37.49279,126.824524
구로구,1943, 온수역 북측,201911,259,326,585,37.49279,126.824524
구로구,1943, 온수역 북측,201912,114,101,215,37.49279,126.824524
구로구,1943, 온수역 북측,202001,135,158,293,37.49279,126.824524
구로구,1943, 온수역 북측,202002,147,161,308,37.49279,126.824524
구로구,1943, 온수역 북측,202003,297,301,598,37.49279,126.824524
구로구,1943, 온수역 북측,202004,476,483,959,37.49279,126.824524
구로구,1943, 온수역 북측,202005,617,648,1265,37.49279,126.824524
구로구,1943, 온수역 북측,202006,554,567,1121,37.49279,126.824524
구로구,1946, 구로역 광장,201901,359,399,758,37.503117,126.880386
구로구,1946, 구로역 광장,201902,364,362,726,37.503117,126.880386
구로구,1946, 구로역 광장,201903,659,684,1343,37.503117,126.880386
구로구,1946, 구로역 광장,201904,960,914,1874,37.503117,126.880386
구로구,1946, 구로역 광장,201905,1354,1298,2652,37.503117,126.880386
구로구,1946, 구로역 광장,201906,1661,1583,3244,37.503117,126.880386
구로구,1946, 구로역 광장,201907,1757,1669,3426,37.503117,126.880386
구로구,1946, 구로역 광장,201908,1502,1410,2912,37.503117,126.880386
구로구,1946, 구로역 광장,201909,1486,1479,2965,37.503117,126.880386
구로구,1946, 구로역 광장,201910,2257,2240,4497,37.503117,126.880386
구로구,1946, 구로역 광장,201911,1400,1414,2814,37.503117,126.880386
구로구,1946, 구로역 광장,201912,767,763,1530,37.503117,126.880386
구로구,1946, 구로역 광장,202001,671,671,1342,37.503117,126.880386
구로구,1946, 구로역 광장,202002,661,670,1331,37.503117,126.880386
구로구,1946, 구로역 광장,202003,1068,1056,2124,37.503117,126.880386
구로구,1946, 구로역 광장,202004,1610,1583,3193,37.503117,126.880386
구로구,1946, 구로역 광장,202005,1774,1772,3546,37.503117,126.880386
구로구,1946, 구로역 광장,202006,2247,2274,4521,37.503117,126.880386
구로구,1951, 천왕이펜하우스 4단지 상가 앞,201901,89,48,137,37.480289,126.8395
구로구,1951, 천왕이펜하우스 4단지 상가 앞,201902,83,53,136,37.480289,126.8395
구로구,1951, 천왕이펜하우스 4단지 상가 앞,201903,179,123,302,37.480289,126.8395
구로구,1951, 천왕이펜하우스 4단지 상가 앞,201904,275,199,474,37.480289,126.8395
구로구,1951, 천왕이펜하우스 4단지 상가 앞,201905,445,323,768,37.480289,126.8395
구로구,1951, 천왕이펜하우스 4단지 상가 앞,201906,567,442,1009,37.480289,126.8395
구로구,1951, 천왕이펜하우스 4단지 상가 앞,201907,523,324,847,37.480289,126.8395
구로구,1951, 천왕이펜하우스 4단지 상가 앞,201908,435,257,692,37.480289,126.8395
구로구,1951, 천왕이펜하우스 4단지 상가 앞,201909,380,280,660,37.480289,126.8395
구로구,1951, 천왕이펜하우스 4단지 상가 앞,201910,475,336,811,37.480289,126.8395
구로구,1951, 천왕이펜하우스 4단지 상가 앞,201911,261,204,465,37.480289,126.8395
구로구,1951, 천왕이펜하우스 4단지 상가 앞,201912,137,82,219,37.480289,126.8395
구로구,1951, 천왕이펜하우스 4단지 상가 앞,202001,142,115,257,37.480289,126.8395
구로구,1951, 천왕이펜하우스 4단지 상가 앞,202002,98,73,171,37.480289,126.8395
구로구,1951, 천왕이펜하우스 4단지 상가 앞,202003,264,227,491,37.480289,126.8395
구로구,1951, 천왕이펜하우스 4단지 상가 앞,202004,469,403,872,37.480289,126.8395
구로구,1951, 천왕이펜하우스 4단지 상가 앞,202005,567,497,1064,37.480289,126.8395
구로구,1951, 천왕이펜하우스 4단지 상가 앞,202006,525,453,978,37.480289,126.8395
구로구,1952, 천왕연지타운2단지 앞,201901,146,281,427,37.482105,126.845726
구로구,1952, 천왕연지타운2단지 앞,201902,157,218,375,37.482105,126.845726
구로구,1952, 천왕연지타운2단지 앞,201903,376,449,825,37.482105,126.845726
구로구,1952, 천왕연지타운2단지 앞,201904,601,626,1227,37.482105,126.845726
구로구,1952, 천왕연지타운2단지 앞,201905,930,1103,2033,37.482105,126.845726
구로구,1952, 천왕연지타운2단지 앞,201906,963,1128,2091,37.482105,126.845726
구로구,1952, 천왕연지타운2단지 앞,201907,912,1050,1962,37.482105,126.845726
구로구,1952, 천왕연지타운2단지 앞,201908,866,1040,1906,37.482105,126.845726
구로구,1952, 천왕연지타운2단지 앞,201909,911,1001,1912,37.482105,126.845726
구로구,1952, 천왕연지타운2단지 앞,201910,1195,1286,2481,37.482105,126.845726
구로구,1952, 천왕연지타운2단지 앞,201911,682,745,1427,37.482105,126.845726
구로구,1952, 천왕연지타운2단지 앞,201912,360,377,737,37.482105,126.845726
구로구,1952, 천왕연지타운2단지 앞,202001,378,431,809,37.482105,126.845726
구로구,1952, 천왕연지타운2단지 앞,202002,369,401,770,37.482105,126.845726
구로구,1952, 천왕연지타운2단지 앞,202003,932,950,1882,37.482105,126.845726
구로구,1952, 천왕연지타운2단지 앞,202004,1635,1715,3350,37.482105,126.845726
구로구,1952, 천왕연지타운2단지 앞,202005,1696,1853,3549,37.482105,126.845726
구로구,1952, 천왕연지타운2단지 앞,202006,1772,2054,3826,37.482105,126.845726
구로구,1953, 천왕역 4번출구 뒤,201901,163,116,279,37.486385,126.839211
구로구,1953, 천왕역 4번출구 뒤,201902,165,96,261,37.486385,126.839211
구로구,1953, 천왕역 4번출구 뒤,201903,285,202,487,37.486385,126.839211
구로구,1953, 천왕역 4번출구 뒤,201904,361,292,653,37.486385,126.839211
구로구,1953, 천왕역 4번출구 뒤,201905,608,501,1109,37.486385,126.839211
구로구,1953, 천왕역 4번출구 뒤,201906,671,538,1209,37.486385,126.839211
구로구,1953, 천왕역 4번출구 뒤,201907,560,489,1049,37.486385,126.839211
구로구,1953, 천왕역 4번출구 뒤,201908,538,501,1039,37.486385,126.839211
구로구,1953, 천왕역 4번출구 뒤,201909,558,507,1065,37.486385,126.839211
구로구,1953, 천왕역 4번출구 뒤,201910,760,685,1445,37.486385,126.839211
구로구,1953, 천왕역 4번출구 뒤,201911,426,352,778,37.486385,126.839211
구로구,1953, 천왕역 4번출구 뒤,201912,261,204,465,37.486385,126.839211
구로구,1953, 천왕역 4번출구 뒤,202001,245,182,427,37.486385,126.839211
구로구,1953, 천왕역 4번출구 뒤,202002,199,169,368,37.486385,126.839211
구로구,1953, 천왕역 4번출구 뒤,202003,399,364,763,37.486385,126.839211
구로구,1953, 천왕역 4번출구 뒤,202004,898,796,1694,37.486385,126.839211
구로구,1953, 천왕역 4번출구 뒤,202005,930,856,1786,37.486385,126.839211
구로구,1953, 천왕역 4번출구 뒤,202006,1084,911,1995,37.486385,126.839211
구로구,1955, 디지털입구 교차로,201901,640,656,1296,37.482883,126.901039
구로구,1955, 디지털입구 교차로,201902,562,521,1083,37.482883,126.901039
구로구,1955, 디지털입구 교차로,201903,1036,1090,2126,37.482883,126.901039
구로구,1955, 디지털입구 교차로,201904,1617,1625,3242,37.482883,126.901039
구로구,1955, 디지털입구 교차로,201905,2458,2421,4879,37.482883,126.901039
구로구,1955, 디지털입구 교차로,201906,2781,2761,5542,37.482883,126.901039
구로구,1955, 디지털입구 교차로,201907,2730,2722,5452,37.482883,126.901039
구로구,1955, 디지털입구 교차로,201908,2604,2595,5199,37.482883,126.901039
구로구,1955, 디지털입구 교차로,201909,2177,2154,4331,37.482883,126.901039
구로구,1955, 디지털입구 교차로,201910,2532,2528,5060,37.482883,126.901039
구로구,1955, 디지털입구 교차로,201911,1781,1757,3538,37.482883,126.901039
구로구,1955, 디지털입구 교차로,201912,1107,1106,2213,37.482883,126.901039
구로구,1955, 디지털입구 교차로,202001,997,1007,2004,37.482883,126.901039
구로구,1955, 디지털입구 교차로,202002,853,855,1708,37.482883,126.901039
구로구,1955, 디지털입구 교차로,202003,1279,1270,2549,37.482883,126.901039
구로구,1955, 디지털입구 교차로,202004,1855,1845,3700,37.482883,126.901039
구로구,1955, 디지털입구 교차로,202005,2250,2249,4499,37.482883,126.901039
구로구,1955, 디지털입구 교차로,202006,3123,3128,6251,37.482883,126.901039
구로구,1956, 도야미리숯불갈비 앞,201901,138,183,321,37.51001,126.88205
구로구,1956, 도야미리숯불갈비 앞,201902,137,142,279,37.51001,126.88205
구로구,1956, 도야미리숯불갈비 앞,201903,261,320,581,37.51001,126.88205
구로구,1956, 도야미리숯불갈비 앞,201904,413,487,900,37.51001,126.88205
구로구,1956, 도야미리숯불갈비 앞,201905,734,864,1598,37.51001,126.88205
구로구,1956, 도야미리숯불갈비 앞,201906,989,996,1985,37.51001,126.88205
구로구,1956, 도야미리숯불갈비 앞,201907,1109,1140,2249,37.51001,126.88205
구로구,1956, 도야미리숯불갈비 앞,201908,1048,1095,2143,37.51001,126.88205
구로구,1956, 도야미리숯불갈비 앞,201909,1003,1026,2029,37.51001,126.88205
구로구,1956, 도야미리숯불갈비 앞,201910,1168,1216,2384,37.51001,126.88205
구로구,1956, 도야미리숯불갈비 앞,201911,794,817,1611,37.51001,126.88205
구로구,1956, 도야미리숯불갈비 앞,201912,418,408,826,37.51001,126.88205
구로구,1956, 도야미리숯불갈비 앞,202001,457,472,929,37.51001,126.88205
구로구,1956, 도야미리숯불갈비 앞,202002,412,439,851,37.51001,126.88205
구로구,1956, 도야미리숯불갈비 앞,202003,614,631,1245,37.51001,126.88205
구로구,1956, 도야미리숯불갈비 앞,202004,911,930,1841,37.51001,126.88205
구로구,1956, 도야미리숯불갈비 앞,202005,1011,1004,2015,37.51001,126.88205
구로구,1956, 도야미리숯불갈비 앞,202006,1231,1243,2474,37.51001,126.88205
구로구,1957, 구일고등학교 정문,201901,273,280,553,37.493401,126.874329
구로구,1957, 구일고등학교 정문,201902,254,263,517,37.493401,126.874329
구로구,1957, 구일고등학교 정문,201903,509,495,1004,37.493401,126.874329
구로구,1957, 구일고등학교 정문,201904,670,693,1363,37.493401,126.874329
구로구,1957, 구일고등학교 정문,201905,1059,1046,2105,37.493401,126.874329
구로구,1957, 구일고등학교 정문,201906,1094,1163,2257,37.493401,126.874329
구로구,1957, 구일고등학교 정문,201907,1093,1197,2290,37.493401,126.874329
구로구,1957, 구일고등학교 정문,201908,1066,1177,2243,37.493401,126.874329
구로구,1957, 구일고등학교 정문,201909,1079,1122,2201,37.493401,126.874329
구로구,1957, 구일고등학교 정문,201910,1341,1394,2735,37.493401,126.874329
구로구,1957, 구일고등학교 정문,201911,951,993,1944,37.493401,126.874329
구로구,1957, 구일고등학교 정문,201912,583,603,1186,37.493401,126.874329
구로구,1957, 구일고등학교 정문,202001,479,515,994,37.493401,126.874329
구로구,1957, 구일고등학교 정문,202002,500,501,1001,37.493401,126.874329
구로구,1957, 구일고등학교 정문,202003,676,697,1373,37.493401,126.874329
구로구,1957, 구일고등학교 정문,202004,1064,1086,2150,37.493401,126.874329
구로구,1957, 구일고등학교 정문,202005,1242,1276,2518,37.493401,126.874329
구로구,1957, 구일고등학교 정문,202006,1525,1576,3101,37.493401,126.874329
구로구,1958, 강서수도사업소민원센터,201901,199,253,452,37.495781,126.890121
구로구,1958, 강서수도사업소민원센터,201902,217,290,507,37.495781,126.890121
구로구,1958, 강서수도사업소민원센터,201903,338,380,718,37.495781,126.890121
구로구,1958, 강서수도사업소민원센터,201904,552,622,1174,37.495781,126.890121
구로구,1958, 강서수도사업소민원센터,201905,1050,1057,2107,37.495781,126.890121
구로구,1958, 강서수도사업소민원센터,201906,1237,1271,2508,37.495781,126.890121
구로구,1958, 강서수도사업소민원센터,201907,1242,1293,2535,37.495781,126.890121
구로구,1958, 강서수도사업소민원센터,201908,1175,1269,2444,37.495781,126.890121
구로구,1958, 강서수도사업소민원센터,201909,1126,1141,2267,37.495781,126.890121
구로구,1958, 강서수도사업소민원센터,201910,1329,1321,2650,37.495781,126.890121
구로구,1958, 강서수도사업소민원센터,201911,754,793,1547,37.495781,126.890121
구로구,1958, 강서수도사업소민원센터,201912,460,486,946,37.495781,126.890121
구로구,1958, 강서수도사업소민원센터,202001,452,462,914,37.495781,126.890121
구로구,1958, 강서수도사업소민원센터,202002,414,423,837,37.495781,126.890121
구로구,1958, 강서수도사업소민원센터,202003,673,652,1325,37.495781,126.890121
구로구,1958, 강서수도사업소민원센터,202004,1098,1084,2182,37.495781,126.890121
구로구,1958, 강서수도사업소민원센터,202005,1365,1335,2700,37.495781,126.890121
구로구,1958, 강서수도사업소민원센터,202006,1585,1606,3191,37.495781,126.890121
구로구,1959, 구로구의회 앞,201901,259,262,521,37.496456,126.889587
구로구,1959, 구로구의회 앞,201902,206,198,404,37.496456,126.889587
구로구,1959, 구로구의회 앞,201903,349,416,765,37.496456,126.889587
구로구,1959, 구로구의회 앞,201904,452,464,916,37.496456,126.889587
구로구,1959, 구로구의회 앞,201905,797,743,1540,37.496456,126.889587
구로구,1959, 구로구의회 앞,201906,1121,1103,2224,37.496456,126.889587
구로구,1959, 구로구의회 앞,201907,1168,1200,2368,37.496456,126.889587
구로구,1959, 구로구의회 앞,201908,1000,1036,2036,37.496456,126.889587
구로구,1959, 구로구의회 앞,201909,963,1013,1976,37.496456,126.889587
구로구,1959, 구로구의회 앞,201910,1234,1255,2489,37.496456,126.889587
구로구,1959, 구로구의회 앞,201911,891,916,1807,37.496456,126.889587
구로구,1959, 구로구의회 앞,201912,500,534,1034,37.496456,126.889587
구로구,1959, 구로구의회 앞,202001,335,353,688,37.496456,126.889587
구로구,1959, 구로구의회 앞,202002,299,301,600,37.496456,126.889587
구로구,1959, 구로구의회 앞,202003,508,519,1027,37.496456,126.889587
구로구,1959, 구로구의회 앞,202004,749,773,1522,37.496456,126.889587
구로구,1959, 구로구의회 앞,202005,983,1035,2018,37.496456,126.889587
구로구,1959, 구로구의회 앞,202006,1123,1132,2255,37.496456,126.889587
구로구,1960, 화광신문사 앞,201901,328,348,676,37.50285,126.889481
구로구,1960, 화광신문사 앞,201902,281,316,597,37.50285,126.889481
구로구,1960, 화광신문사 앞,201903,560,538,1098,37.50285,126.889481
구로구,1960, 화광신문사 앞,201904,905,852,1757,37.50285,126.889481
구로구,1960, 화광신문사 앞,201905,1545,1452,2997,37.50285,126.889481
구로구,1960, 화광신문사 앞,201906,1783,1604,3387,37.50285,126.889481
구로구,1960, 화광신문사 앞,201907,1960,1834,3794,37.50285,126.889481
구로구,1960, 화광신문사 앞,201908,2127,1905,4032,37.50285,126.889481
구로구,1960, 화광신문사 앞,201909,2061,1729,3790,37.50285,126.889481
구로구,1960, 화광신문사 앞,201910,2528,2183,4711,37.50285,126.889481
구로구,1960, 화광신문사 앞,201911,1650,1448,3098,37.50285,126.889481
구로구,1960, 화광신문사 앞,201912,866,800,1666,37.50285,126.889481
구로구,1960, 화광신문사 앞,202001,805,746,1551,37.50285,126.889481
구로구,1960, 화광신문사 앞,202002,786,781,1567,37.50285,126.889481
구로구,1960, 화광신문사 앞,202003,1239,1236,2475,37.50285,126.889481
구로구,1960, 화광신문사 앞,202004,1876,1826,3702,37.50285,126.889481
구로구,1960, 화광신문사 앞,202005,2045,2023,4068,37.50285,126.889481
구로구,1960, 화광신문사 앞,202006,2639,2554,5193,37.50285,126.889481
구로구,1961, 신도림테크노근린공원,201901,794,776,1570,37.508194,126.891304
구로구,1961, 신도림테크노근린공원,201902,781,760,1541,37.508194,126.891304
구로구,1961, 신도림테크노근린공원,201903,1432,1442,2874,37.508194,126.891304
구로구,1961, 신도림테크노근린공원,201904,2373,2402,4775,37.508194,126.891304
구로구,1961, 신도림테크노근린공원,201905,3739,3800,7539,37.508194,126.891304
구로구,1961, 신도림테크노근린공원,201906,4387,4389,8776,37.508194,126.891304
구로구,1961, 신도림테크노근린공원,201907,4057,4113,8170,37.508194,126.891304
구로구,1961, 신도림테크노근린공원,201908,4018,4082,8100,37.508194,126.891304
구로구,1961, 신도림테크노근린공원,201909,3681,3697,7378,37.508194,126.891304
구로구,1961, 신도림테크노근린공원,201910,4403,4437,8840,37.508194,126.891304
구로구,1961, 신도림테크노근린공원,201911,2745,2776,5521,37.508194,126.891304
구로구,1961, 신도림테크노근린공원,201912,1600,1616,3216,37.508194,126.891304
구로구,1961, 신도림테크노근린공원,202001,1387,1397,2784,37.508194,126.891304
구로구,1961, 신도림테크노근린공원,202002,1412,1410,2822,37.508194,126.891304
구로구,1961, 신도림테크노근린공원,202003,2314,2314,4628,37.508194,126.891304
구로구,1961, 신도림테크노근린공원,202004,3730,3725,7455,37.508194,126.891304
구로구,1961, 신도림테크노근린공원,202005,4136,4119,8255,37.508194,126.891304
구로구,1961, 신도림테크노근린공원,202006,4751,4777,9528,37.508194,126.891304
구로구,1962, 가리봉동주민센터,201901,410,391,801,37.481602,126.892799
구로구,1962, 가리봉동주민센터,201902,349,317,666,37.481602,126.892799
구로구,1962, 가리봉동주민센터,201903,492,487,979,37.481602,126.892799
구로구,1962, 가리봉동주민센터,201904,712,706,1418,37.481602,126.892799
구로구,1962, 가리봉동주민센터,201905,1114,1103,2217,37.481602,126.892799
구로구,1962, 가리봉동주민센터,201906,1036,1037,2073,37.481602,126.892799
구로구,1962, 가리봉동주민센터,201907,1106,1157,2263,37.481602,126.892799
구로구,1962, 가리봉동주민센터,201908,1100,1014,2114,37.481602,126.892799
구로구,1962, 가리봉동주민센터,201909,994,944,1938,37.481602,126.892799
구로구,1962, 가리봉동주민센터,201910,1230,1205,2435,37.481602,126.892799
구로구,1962, 가리봉동주민센터,201911,848,854,1702,37.481602,126.892799
구로구,1962, 가리봉동주민센터,201912,573,571,1144,37.481602,126.892799
구로구,1962, 가리봉동주민센터,202001,529,528,1057,37.481602,126.892799
구로구,1962, 가리봉동주민센터,202002,404,410,814,37.481602,126.892799
구로구,1962, 가리봉동주민센터,202003,550,533,1083,37.481602,126.892799
구로구,1962, 가리봉동주민센터,202004,748,733,1481,37.481602,126.892799
구로구,1962, 가리봉동주민센터,202005,851,857,1708,37.481602,126.892799
구로구,1962, 가리봉동주민센터,202006,1351,1366,2717,37.481602,126.892799
구로구,1964, 원메디타운 앞,201901,223,186,409,37.49789,126.864502
구로구,1964, 원메디타운 앞,201902,190,172,362,37.49789,126.864502
구로구,1964, 원메디타운 앞,201903,375,316,691,37.49789,126.864502
구로구,1964, 원메디타운 앞,201904,546,510,1056,37.49789,126.864502
구로구,1964, 원메디타운 앞,201905,818,791,1609,37.49789,126.864502
구로구,1964, 원메디타운 앞,201906,1023,1015,2038,37.49789,126.864502
구로구,1964, 원메디타운 앞,201907,935,903,1838,37.49789,126.864502
구로구,1964, 원메디타운 앞,201908,450,440,890,37.49789,126.864502
구로구,1964, 원메디타운 앞,201909,853,827,1680,37.49789,126.864502
구로구,1964, 원메디타운 앞,201910,808,855,1663,37.49789,126.864502
구로구,1964, 원메디타운 앞,201911,576,553,1129,37.49789,126.864502
구로구,1964, 원메디타운 앞,201912,443,429,872,37.49789,126.864502
구로구,1964, 원메디타운 앞,202001,384,385,769,37.49789,126.864502
구로구,1964, 원메디타운 앞,202002,346,347,693,37.49789,126.864502
구로구,1964, 원메디타운 앞,202003,592,570,1162,37.49789,126.864502
구로구,1964, 원메디타운 앞,202004,1040,1021,2061,37.49789,126.864502
구로구,1964, 원메디타운 앞,202005,1184,1174,2358,37.49789,126.864502
구로구,1964, 원메디타운 앞,202006,1446,1482,2928,37.49789,126.864502
구로구,1965, 삼환로즈빌아파트 105동 옆,201901,131,122,253,37.497231,126.859192
구로구,1965, 삼환로즈빌아파트 105동 옆,201902,117,100,217,37.497231,126.859192
구로구,1965, 삼환로즈빌아파트 105동 옆,201903,251,241,492,37.497231,126.859192
구로구,1965, 삼환로즈빌아파트 105동 옆,201904,426,340,766,37.497231,126.859192
구로구,1965, 삼환로즈빌아파트 105동 옆,201905,689,639,1328,37.497231,126.859192
구로구,1965, 삼환로즈빌아파트 105동 옆,201906,781,792,1573,37.497231,126.859192
구로구,1965, 삼환로즈빌아파트 105동 옆,201907,733,732,1465,37.497231,126.859192
구로구,1965, 삼환로즈빌아파트 105동 옆,201908,736,720,1456,37.497231,126.859192
구로구,1965, 삼환로즈빌아파트 105동 옆,201909,717,654,1371,37.497231,126.859192
구로구,1965, 삼환로즈빌아파트 105동 옆,201910,841,752,1593,37.497231,126.859192
구로구,1965, 삼환로즈빌아파트 105동 옆,201911,582,503,1085,37.497231,126.859192
구로구,1965, 삼환로즈빌아파트 105동 옆,201912,294,227,521,37.497231,126.859192
구로구,1965, 삼환로즈빌아파트 105동 옆,202001,244,192,436,37.497231,126.859192
구로구,1965, 삼환로즈빌아파트 105동 옆,202002,254,209,463,37.497231,126.859192
구로구,1965, 삼환로즈빌아파트 105동 옆,202003,406,341,747,37.497231,126.859192
구로구,1965, 삼환로즈빌아파트 105동 옆,202004,676,593,1269,37.497231,126.859192
구로구,1965, 삼환로즈빌아파트 105동 옆,202005,833,784,1617,37.497231,126.859192
구로구,1965, 삼환로즈빌아파트 105동 옆,202006,1072,949,2021,37.497231,126.859192
구로구,1966, 한마을아파트 정문상가,201901,196,219,415,37.496498,126.863098
구로구,1966, 한마을아파트 정문상가,201902,188,174,362,37.496498,126.863098
구로구,1966, 한마을아파트 정문상가,201903,380,333,713,37.496498,126.863098
구로구,1966, 한마을아파트 정문상가,201904,572,562,1134,37.496498,126.863098
구로구,1966, 한마을아파트 정문상가,201905,870,857,1727,37.496498,126.863098
구로구,1966, 한마을아파트 정문상가,201906,1046,1110,2156,37.496498,126.863098
구로구,1966, 한마을아파트 정문상가,201907,1024,1029,2053,37.496498,126.863098
구로구,1966, 한마을아파트 정문상가,201908,1170,1236,2406,37.496498,126.863098
구로구,1966, 한마을아파트 정문상가,201909,1021,1033,2054,37.496498,126.863098
구로구,1966, 한마을아파트 정문상가,201910,1299,1344,2643,37.496498,126.863098
구로구,1966, 한마을아파트 정문상가,201911,828,815,1643,37.496498,126.863098
구로구,1966, 한마을아파트 정문상가,201912,455,443,898,37.496498,126.863098
구로구,1966, 한마을아파트 정문상가,202001,367,352,719,37.496498,126.863098
구로구,1966, 한마을아파트 정문상가,202002,373,373,746,37.496498,126.863098
구로구,1966, 한마을아파트 정문상가,202003,802,805,1607,37.496498,126.863098
구로구,1966, 한마을아파트 정문상가,202004,1081,1068,2149,37.496498,126.863098
구로구,1966, 한마을아파트 정문상가,202005,1366,1318,2684,37.496498,126.863098
구로구,1966, 한마을아파트 정문상가,202006,1545,1527,3072,37.496498,126.863098
구로구,1967, 참새공원(백곡경노당),201901,41,35,76,37.505138,126.844337
구로구,1967, 참새공원(백곡경노당),201902,51,48,99,37.505138,126.844337
구로구,1967, 참새공원(백곡경노당),201903,66,73,139,37.505138,126.844337
구로구,1967, 참새공원(백곡경노당),201904,128,134,262,37.505138,126.844337
구로구,1967, 참새공원(백곡경노당),201905,203,211,414,37.505138,126.844337
구로구,1967, 참새공원(백곡경노당),201906,212,217,429,37.505138,126.844337
구로구,1967, 참새공원(백곡경노당),201907,249,284,533,37.505138,126.844337
구로구,1967, 참새공원(백곡경노당),201908,251,263,514,37.505138,126.844337
구로구,1967, 참새공원(백곡경노당),201909,260,255,515,37.505138,126.844337
구로구,1967, 참새공원(백곡경노당),201910,266,272,538,37.505138,126.844337
구로구,1967, 참새공원(백곡경노당),201911,202,181,383,37.505138,126.844337
구로구,1967, 참새공원(백곡경노당),201912,120,102,222,37.505138,126.844337
구로구,1967, 참새공원(백곡경노당),202001,96,77,173,37.505138,126.844337
구로구,1967, 참새공원(백곡경노당),202002,105,89,194,37.505138,126.844337
구로구,1967, 참새공원(백곡경노당),202003,180,170,350,37.505138,126.844337
구로구,1967, 참새공원(백곡경노당),202004,225,234,459,37.505138,126.844337
구로구,1967, 참새공원(백곡경노당),202005,297,280,577,37.505138,126.844337
구로구,1967, 참새공원(백곡경노당),202006,354,346,700,37.505138,126.844337
구로구,1968, 동인오피스텔 건너편 소공원,201901,51,69,120,37.498482,126.847504
구로구,1968, 동인오피스텔 건너편 소공원,201902,53,75,128,37.498482,126.847504
구로구,1968, 동인오피스텔 건너편 소공원,201903,124,128,252,37.498482,126.847504
구로구,1968, 동인오피스텔 건너편 소공원,201904,189,193,382,37.498482,126.847504
구로구,1968, 동인오피스텔 건너편 소공원,201905,346,332,678,37.498482,126.847504
구로구,1968, 동인오피스텔 건너편 소공원,201906,367,345,712,37.498482,126.847504
구로구,1968, 동인오피스텔 건너편 소공원,201907,361,388,749,37.498482,126.847504
구로구,1968, 동인오피스텔 건너편 소공원,201908,397,410,807,37.498482,126.847504
구로구,1968, 동인오피스텔 건너편 소공원,201909,301,337,638,37.498482,126.847504
구로구,1968, 동인오피스텔 건너편 소공원,201910,375,392,767,37.498482,126.847504
구로구,1968, 동인오피스텔 건너편 소공원,201911,282,303,585,37.498482,126.847504
구로구,1968, 동인오피스텔 건너편 소공원,201912,158,160,318,37.498482,126.847504
구로구,1968, 동인오피스텔 건너편 소공원,202001,163,171,334,37.498482,126.847504
구로구,1968, 동인오피스텔 건너편 소공원,202002,134,127,261,37.498482,126.847504
구로구,1968, 동인오피스텔 건너편 소공원,202003,238,240,478,37.498482,126.847504
구로구,1968, 동인오피스텔 건너편 소공원,202004,361,363,724,37.498482,126.847504
구로구,1968, 동인오피스텔 건너편 소공원,202005,372,410,782,37.498482,126.847504
구로구,1968, 동인오피스텔 건너편 소공원,202006,460,498,958,37.498482,126.847504
구로구,1969, 궁동생태공원,201901,17,16,33,37.501904,126.828964
구로구,1969, 궁동생태공원,201902,35,33,68,37.501904,126.828964
구로구,1969, 궁동생태공원,201903,53,51,104,37.501904,126.828964
구로구,1969, 궁동생태공원,201904,59,58,117,37.501904,126.828964
구로구,1969, 궁동생태공원,201905,188,147,335,37.501904,126.828964
구로구,1969, 궁동생태공원,201906,271,231,502,37.501904,126.828964
구로구,1969, 궁동생태공원,201907,137,134,271,37.501904,126.828964
구로구,1969, 궁동생태공원,201908,154,147,301,37.501904,126.828964
구로구,1969, 궁동생태공원,201909,152,127,279,37.501904,126.828964
구로구,1969, 궁동생태공원,201910,157,142,299,37.501904,126.828964
구로구,1969, 궁동생태공원,201911,79,82,161,37.501904,126.828964
구로구,1969, 궁동생태공원,201912,30,47,77,37.501904,126.828964
구로구,1969, 궁동생태공원,202001,37,47,84,37.501904,126.828964
구로구,1969, 궁동생태공원,202002,40,66,106,37.501904,126.828964
구로구,1969, 궁동생태공원,202003,115,128,243,37.501904,126.828964
구로구,1969, 궁동생태공원,202004,223,230,453,37.501904,126.828964
구로구,1969, 궁동생태공원,202005,241,244,485,37.501904,126.828964
구로구,1969, 궁동생태공원,202006,328,301,629,37.501904,126.828964
구로구,1971, 오정초교 앞 보도육교,201901,17,45,62,37.490723,126.826393
구로구,1971, 오정초교 앞 보도육교,201902,39,41,80,37.490723,126.826393
구로구,1971, 오정초교 앞 보도육교,201903,108,82,190,37.490723,126.826393
구로구,1971, 오정초교 앞 보도육교,201904,120,144,264,37.490723,126.826393
구로구,1971, 오정초교 앞 보도육교,201905,258,280,538,37.490723,126.826393
구로구,1971, 오정초교 앞 보도육교,201906,291,343,634,37.490723,126.826393
구로구,1971, 오정초교 앞 보도육교,201907,250,296,546,37.490723,126.826393
구로구,1971, 오정초교 앞 보도육교,201908,259,259,518,37.490723,126.826393
구로구,1971, 오정초교 앞 보도육교,201909,290,275,565,37.490723,126.826393
구로구,1971, 오정초교 앞 보도육교,201910,402,419,821,37.490723,126.826393
구로구,1971, 오정초교 앞 보도육교,201911,277,289,566,37.490723,126.826393
구로구,1971, 오정초교 앞 보도육교,201912,105,138,243,37.490723,126.826393
구로구,1971, 오정초교 앞 보도육교,202001,102,110,212,37.490723,126.826393
구로구,1971, 오정초교 앞 보도육교,202002,97,130,227,37.490723,126.826393
구로구,1971, 오정초교 앞 보도육교,202003,235,306,541,37.490723,126.826393
구로구,1971, 오정초교 앞 보도육교,202004,396,433,829,37.490723,126.826393
구로구,1971, 오정초교 앞 보도육교,202005,508,531,1039,37.490723,126.826393
구로구,1971, 오정초교 앞 보도육교,202006,517,559,1076,37.490723,126.826393
구로구,1973, 오리로와 서해안도로 교차로 앞,201901,60,17,77,37.488598,126.836494
구로구,1973, 오리로와 서해안도로 교차로 앞,201902,62,19,81,37.488598,126.836494
구로구,1973, 오리로와 서해안도로 교차로 앞,201903,90,65,155,37.488598,126.836494
구로구,1973, 오리로와 서해안도로 교차로 앞,201904,197,151,348,37.488598,126.836494
구로구,1973, 오리로와 서해안도로 교차로 앞,201905,235,195,430,37.488598,126.836494
구로구,1973, 오리로와 서해안도로 교차로 앞,201906,259,234,493,37.488598,126.836494
구로구,1973, 오리로와 서해안도로 교차로 앞,201907,306,272,578,37.488598,126.836494
구로구,1973, 오리로와 서해안도로 교차로 앞,201908,284,308,592,37.488598,126.836494
구로구,1973, 오리로와 서해안도로 교차로 앞,201909,248,215,463,37.488598,126.836494
구로구,1973, 오리로와 서해안도로 교차로 앞,201910,324,290,614,37.488598,126.836494
구로구,1973, 오리로와 서해안도로 교차로 앞,201911,264,228,492,37.488598,126.836494
구로구,1973, 오리로와 서해안도로 교차로 앞,201912,137,134,271,37.488598,126.836494
구로구,1973, 오리로와 서해안도로 교차로 앞,202001,119,104,223,37.488598,126.836494
구로구,1973, 오리로와 서해안도로 교차로 앞,202002,142,102,244,37.488598,126.836494
구로구,1973, 오리로와 서해안도로 교차로 앞,202003,248,229,477,37.488598,126.836494
구로구,1973, 오리로와 서해안도로 교차로 앞,202004,372,315,687,37.488598,126.836494
구로구,1973, 오리로와 서해안도로 교차로 앞,202005,469,431,900,37.488598,126.836494
구로구,1973, 오리로와 서해안도로 교차로 앞,202006,513,439,952,37.488598,126.836494
구로구,1974, 신도림2차e편한세상아파트 203동 앞,201901,301,279,580,37.50518,126.882538
구로구,1974, 신도림2차e편한세상아파트 203동 앞,201902,284,258,542,37.50518,126.882538
구로구,1974, 신도림2차e편한세상아파트 203동 앞,201903,486,475,961,37.50518,126.882538
구로구,1974, 신도림2차e편한세상아파트 203동 앞,201904,794,724,1518,37.50518,126.882538
구로구,1974, 신도림2차e편한세상아파트 203동 앞,201905,1223,1151,2374,37.50518,126.882538
구로구,1974, 신도림2차e편한세상아파트 203동 앞,201906,1393,1329,2722,37.50518,126.882538
구로구,1974, 신도림2차e편한세상아파트 203동 앞,201907,1332,1179,2511,37.50518,126.882538
구로구,1974, 신도림2차e편한세상아파트 203동 앞,201908,1273,1097,2370,37.50518,126.882538
구로구,1974, 신도림2차e편한세상아파트 203동 앞,201909,906,854,1760,37.50518,126.882538
구로구,1974, 신도림2차e편한세상아파트 203동 앞,201910,87,91,178,37.50518,126.882538
구로구,1974, 신도림2차e편한세상아파트 203동 앞,201911,675,621,1296,37.50518,126.882538
구로구,1974, 신도림2차e편한세상아파트 203동 앞,201912,499,481,980,37.50518,126.882538
구로구,1974, 신도림2차e편한세상아파트 203동 앞,202001,474,462,936,37.50518,126.882538
구로구,1974, 신도림2차e편한세상아파트 203동 앞,202002,376,356,732,37.50518,126.882538
구로구,1974, 신도림2차e편한세상아파트 203동 앞,202003,597,574,1171,37.50518,126.882538
구로구,1974, 신도림2차e편한세상아파트 203동 앞,202004,938,911,1849,37.50518,126.882538
구로구,1974, 신도림2차e편한세상아파트 203동 앞,202005,1006,973,1979,37.50518,126.882538
구로구,1974, 신도림2차e편한세상아파트 203동 앞,202006,1433,1380,2813,37.50518,126.882538
구로구,1975, 대림역 1번 출입구 밑,201901,285,227,512,37.49258,126.894737
구로구,1975, 대림역 1번 출입구 밑,201902,227,176,403,37.49258,126.894737
구로구,1975, 대림역 1번 출입구 밑,201903,639,589,1228,37.49258,126.894737
구로구,1975, 대림역 1번 출입구 밑,201904,808,700,1508,37.49258,126.894737
구로구,1975, 대림역 1번 출입구 밑,201905,1127,1063,2190,37.49258,126.894737
구로구,1975, 대림역 1번 출입구 밑,201906,1241,1182,2423,37.49258,126.894737
구로구,1975, 대림역 1번 출입구 밑,201907,1238,1157,2395,37.49258,126.894737
구로구,1975, 대림역 1번 출입구 밑,201908,1213,1180,2393,37.49258,126.894737
구로구,1975, 대림역 1번 출입구 밑,201909,1104,1104,2208,37.49258,126.894737
구로구,1975, 대림역 1번 출입구 밑,201910,1310,1308,2618,37.49258,126.894737
구로구,1975, 대림역 1번 출입구 밑,201911,906,869,1775,37.49258,126.894737
구로구,1975, 대림역 1번 출입구 밑,201912,531,542,1073,37.49258,126.894737
구로구,1975, 대림역 1번 출입구 밑,202001,418,407,825,37.49258,126.894737
구로구,1975, 대림역 1번 출입구 밑,202002,373,369,742,37.49258,126.894737
구로구,1975, 대림역 1번 출입구 밑,202003,609,607,1216,37.49258,126.894737
구로구,1975, 대림역 1번 출입구 밑,202004,982,981,1963,37.49258,126.894737
구로구,1975, 대림역 1번 출입구 밑,202005,1190,1193,2383,37.49258,126.894737
구로구,1975, 대림역 1번 출입구 밑,202006,1355,1351,2706,37.49258,126.894737
구로구,1976, 남구로역 5번 출입구 앞,201901,215,139,354,37.48568,126.886703
구로구,1976, 남구로역 5번 출입구 앞,201902,222,139,361,37.48568,126.886703
구로구,1976, 남구로역 5번 출입구 앞,201903,273,200,473,37.48568,126.886703
구로구,1976, 남구로역 5번 출입구 앞,201904,302,224,526,37.48568,126.886703
구로구,1976, 남구로역 5번 출입구 앞,201905,410,332,742,37.48568,126.886703
구로구,1976, 남구로역 5번 출입구 앞,201906,546,485,1031,37.48568,126.886703
구로구,1976, 남구로역 5번 출입구 앞,201907,545,406,951,37.48568,126.886703
구로구,1976, 남구로역 5번 출입구 앞,201908,499,434,933,37.48568,126.886703
구로구,1976, 남구로역 5번 출입구 앞,201909,408,403,811,37.48568,126.886703
구로구,1976, 남구로역 5번 출입구 앞,201910,498,494,992,37.48568,126.886703
구로구,1976, 남구로역 5번 출입구 앞,201911,393,387,780,37.48568,126.886703
구로구,1976, 남구로역 5번 출입구 앞,201912,210,207,417,37.48568,126.886703
구로구,1976, 남구로역 5번 출입구 앞,202001,186,183,369,37.48568,126.886703
구로구,1976, 남구로역 5번 출입구 앞,202002,125,124,249,37.48568,126.886703
구로구,1976, 남구로역 5번 출입구 앞,202003,131,129,260,37.48568,126.886703
구로구,1976, 남구로역 5번 출입구 앞,202004,316,315,631,37.48568,126.886703
구로구,1976, 남구로역 5번 출입구 앞,202005,420,423,843,37.48568,126.886703
구로구,1976, 남구로역 5번 출입구 앞,202006,512,515,1027,37.48568,126.886703
구로구,1977, 천왕역 1번 출입구 앞,201901,183,161,344,37.48621,126.838821
구로구,1977, 천왕역 1번 출입구 앞,201902,207,159,366,37.48621,126.838821
구로구,1977, 천왕역 1번 출입구 앞,201903,324,305,629,37.48621,126.838821
구로구,1977, 천왕역 1번 출입구 앞,201904,481,473,954,37.48621,126.838821
구로구,1977, 천왕역 1번 출입구 앞,201905,784,717,1501,37.48621,126.838821
구로구,1977, 천왕역 1번 출입구 앞,201906,837,801,1638,37.48621,126.838821
구로구,1977, 천왕역 1번 출입구 앞,201907,787,777,1564,37.48621,126.838821
구로구,1977, 천왕역 1번 출입구 앞,201908,876,787,1663,37.48621,126.838821
구로구,1977, 천왕역 1번 출입구 앞,201909,766,716,1482,37.48621,126.838821
구로구,1977, 천왕역 1번 출입구 앞,201910,927,840,1767,37.48621,126.838821
구로구,1977, 천왕역 1번 출입구 앞,201911,617,532,1149,37.48621,126.838821
구로구,1977, 천왕역 1번 출입구 앞,201912,401,361,762,37.48621,126.838821
구로구,1977, 천왕역 1번 출입구 앞,202001,315,307,622,37.48621,126.838821
구로구,1977, 천왕역 1번 출입구 앞,202002,285,247,532,37.48621,126.838821
구로구,1977, 천왕역 1번 출입구 앞,202003,484,433,917,37.48621,126.838821
구로구,1977, 천왕역 1번 출입구 앞,202004,786,692,1478,37.48621,126.838821
구로구,1977, 천왕역 1번 출입구 앞,202005,888,802,1690,37.48621,126.838821
구로구,1977, 천왕역 1번 출입구 앞,202006,1214,1177,2391,37.48621,126.838821
구로구,1979, 구로1동우체국 앞,201901,82,72,154,37.492031,126.873772
구로구,1979, 구로1동우체국 앞,201902,90,77,167,37.492031,126.873772
구로구,1979, 구로1동우체국 앞,201903,146,105,251,37.492031,126.873772
구로구,1979, 구로1동우체국 앞,201904,178,156,334,37.492031,126.873772
구로구,1979, 구로1동우체국 앞,201905,220,175,395,37.492031,126.873772
구로구,1979, 구로1동우체국 앞,201906,237,178,415,37.492031,126.873772
구로구,1979, 구로1동우체국 앞,201907,233,214,447,37.492031,126.873772
구로구,1979, 구로1동우체국 앞,201908,194,193,387,37.492031,126.873772
구로구,1979, 구로1동우체국 앞,201909,229,185,414,37.492031,126.873772
구로구,1979, 구로1동우체국 앞,201910,305,238,543,37.492031,126.873772
구로구,1979, 구로1동우체국 앞,201911,171,138,309,37.492031,126.873772
구로구,1979, 구로1동우체국 앞,201912,138,93,231,37.492031,126.873772
구로구,1979, 구로1동우체국 앞,202001,97,60,157,37.492031,126.873772
구로구,1979, 구로1동우체국 앞,202002,101,75,176,37.492031,126.873772
구로구,1979, 구로1동우체국 앞,202003,129,104,233,37.492031,126.873772
구로구,1979, 구로1동우체국 앞,202004,216,102,318,37.492031,126.873772
구로구,1979, 구로1동우체국 앞,202005,178,125,303,37.492031,126.873772
구로구,1979, 구로1동우체국 앞,202006,254,154,408,37.492031,126.873772
구로구,1981, 천왕이펜하우스5단지 앞,201901,180,227,407,37.479431,126.842697
구로구,1981, 천왕이펜하우스5단지 앞,201902,155,234,389,37.479431,126.842697
구로구,1981, 천왕이펜하우스5단지 앞,201903,327,406,733,37.479431,126.842697
구로구,1981, 천왕이펜하우스5단지 앞,201904,503,534,1037,37.479431,126.842697
구로구,1981, 천왕이펜하우스5단지 앞,201905,650,778,1428,37.479431,126.842697
구로구,1981, 천왕이펜하우스5단지 앞,201906,659,819,1478,37.479431,126.842697
구로구,1981, 천왕이펜하우스5단지 앞,201907,547,765,1312,37.479431,126.842697
구로구,1981, 천왕이펜하우스5단지 앞,201908,588,833,1421,37.479431,126.842697
구로구,1981, 천왕이펜하우스5단지 앞,201909,582,710,1292,37.479431,126.842697
구로구,1981, 천왕이펜하우스5단지 앞,201910,608,882,1490,37.479431,126.842697
구로구,1981, 천왕이펜하우스5단지 앞,201911,478,592,1070,37.479431,126.842697
구로구,1981, 천왕이펜하우스5단지 앞,201912,306,390,696,37.479431,126.842697
구로구,1981, 천왕이펜하우스5단지 앞,202001,238,293,531,37.479431,126.842697
구로구,1981, 천왕이펜하우스5단지 앞,202002,241,287,528,37.479431,126.842697
구로구,1981, 천왕이펜하우스5단지 앞,202003,440,486,926,37.479431,126.842697
구로구,1981, 천왕이펜하우스5단지 앞,202004,696,752,1448,37.479431,126.842697
구로구,1981, 천왕이펜하우스5단지 앞,202005,820,914,1734,37.479431,126.842697
구로구,1981, 천왕이펜하우스5단지 앞,202006,815,1034,1849,37.479431,126.842697
구로구,1983, 구로동롯데아파트,201901,283,282,565,37.502548,126.883881
구로구,1983, 구로동롯데아파트,201902,272,233,505,37.502548,126.883881
구로구,1983, 구로동롯데아파트,201903,465,427,892,37.502548,126.883881
구로구,1983, 구로동롯데아파트,201904,770,695,1465,37.502548,126.883881
구로구,1983, 구로동롯데아파트,201905,1140,1049,2189,37.502548,126.883881
구로구,1983, 구로동롯데아파트,201906,1441,1292,2733,37.502548,126.883881
구로구,1983, 구로동롯데아파트,201907,1417,1276,2693,37.502548,126.883881
구로구,1983, 구로동롯데아파트,201908,1414,1321,2735,37.502548,126.883881
구로구,1983, 구로동롯데아파트,201909,1074,1027,2101,37.502548,126.883881
구로구,1983, 구로동롯데아파트,201910,1387,1343,2730,37.502548,126.883881
구로구,1983, 구로동롯데아파트,201911,951,931,1882,37.502548,126.883881
구로구,1983, 구로동롯데아파트,201912,600,564,1164,37.502548,126.883881
구로구,1983, 구로동롯데아파트,202001,461,442,903,37.502548,126.883881
구로구,1983, 구로동롯데아파트,202002,431,405,836,37.502548,126.883881
구로구,1983, 구로동롯데아파트,202003,679,681,1360,37.502548,126.883881
구로구,1983, 구로동롯데아파트,202004,1030,1019,2049,37.502548,126.883881
구로구,1983, 구로동롯데아파트,202005,1271,1258,2529,37.502548,126.883881
구로구,1983, 구로동롯데아파트,202006,1660,1639,3299,37.502548,126.883881
구로구,1984, 구로구청,201901,288,323,611,37.495266,126.888474
구로구,1984, 구로구청,201902,268,256,524,37.495266,126.888474
구로구,1984, 구로구청,201903,462,473,935,37.495266,126.888474
구로구,1984, 구로구청,201904,687,720,1407,37.495266,126.888474
구로구,1984, 구로구청,201905,1091,1103,2194,37.495266,126.888474
구로구,1984, 구로구청,201906,1197,1300,2497,37.495266,126.888474
구로구,1984, 구로구청,201907,1027,1153,2180,37.495266,126.888474
구로구,1984, 구로구청,201908,1141,1251,2392,37.495266,126.888474
구로구,1984, 구로구청,201909,1150,1259,2409,37.495266,126.888474
구로구,1984, 구로구청,201910,1427,1536,2963,37.495266,126.888474
구로구,1984, 구로구청,201911,855,922,1777,37.495266,126.888474
구로구,1984, 구로구청,201912,556,566,1122,37.495266,126.888474
구로구,1984, 구로구청,202001,528,555,1083,37.495266,126.888474
구로구,1984, 구로구청,202002,497,501,998,37.495266,126.888474
구로구,1984, 구로구청,202003,775,786,1561,37.495266,126.888474
구로구,1984, 구로구청,202004,1248,1267,2515,37.495266,126.888474
구로구,1984, 구로구청,202005,1425,1447,2872,37.495266,126.888474
구로구,1984, 구로구청,202006,1835,1842,3677,37.495266,126.888474
구로구,1985, 구로도서관,201901,888,791,1679,37.498516,126.891991
구로구,1985, 구로도서관,201902,750,680,1430,37.498516,126.891991
구로구,1985, 구로도서관,201903,1158,1112,2270,37.498516,126.891991
구로구,1985, 구로도서관,201904,2054,1979,4033,37.498516,126.891991
구로구,1985, 구로도서관,201905,2986,2885,5871,37.498516,126.891991
구로구,1985, 구로도서관,201906,3532,3394,6926,37.498516,126.891991
구로구,1985, 구로도서관,201907,4041,3792,7833,37.498516,126.891991
구로구,1985, 구로도서관,201908,4005,3642,7647,37.498516,126.891991
구로구,1985, 구로도서관,201909,3272,2996,6268,37.498516,126.891991
구로구,1985, 구로도서관,201910,3799,3467,7266,37.498516,126.891991
구로구,1985, 구로도서관,201911,2373,2130,4503,37.498516,126.891991
구로구,1985, 구로도서관,201912,1298,1160,2458,37.498516,126.891991
구로구,1985, 구로도서관,202001,1309,1224,2533,37.498516,126.891991
구로구,1985, 구로도서관,202002,952,907,1859,37.498516,126.891991
구로구,1985, 구로도서관,202003,1358,1253,2611,37.498516,126.891991
구로구,1985, 구로도서관,202004,2151,1998,4149,37.498516,126.891991
구로구,1985, 구로도서관,202005,2715,2580,5295,37.498516,126.891991
구로구,1985, 구로도서관,202006,3376,3177,6553,37.498516,126.891991
구로구,1986, 태평양물산빌딩,201901,888,920,1808,37.484859,126.895187
구로구,1986, 태평양물산빌딩,201902,684,695,1379,37.484859,126.895187
구로구,1986, 태평양물산빌딩,201903,1357,1515,2872,37.484859,126.895187
구로구,1986, 태평양물산빌딩,201904,2076,2363,4439,37.484859,126.895187
구로구,1986, 태평양물산빌딩,201905,3063,3388,6451,37.484859,126.895187
구로구,1986, 태평양물산빌딩,201906,3364,3656,7020,37.484859,126.895187
구로구,1986, 태평양물산빌딩,201907,3106,3646,6752,37.484859,126.895187
구로구,1986, 태평양물산빌딩,201908,2399,2604,5003,37.484859,126.895187
구로구,1986, 태평양물산빌딩,201909,2119,2505,4624,37.484859,126.895187
구로구,1986, 태평양물산빌딩,201910,2547,2976,5523,37.484859,126.895187
구로구,1986, 태평양물산빌딩,201911,1716,2043,3759,37.484859,126.895187
구로구,1986, 태평양물산빌딩,201912,1007,1160,2167,37.484859,126.895187
구로구,1986, 태평양물산빌딩,202001,859,1069,1928,37.484859,126.895187
구로구,1986, 태평양물산빌딩,202002,932,999,1931,37.484859,126.895187
구로구,1986, 태평양물산빌딩,202003,1278,1401,2679,37.484859,126.895187
구로구,1986, 태평양물산빌딩,202004,1925,2098,4023,37.484859,126.895187
구로구,1986, 태평양물산빌딩,202005,2191,2280,4471,37.484859,126.895187
구로구,1986, 태평양물산빌딩,202006,2578,2907,5485,37.484859,126.895187
구로구,1987, 개봉아이파크아파트 앞,201901,212,205,417,37.490341,126.860931
구로구,1987, 개봉아이파크아파트 앞,201902,181,169,350,37.490341,126.860931
구로구,1987, 개봉아이파크아파트 앞,201903,330,348,678,37.490341,126.860931
구로구,1987, 개봉아이파크아파트 앞,201904,672,776,1448,37.490341,126.860931
구로구,1987, 개봉아이파크아파트 앞,201905,960,1046,2006,37.490341,126.860931
구로구,1987, 개봉아이파크아파트 앞,201906,1142,1282,2424,37.490341,126.860931
구로구,1987, 개봉아이파크아파트 앞,201907,993,1143,2136,37.490341,126.860931
구로구,1987, 개봉아이파크아파트 앞,201908,1020,1144,2164,37.490341,126.860931
구로구,1987, 개봉아이파크아파트 앞,201909,1077,1235,2312,37.490341,126.860931
구로구,1987, 개봉아이파크아파트 앞,201910,1388,1504,2892,37.490341,126.860931
구로구,1987, 개봉아이파크아파트 앞,201911,782,936,1718,37.490341,126.860931
구로구,1987, 개봉아이파크아파트 앞,201912,471,490,961,37.490341,126.860931
구로구,1987, 개봉아이파크아파트 앞,202001,374,380,754,37.490341,126.860931
구로구,1987, 개봉아이파크아파트 앞,202002,412,448,860,37.490341,126.860931
구로구,1987, 개봉아이파크아파트 앞,202003,1145,1233,2378,37.490341,126.860931
구로구,1987, 개봉아이파크아파트 앞,202004,1565,1662,3227,37.490341,126.860931
구로구,1987, 개봉아이파크아파트 앞,202005,1909,2066,3975,37.490341,126.860931
구로구,1987, 개봉아이파크아파트 앞,202006,2042,2306,4348,37.490341,126.860931
구로구,1988, 고척LIGA아파트 앞,201901,272,289,561,37.50605,126.860786
구로구,1988, 고척LIGA아파트 앞,201902,370,333,703,37.50605,126.860786
구로구,1988, 고척LIGA아파트 앞,201903,563,524,1087,37.50605,126.860786
구로구,1988, 고척LIGA아파트 앞,201904,802,950,1752,37.50605,126.860786
구로구,1988, 고척LIGA아파트 앞,201905,1401,1606,3007,37.50605,126.860786
구로구,1988, 고척LIGA아파트 앞,201906,1716,1933,3649,37.50605,126.860786
구로구,1988, 고척LIGA아파트 앞,201907,1629,1900,3529,37.50605,126.860786
구로구,1988, 고척LIGA아파트 앞,201908,1733,2065,3798,37.50605,126.860786
구로구,1988, 고척LIGA아파트 앞,201909,1750,1931,3681,37.50605,126.860786
구로구,1988, 고척LIGA아파트 앞,201910,2308,2389,4697,37.50605,126.860786
구로구,1988, 고척LIGA아파트 앞,201911,1407,1367,2774,37.50605,126.860786
구로구,1988, 고척LIGA아파트 앞,201912,860,851,1711,37.50605,126.860786
구로구,1988, 고척LIGA아파트 앞,202001,710,705,1415,37.50605,126.860786
구로구,1988, 고척LIGA아파트 앞,202002,747,711,1458,37.50605,126.860786
구로구,1988, 고척LIGA아파트 앞,202003,1073,1074,2147,37.50605,126.860786
구로구,1988, 고척LIGA아파트 앞,202004,1926,2018,3944,37.50605,126.860786
구로구,1988, 고척LIGA아파트 앞,202005,2170,2221,4391,37.50605,126.860786
구로구,1988, 고척LIGA아파트 앞,202006,2177,2280,4457,37.50605,126.860786
구로구,1991, 오류동역 맞은편,201901,189,253,442,37.496761,126.844963
구로구,1991, 오류동역 맞은편,201902,235,251,486,37.496761,126.844963
구로구,1991, 오류동역 맞은편,201903,372,466,838,37.496761,126.844963
구로구,1991, 오류동역 맞은편,201904,698,854,1552,37.496761,126.844963
구로구,1991, 오류동역 맞은편,201905,1092,1479,2571,37.496761,126.844963
구로구,1991, 오류동역 맞은편,201906,1209,1665,2874,37.496761,126.844963
구로구,1991, 오류동역 맞은편,201907,1122,1466,2588,37.496761,126.844963
구로구,1991, 오류동역 맞은편,201908,980,1402,2382,37.496761,126.844963
구로구,1991, 오류동역 맞은편,201909,1058,1410,2468,37.496761,126.844963
구로구,1991, 오류동역 맞은편,201910,1295,1651,2946,37.496761,126.844963
구로구,1991, 오류동역 맞은편,201911,756,969,1725,37.496761,126.844963
구로구,1991, 오류동역 맞은편,201912,422,510,932,37.496761,126.844963
구로구,1991, 오류동역 맞은편,202001,452,582,1034,37.496761,126.844963
구로구,1991, 오류동역 맞은편,202002,440,572,1012,37.496761,126.844963
구로구,1991, 오류동역 맞은편,202003,791,951,1742,37.496761,126.844963
구로구,1991, 오류동역 맞은편,202004,1259,1521,2780,37.496761,126.844963
구로구,1991, 오류동역 맞은편,202005,1647,1925,3572,37.496761,126.844963
구로구,1991, 오류동역 맞은편,202006,1752,2244,3996,37.496761,126.844963
구로구,1992, 구로구배드민턴실내체육관 앞,201901,45,45,90,37.491798,126.83242
구로구,1992, 구로구배드민턴실내체육관 앞,201902,35,21,56,37.491798,126.83242
구로구,1992, 구로구배드민턴실내체육관 앞,201903,82,84,166,37.491798,126.83242
구로구,1992, 구로구배드민턴실내체육관 앞,201904,79,115,194,37.491798,126.83242
구로구,1992, 구로구배드민턴실내체육관 앞,201905,154,217,371,37.491798,126.83242
구로구,1992, 구로구배드민턴실내체육관 앞,201906,209,258,467,37.491798,126.83242
구로구,1992, 구로구배드민턴실내체육관 앞,201907,126,198,324,37.491798,126.83242
구로구,1992, 구로구배드민턴실내체육관 앞,201908,138,203,341,37.491798,126.83242
구로구,1992, 구로구배드민턴실내체육관 앞,201909,169,173,342,37.491798,126.83242
구로구,1992, 구로구배드민턴실내체육관 앞,201910,237,225,462,37.491798,126.83242
구로구,1992, 구로구배드민턴실내체육관 앞,201911,158,157,315,37.491798,126.83242
구로구,1992, 구로구배드민턴실내체육관 앞,201912,97,102,199,37.491798,126.83242
구로구,1992, 구로구배드민턴실내체육관 앞,202001,111,91,202,37.491798,126.83242
구로구,1992, 구로구배드민턴실내체육관 앞,202002,88,104,192,37.491798,126.83242
구로구,1992, 구로구배드민턴실내체육관 앞,202003,139,135,274,37.491798,126.83242
구로구,1992, 구로구배드민턴실내체육관 앞,202004,232,197,429,37.491798,126.83242
구로구,1992, 구로구배드민턴실내체육관 앞,202005,289,250,539,37.491798,126.83242
구로구,1992, 구로구배드민턴실내체육관 앞,202006,278,260,538,37.491798,126.83242
구로구,1993, 금강수목원아파트 앞,201901,31,30,61,37.48938,126.834198
구로구,1993, 금강수목원아파트 앞,201902,42,40,82,37.48938,126.834198
구로구,1993, 금강수목원아파트 앞,201903,124,132,256,37.48938,126.834198
구로구,1993, 금강수목원아파트 앞,201904,249,215,464,37.48938,126.834198
구로구,1993, 금강수목원아파트 앞,201905,289,288,577,37.48938,126.834198
구로구,1993, 금강수목원아파트 앞,201906,361,326,687,37.48938,126.834198
구로구,1993, 금강수목원아파트 앞,201907,321,322,643,37.48938,126.834198
구로구,1993, 금강수목원아파트 앞,201908,330,328,658,37.48938,126.834198
구로구,1993, 금강수목원아파트 앞,201909,295,275,570,37.48938,126.834198
구로구,1993, 금강수목원아파트 앞,201910,390,353,743,37.48938,126.834198
구로구,1993, 금강수목원아파트 앞,201911,260,269,529,37.48938,126.834198
구로구,1993, 금강수목원아파트 앞,201912,178,187,365,37.48938,126.834198
구로구,1993, 금강수목원아파트 앞,202001,227,237,464,37.48938,126.834198
구로구,1993, 금강수목원아파트 앞,202002,196,195,391,37.48938,126.834198
구로구,1993, 금강수목원아파트 앞,202003,292,270,562,37.48938,126.834198
구로구,1993, 금강수목원아파트 앞,202004,515,481,996,37.48938,126.834198
구로구,1993, 금강수목원아파트 앞,202005,523,512,1035,37.48938,126.834198
구로구,1993, 금강수목원아파트 앞,202006,772,750,1522,37.48938,126.834198
구로구,1994, 삼성전자 물류센터 앞,201901,130,133,263,37.496998,126.87178
구로구,1994, 삼성전자 물류센터 앞,201902,144,152,296,37.496998,126.87178
구로구,1994, 삼성전자 물류센터 앞,201903,239,239,478,37.496998,126.87178
구로구,1994, 삼성전자 물류센터 앞,201904,283,267,550,37.496998,126.87178
구로구,1994, 삼성전자 물류센터 앞,201905,450,422,872,37.496998,126.87178
구로구,1994, 삼성전자 물류센터 앞,201906,554,518,1072,37.496998,126.87178
구로구,1994, 삼성전자 물류센터 앞,201907,699,698,1397,37.496998,126.87178
구로구,1994, 삼성전자 물류센터 앞,201908,760,742,1502,37.496998,126.87178
구로구,1994, 삼성전자 물류센터 앞,201909,882,825,1707,37.496998,126.87178
구로구,1994, 삼성전자 물류센터 앞,201910,946,929,1875,37.496998,126.87178
구로구,1994, 삼성전자 물류센터 앞,201911,688,644,1332,37.496998,126.87178
구로구,1994, 삼성전자 물류센터 앞,201912,443,413,856,37.496998,126.87178
구로구,1994, 삼성전자 물류센터 앞,202001,404,393,797,37.496998,126.87178
구로구,1994, 삼성전자 물류센터 앞,202002,359,350,709,37.496998,126.87178
구로구,1994, 삼성전자 물류센터 앞,202003,553,549,1102,37.496998,126.87178
구로구,1994, 삼성전자 물류센터 앞,202004,853,809,1662,37.496998,126.87178
구로구,1994, 삼성전자 물류센터 앞,202005,891,866,1757,37.496998,126.87178
구로구,1994, 삼성전자 물류센터 앞,202006,1149,1106,2255,37.496998,126.87178
구로구,1996, 구일역 1번 출입구 앞,201901,111,107,218,37.495399,126.87101
구로구,1996, 구일역 1번 출입구 앞,201902,142,130,272,37.495399,126.87101
구로구,1996, 구일역 1번 출입구 앞,201903,383,373,756,37.495399,126.87101
구로구,1996, 구일역 1번 출입구 앞,201904,949,926,1875,37.495399,126.87101
구로구,1996, 구일역 1번 출입구 앞,201905,1578,1589,3167,37.495399,126.87101
구로구,1996, 구일역 1번 출입구 앞,201906,1840,1834,3674,37.495399,126.87101
구로구,1996, 구일역 1번 출입구 앞,201907,1406,1410,2816,37.495399,126.87101
구로구,1996, 구일역 1번 출입구 앞,201908,1443,1435,2878,37.495399,126.87101
구로구,1996, 구일역 1번 출입구 앞,201909,1376,1386,2762,37.495399,126.87101
구로구,1996, 구일역 1번 출입구 앞,201910,1761,1763,3524,37.495399,126.87101
구로구,1996, 구일역 1번 출입구 앞,201911,892,897,1789,37.495399,126.87101
구로구,1996, 구일역 1번 출입구 앞,201912,351,345,696,37.495399,126.87101
구로구,1996, 구일역 1번 출입구 앞,202001,322,316,638,37.495399,126.87101
구로구,1996, 구일역 1번 출입구 앞,202002,522,528,1050,37.495399,126.87101
구로구,1996, 구일역 1번 출입구 앞,202003,1392,1401,2793,37.495399,126.87101
구로구,1996, 구일역 1번 출입구 앞,202004,2393,2418,4811,37.495399,126.87101
구로구,1996, 구일역 1번 출입구 앞,202005,2701,2711,5412,37.495399,126.87101
구로구,1996, 구일역 1번 출입구 앞,202006,2774,2802,5576,37.495399,126.87101
구로구,1998, 고척교 교차로,201901,131,97,228,37.498569,126.871521
구로구,1998, 고척교 교차로,201902,153,120,273,37.498569,126.871521
구로구,1998, 고척교 교차로,201903,297,270,567,37.498569,126.871521
구로구,1998, 고척교 교차로,201904,622,601,1223,37.498569,126.871521
구로구,1998, 고척교 교차로,201905,813,787,1600,37.498569,126.871521
구로구,1998, 고척교 교차로,201906,1060,1016,2076,37.498569,126.871521
구로구,1998, 고척교 교차로,201907,873,815,1688,37.498569,126.871521
구로구,1998, 고척교 교차로,201908,907,813,1720,37.498569,126.871521
구로구,1998, 고척교 교차로,201909,1030,1008,2038,37.498569,126.871521
구로구,1998, 고척교 교차로,201910,1213,1152,2365,37.498569,126.871521
구로구,1998, 고척교 교차로,201911,625,598,1223,37.498569,126.871521
구로구,1998, 고척교 교차로,201912,376,338,714,37.498569,126.871521
구로구,1998, 고척교 교차로,202001,436,412,848,37.498569,126.871521
구로구,1998, 고척교 교차로,202002,365,370,735,37.498569,126.871521
구로구,1998, 고척교 교차로,202003,1054,1058,2112,37.498569,126.871521
구로구,1998, 고척교 교차로,202004,1721,1702,3423,37.498569,126.871521
구로구,1998, 고척교 교차로,202005,1951,1931,3882,37.498569,126.871521
구로구,1998, 고척교 교차로,202006,1902,1887,3789,37.498569,126.871521
구로구,1999, 수궁동 성당 주변,201903,41,55,96,37.495258,126.830658
구로구,1999, 수궁동 성당 주변,201904,104,142,246,37.495258,126.830658
구로구,1999, 수궁동 성당 주변,201905,205,322,527,37.495258,126.830658
구로구,1999, 수궁동 성당 주변,201906,328,492,820,37.495258,126.830658
구로구,1999, 수궁동 성당 주변,201907,392,463,855,37.495258,126.830658
구로구,1999, 수궁동 성당 주변,201908,339,417,756,37.495258,126.830658
구로구,1999, 수궁동 성당 주변,201909,309,376,685,37.495258,126.830658
구로구,1999, 수궁동 성당 주변,201910,375,510,885,37.495258,126.830658
구로구,1999, 수궁동 성당 주변,201911,188,216,404,37.495258,126.830658
구로구,1999, 수궁동 성당 주변,201912,106,105,211,37.495258,126.830658
구로구,1999, 수궁동 성당 주변,202001,101,132,233,37.495258,126.830658
구로구,1999, 수궁동 성당 주변,202002,83,112,195,37.495258,126.830658
구로구,1999, 수궁동 성당 주변,202003,237,279,516,37.495258,126.830658
구로구,1999, 수궁동 성당 주변,202004,427,445,872,37.495258,126.830658
구로구,1999, 수궁동 성당 주변,202005,452,518,970,37.495258,126.830658
구로구,1999, 수궁동 성당 주변,202006,552,612,1164,37.495258,126.830658
구로구,2000, 신도림4차 e편한세상 아파트 1109동 앞,201903,109,121,230,37.512329,126.886833
구로구,2000, 신도림4차 e편한세상 아파트 1109동 앞,201904,769,658,1427,37.512329,126.886833
구로구,2000, 신도림4차 e편한세상 아파트 1109동 앞,201905,1278,1021,2299,37.512329,126.886833
구로구,2000, 신도림4차 e편한세상 아파트 1109동 앞,201906,1442,1072,2514,37.512329,126.886833
구로구,2000, 신도림4차 e편한세상 아파트 1109동 앞,201907,1622,1239,2861,37.512329,126.886833
구로구,2000, 신도림4차 e편한세상 아파트 1109동 앞,201908,1620,1262,2882,37.512329,126.886833
구로구,2000, 신도림4차 e편한세상 아파트 1109동 앞,201909,1388,1054,2442,37.512329,126.886833
구로구,2000, 신도림4차 e편한세상 아파트 1109동 앞,201910,1714,1287,3001,37.512329,126.886833
구로구,2000, 신도림4차 e편한세상 아파트 1109동 앞,201911,950,741,1691,37.512329,126.886833
구로구,2000, 신도림4차 e편한세상 아파트 1109동 앞,201912,467,360,827,37.512329,126.886833
구로구,2000, 신도림4차 e편한세상 아파트 1109동 앞,202001,393,334,727,37.512329,126.886833
구로구,2000, 신도림4차 e편한세상 아파트 1109동 앞,202002,427,369,796,37.512329,126.886833
구로구,2000, 신도림4차 e편한세상 아파트 1109동 앞,202003,1139,992,2131,37.512329,126.886833
구로구,2000, 신도림4차 e편한세상 아파트 1109동 앞,202004,1797,1591,3388,37.512329,126.886833
구로구,2000, 신도림4차 e편한세상 아파트 1109동 앞,202005,1821,1654,3475,37.512329,126.886833
구로구,2000, 신도림4차 e편한세상 아파트 1109동 앞,202006,2034,1786,3820,37.512329,126.886833
동작구,2002, 노들역 1번출구,201901,487,544,1031,37.512844,126.952469
동작구,2002, 노들역 1번출구,201902,575,661,1236,37.512844,126.952469
동작구,2002, 노들역 1번출구,201903,1400,1522,2922,37.512844,126.952469
동작구,2002, 노들역 1번출구,201904,2648,3092,5740,37.512844,126.952469
동작구,2002, 노들역 1번출구,201905,4901,5502,10403,37.512844,126.952469
동작구,2002, 노들역 1번출구,201906,5050,5431,10481,37.512844,126.952469
동작구,2002, 노들역 1번출구,201907,4327,4575,8902,37.512844,126.952469
동작구,2002, 노들역 1번출구,201908,4687,5045,9732,37.512844,126.952469
동작구,2002, 노들역 1번출구,201909,4835,5042,9877,37.512844,126.952469
동작구,2002, 노들역 1번출구,201910,5274,5775,11049,37.512844,126.952469
동작구,2002, 노들역 1번출구,201911,2449,2702,5151,37.512844,126.952469
동작구,2002, 노들역 1번출구,201912,934,1071,2005,37.512844,126.952469
동작구,2002, 노들역 1번출구,202001,1047,1054,2101,37.512844,126.952469
동작구,2002, 노들역 1번출구,202002,1169,1279,2448,37.512844,126.952469
동작구,2002, 노들역 1번출구,202003,4751,5045,9796,37.512844,126.952469
동작구,2002, 노들역 1번출구,202004,6756,7315,14071,37.512844,126.952469
동작구,2002, 노들역 1번출구,202005,8017,8344,16361,37.512844,126.952469
동작구,2002, 노들역 1번출구,202006,5407,5677,11084,37.512844,126.952469
동작구,2003, 사육신공원앞,201901,264,286,550,37.513359,126.948059
동작구,2003, 사육신공원앞,201902,358,372,730,37.513359,126.948059
동작구,2003, 사육신공원앞,201903,661,679,1340,37.513359,126.948059
동작구,2003, 사육신공원앞,201904,1141,1147,2288,37.513359,126.948059
동작구,2003, 사육신공원앞,201905,1919,2037,3956,37.513359,126.948059
동작구,2003, 사육신공원앞,201906,2001,2033,4034,37.513359,126.948059
동작구,2003, 사육신공원앞,201907,1702,1722,3424,37.513359,126.948059
동작구,2003, 사육신공원앞,201908,1703,1736,3439,37.513359,126.948059
동작구,2003, 사육신공원앞,201909,1623,1652,3275,37.513359,126.948059
동작구,2003, 사육신공원앞,201910,2004,2082,4086,37.513359,126.948059
동작구,2003, 사육신공원앞,201911,1091,1126,2217,37.513359,126.948059
동작구,2003, 사육신공원앞,201912,449,440,889,37.513359,126.948059
동작구,2003, 사육신공원앞,202001,377,384,761,37.513359,126.948059
동작구,2003, 사육신공원앞,202002,437,433,870,37.513359,126.948059
동작구,2003, 사육신공원앞,202003,1539,1523,3062,37.513359,126.948059
동작구,2003, 사육신공원앞,202004,2305,2316,4621,37.513359,126.948059
동작구,2003, 사육신공원앞,202005,2414,2412,4826,37.513359,126.948059
동작구,2003, 사육신공원앞,202006,2800,2823,5623,37.513359,126.948059
동작구,2007, 유한양행앞,201901,373,364,737,37.512939,126.934242
동작구,2007, 유한양행앞,201902,338,347,685,37.512939,126.934242
동작구,2007, 유한양행앞,201903,639,598,1237,37.512939,126.934242
동작구,2007, 유한양행앞,201904,973,876,1849,37.512939,126.934242
동작구,2007, 유한양행앞,201905,1389,1414,2803,37.512939,126.934242
동작구,2007, 유한양행앞,201906,1764,1750,3514,37.512939,126.934242
동작구,2007, 유한양행앞,201907,1792,1816,3608,37.512939,126.934242
동작구,2007, 유한양행앞,201908,1646,1640,3286,37.512939,126.934242
동작구,2007, 유한양행앞,201909,1499,1490,2989,37.512939,126.934242
동작구,2007, 유한양행앞,201910,1730,1737,3467,37.512939,126.934242
동작구,2007, 유한양행앞,201911,1106,1172,2278,37.512939,126.934242
동작구,2007, 유한양행앞,201912,678,737,1415,37.512939,126.934242
동작구,2007, 유한양행앞,202001,632,629,1261,37.512939,126.934242
동작구,2007, 유한양행앞,202002,633,594,1227,37.512939,126.934242
동작구,2007, 유한양행앞,202003,998,957,1955,37.512939,126.934242
동작구,2007, 유한양행앞,202004,1493,1476,2969,37.512939,126.934242
동작구,2007, 유한양행앞,202005,1663,1650,3313,37.512939,126.934242
동작구,2007, 유한양행앞,202006,1886,1890,3776,37.512939,126.934242
동작구,2008, 노량진근린공원 대방공원,201901,100,52,152,37.509369,126.92807
동작구,2008, 노량진근린공원 대방공원,201902,94,51,145,37.509369,126.92807
동작구,2008, 노량진근린공원 대방공원,201903,213,149,362,37.509369,126.92807
동작구,2008, 노량진근린공원 대방공원,201904,329,248,577,37.509369,126.92807
동작구,2008, 노량진근린공원 대방공원,201905,487,423,910,37.509369,126.92807
동작구,2008, 노량진근린공원 대방공원,201906,483,414,897,37.509369,126.92807
동작구,2008, 노량진근린공원 대방공원,201907,535,490,1025,37.509369,126.92807
동작구,2008, 노량진근린공원 대방공원,201908,454,324,778,37.509369,126.92807
동작구,2008, 노량진근린공원 대방공원,201909,452,345,797,37.509369,126.92807
동작구,2008, 노량진근린공원 대방공원,201910,647,483,1130,37.509369,126.92807
동작구,2008, 노량진근린공원 대방공원,201911,433,255,688,37.509369,126.92807
동작구,2008, 노량진근린공원 대방공원,201912,239,143,382,37.509369,126.92807
동작구,2008, 노량진근린공원 대방공원,202001,173,86,259,37.509369,126.92807
동작구,2008, 노량진근린공원 대방공원,202002,200,124,324,37.509369,126.92807
동작구,2008, 노량진근린공원 대방공원,202003,296,209,505,37.509369,126.92807
동작구,2008, 노량진근린공원 대방공원,202004,367,299,666,37.509369,126.92807
동작구,2008, 노량진근린공원 대방공원,202005,359,326,685,37.509369,126.92807
동작구,2008, 노량진근린공원 대방공원,202006,598,446,1044,37.509369,126.92807
동작구,2009, 보라매역 8번출구,201901,203,195,398,37.500076,126.921082
동작구,2009, 보라매역 8번출구,201902,217,202,419,37.500076,126.921082
동작구,2009, 보라매역 8번출구,201903,433,463,896,37.500076,126.921082
동작구,2009, 보라매역 8번출구,201904,602,613,1215,37.500076,126.921082
동작구,2009, 보라매역 8번출구,201905,952,969,1921,37.500076,126.921082
동작구,2009, 보라매역 8번출구,201906,1093,1078,2171,37.500076,126.921082
동작구,2009, 보라매역 8번출구,201907,1057,1080,2137,37.500076,126.921082
동작구,2009, 보라매역 8번출구,201908,1109,1123,2232,37.500076,126.921082
동작구,2009, 보라매역 8번출구,201909,1042,1033,2075,37.500076,126.921082
동작구,2009, 보라매역 8번출구,201910,1281,1281,2562,37.500076,126.921082
동작구,2009, 보라매역 8번출구,201911,883,905,1788,37.500076,126.921082
동작구,2009, 보라매역 8번출구,201912,471,482,953,37.500076,126.921082
동작구,2009, 보라매역 8번출구,202001,286,289,575,37.500076,126.921082
동작구,2009, 보라매역 8번출구,202002,297,311,608,37.500076,126.921082
동작구,2009, 보라매역 8번출구,202003,584,574,1158,37.500076,126.921082
동작구,2009, 보라매역 8번출구,202004,892,903,1795,37.500076,126.921082
동작구,2009, 보라매역 8번출구,202005,1045,1040,2085,37.500076,126.921082
동작구,2009, 보라매역 8번출구,202006,1079,1081,2160,37.500076,126.921082
동작구,2012, 녹십초요양병원앞,201901,18,24,42,37.488361,126.906227
동작구,2012, 녹십초요양병원앞,201902,115,94,209,37.488361,126.906227
동작구,2012, 녹십초요양병원앞,201903,266,253,519,37.488361,126.906227
동작구,2012, 녹십초요양병원앞,201904,431,410,841,37.488361,126.906227
동작구,2012, 녹십초요양병원앞,201905,722,679,1401,37.488361,126.906227
동작구,2012, 녹십초요양병원앞,201906,626,648,1274,37.488361,126.906227
동작구,2012, 녹십초요양병원앞,201907,777,776,1553,37.488361,126.906227
동작구,2012, 녹십초요양병원앞,201908,735,722,1457,37.488361,126.906227
동작구,2012, 녹십초요양병원앞,201909,627,624,1251,37.488361,126.906227
동작구,2012, 녹십초요양병원앞,201910,680,680,1360,37.488361,126.906227
동작구,2012, 녹십초요양병원앞,201911,423,409,832,37.488361,126.906227
동작구,2012, 녹십초요양병원앞,201912,278,279,557,37.488361,126.906227
동작구,2012, 녹십초요양병원앞,202001,192,184,376,37.488361,126.906227
동작구,2012, 녹십초요양병원앞,202002,176,166,342,37.488361,126.906227
동작구,2012, 녹십초요양병원앞,202003,348,345,693,37.488361,126.906227
동작구,2012, 녹십초요양병원앞,202004,547,538,1085,37.488361,126.906227
동작구,2012, 녹십초요양병원앞,202005,718,713,1431,37.488361,126.906227
동작구,2012, 녹십초요양병원앞,202006,949,949,1898,37.488361,126.906227
동작구,2013, 장승배기역 5번출구,201901,613,374,987,37.505852,126.939362
동작구,2013, 장승배기역 5번출구,201902,688,395,1083,37.505852,126.939362
동작구,2013, 장승배기역 5번출구,201903,1346,791,2137,37.505852,126.939362
동작구,2013, 장승배기역 5번출구,201904,1757,1213,2970,37.505852,126.939362
동작구,2013, 장승배기역 5번출구,201905,2506,1972,4478,37.505852,126.939362
동작구,2013, 장승배기역 5번출구,201906,2633,2113,4746,37.505852,126.939362
동작구,2013, 장승배기역 5번출구,201907,2408,1917,4325,37.505852,126.939362
동작구,2013, 장승배기역 5번출구,201908,2402,1737,4139,37.505852,126.939362
동작구,2013, 장승배기역 5번출구,201909,2200,1641,3841,37.505852,126.939362
동작구,2013, 장승배기역 5번출구,201910,2719,1844,4563,37.505852,126.939362
동작구,2013, 장승배기역 5번출구,201911,1920,1309,3229,37.505852,126.939362
동작구,2013, 장승배기역 5번출구,201912,1074,695,1769,37.505852,126.939362
동작구,2013, 장승배기역 5번출구,202001,952,728,1680,37.505852,126.939362
동작구,2013, 장승배기역 5번출구,202002,991,641,1632,37.505852,126.939362
동작구,2013, 장승배기역 5번출구,202003,1365,1034,2399,37.505852,126.939362
동작구,2013, 장승배기역 5번출구,202004,1953,1634,3587,37.505852,126.939362
동작구,2013, 장승배기역 5번출구,202005,2063,1960,4023,37.505852,126.939362
동작구,2013, 장승배기역 5번출구,202006,2305,1946,4251,37.505852,126.939362
동작구,2015, 신대방삼거리역 6번출구쪽,201901,570,549,1119,37.499855,126.929565
동작구,2015, 신대방삼거리역 6번출구쪽,201902,530,523,1053,37.499855,126.929565
동작구,2015, 신대방삼거리역 6번출구쪽,201903,985,1042,2027,37.499855,126.929565
동작구,2015, 신대방삼거리역 6번출구쪽,201904,1443,1635,3078,37.499855,126.929565
동작구,2015, 신대방삼거리역 6번출구쪽,201905,2213,2450,4663,37.499855,126.929565
동작구,2015, 신대방삼거리역 6번출구쪽,201906,2423,2542,4965,37.499855,126.929565
동작구,2015, 신대방삼거리역 6번출구쪽,201907,2245,2380,4625,37.499855,126.929565
동작구,2015, 신대방삼거리역 6번출구쪽,201908,2199,2284,4483,37.499855,126.929565
동작구,2015, 신대방삼거리역 6번출구쪽,201909,1976,2121,4097,37.499855,126.929565
동작구,2015, 신대방삼거리역 6번출구쪽,201910,2572,2769,5341,37.499855,126.929565
동작구,2015, 신대방삼거리역 6번출구쪽,201911,1747,1807,3554,37.499855,126.929565
동작구,2015, 신대방삼거리역 6번출구쪽,201912,896,918,1814,37.499855,126.929565
동작구,2015, 신대방삼거리역 6번출구쪽,202001,805,826,1631,37.499855,126.929565
동작구,2015, 신대방삼거리역 6번출구쪽,202002,831,849,1680,37.499855,126.929565
동작구,2015, 신대방삼거리역 6번출구쪽,202003,1356,1391,2747,37.499855,126.929565
동작구,2015, 신대방삼거리역 6번출구쪽,202004,2116,2142,4258,37.499855,126.929565
동작구,2015, 신대방삼거리역 6번출구쪽,202005,2274,2337,4611,37.499855,126.929565
동작구,2015, 신대방삼거리역 6번출구쪽,202006,2675,2723,5398,37.499855,126.929565
동작구,2016, 신대방삼거리역 3번출구쪽,201901,429,398,827,37.499645,126.927094
동작구,2016, 신대방삼거리역 3번출구쪽,201902,413,405,818,37.499645,126.927094
동작구,2016, 신대방삼거리역 3번출구쪽,201903,649,720,1369,37.499645,126.927094
동작구,2016, 신대방삼거리역 3번출구쪽,201904,1016,1074,2090,37.499645,126.927094
동작구,2016, 신대방삼거리역 3번출구쪽,201905,1659,1883,3542,37.499645,126.927094
동작구,2016, 신대방삼거리역 3번출구쪽,201906,1802,2011,3813,37.499645,126.927094
동작구,2016, 신대방삼거리역 3번출구쪽,201907,1755,1833,3588,37.499645,126.927094
동작구,2016, 신대방삼거리역 3번출구쪽,201908,1671,1743,3414,37.499645,126.927094
동작구,2016, 신대방삼거리역 3번출구쪽,201909,1801,1863,3664,37.499645,126.927094
동작구,2016, 신대방삼거리역 3번출구쪽,201910,2117,2141,4258,37.499645,126.927094
동작구,2016, 신대방삼거리역 3번출구쪽,201911,1321,1332,2653,37.499645,126.927094
동작구,2016, 신대방삼거리역 3번출구쪽,201912,697,705,1402,37.499645,126.927094
동작구,2016, 신대방삼거리역 3번출구쪽,202001,577,602,1179,37.499645,126.927094
동작구,2016, 신대방삼거리역 3번출구쪽,202002,539,582,1121,37.499645,126.927094
동작구,2016, 신대방삼거리역 3번출구쪽,202003,1070,1092,2162,37.499645,126.927094
동작구,2016, 신대방삼거리역 3번출구쪽,202004,1771,1829,3600,37.499645,126.927094
동작구,2016, 신대방삼거리역 3번출구쪽,202005,1967,2015,3982,37.499645,126.927094
동작구,2016, 신대방삼거리역 3번출구쪽,202006,2366,2404,4770,37.499645,126.927094
동작구,2020, 장승배기역2번출구뒷편쪽,201901,184,154,338,37.504498,126.938988
동작구,2020, 장승배기역2번출구뒷편쪽,201902,184,167,351,37.504498,126.938988
동작구,2020, 장승배기역2번출구뒷편쪽,201903,358,318,676,37.504498,126.938988
동작구,2020, 장승배기역2번출구뒷편쪽,201904,530,496,1026,37.504498,126.938988
동작구,2020, 장승배기역2번출구뒷편쪽,201905,833,734,1567,37.504498,126.938988
동작구,2020, 장승배기역2번출구뒷편쪽,201906,832,750,1582,37.504498,126.938988
동작구,2020, 장승배기역2번출구뒷편쪽,201907,854,731,1585,37.504498,126.938988
동작구,2020, 장승배기역2번출구뒷편쪽,201908,750,655,1405,37.504498,126.938988
동작구,2020, 장승배기역2번출구뒷편쪽,201909,758,694,1452,37.504498,126.938988
동작구,2020, 장승배기역2번출구뒷편쪽,201910,914,808,1722,37.504498,126.938988
동작구,2020, 장승배기역2번출구뒷편쪽,201911,634,520,1154,37.504498,126.938988
동작구,2020, 장승배기역2번출구뒷편쪽,201912,310,299,609,37.504498,126.938988
동작구,2020, 장승배기역2번출구뒷편쪽,202001,338,279,617,37.504498,126.938988
동작구,2020, 장승배기역2번출구뒷편쪽,202002,321,247,568,37.504498,126.938988
동작구,2020, 장승배기역2번출구뒷편쪽,202003,565,487,1052,37.504498,126.938988
동작구,2020, 장승배기역2번출구뒷편쪽,202004,861,784,1645,37.504498,126.938988
동작구,2020, 장승배기역2번출구뒷편쪽,202005,822,801,1623,37.504498,126.938988
동작구,2020, 장승배기역2번출구뒷편쪽,202006,971,931,1902,37.504498,126.938988
동작구,2024, 상도역 1번출구,201901,310,294,604,37.502178,126.948204
동작구,2024, 상도역 1번출구,201902,305,301,606,37.502178,126.948204
동작구,2024, 상도역 1번출구,201903,653,581,1234,37.502178,126.948204
동작구,2024, 상도역 1번출구,201904,1078,1009,2087,37.502178,126.948204
동작구,2024, 상도역 1번출구,201905,1669,1553,3222,37.502178,126.948204
동작구,2024, 상도역 1번출구,201906,1640,1497,3137,37.502178,126.948204
동작구,2024, 상도역 1번출구,201907,1406,1328,2734,37.502178,126.948204
동작구,2024, 상도역 1번출구,201908,1527,1449,2976,37.502178,126.948204
동작구,2024, 상도역 1번출구,201909,1542,1533,3075,37.502178,126.948204
동작구,2024, 상도역 1번출구,201910,1475,1454,2929,37.502178,126.948204
동작구,2024, 상도역 1번출구,201911,940,894,1834,37.502178,126.948204
동작구,2024, 상도역 1번출구,201912,428,424,852,37.502178,126.948204
동작구,2024, 상도역 1번출구,202001,369,332,701,37.502178,126.948204
동작구,2024, 상도역 1번출구,202002,362,349,711,37.502178,126.948204
동작구,2024, 상도역 1번출구,202003,985,938,1923,37.502178,126.948204
동작구,2024, 상도역 1번출구,202004,1375,1352,2727,37.502178,126.948204
동작구,2024, 상도역 1번출구,202005,1593,1569,3162,37.502178,126.948204
동작구,2024, 상도역 1번출구,202006,1506,1394,2900,37.502178,126.948204
동작구,2025, 흑석역 1번출구,201901,352,400,752,37.50938,126.963615
동작구,2025, 흑석역 1번출구,201902,482,512,994,37.50938,126.963615
동작구,2025, 흑석역 1번출구,201903,1323,1392,2715,37.50938,126.963615
동작구,2025, 흑석역 1번출구,201904,2492,2656,5148,37.50938,126.963615
동작구,2025, 흑석역 1번출구,201905,4239,4468,8707,37.50938,126.963615
동작구,2025, 흑석역 1번출구,201906,3671,3810,7481,37.50938,126.963615
동작구,2025, 흑석역 1번출구,201907,3164,3496,6660,37.50938,126.963615
동작구,2025, 흑석역 1번출구,201908,3274,3714,6988,37.50938,126.963615
동작구,2025, 흑석역 1번출구,201909,3904,4254,8158,37.50938,126.963615
동작구,2025, 흑석역 1번출구,201910,3656,3788,7444,37.50938,126.963615
동작구,2025, 흑석역 1번출구,201911,1779,1934,3713,37.50938,126.963615
동작구,2025, 흑석역 1번출구,201912,622,695,1317,37.50938,126.963615
동작구,2025, 흑석역 1번출구,202001,642,716,1358,37.50938,126.963615
동작구,2025, 흑석역 1번출구,202002,874,1038,1912,37.50938,126.963615
동작구,2025, 흑석역 1번출구,202003,3671,3949,7620,37.50938,126.963615
동작구,2025, 흑석역 1번출구,202004,4927,5560,10487,37.50938,126.963615
동작구,2025, 흑석역 1번출구,202005,5703,6091,11794,37.50938,126.963615
동작구,2025, 흑석역 1번출구,202006,4893,5393,10286,37.50938,126.963615
동작구,2026, 흑석역 4번출구,201901,117,170,287,37.508587,126.963493
동작구,2026, 흑석역 4번출구,201902,118,147,265,37.508587,126.963493
동작구,2026, 흑석역 4번출구,201903,243,231,474,37.508587,126.963493
동작구,2026, 흑석역 4번출구,201904,345,331,676,37.508587,126.963493
동작구,2026, 흑석역 4번출구,201905,553,547,1100,37.508587,126.963493
동작구,2026, 흑석역 4번출구,201906,618,626,1244,37.508587,126.963493
동작구,2026, 흑석역 4번출구,201907,578,621,1199,37.508587,126.963493
동작구,2026, 흑석역 4번출구,201908,490,496,986,37.508587,126.963493
동작구,2026, 흑석역 4번출구,201909,538,527,1065,37.508587,126.963493
동작구,2026, 흑석역 4번출구,201910,661,668,1329,37.508587,126.963493
동작구,2026, 흑석역 4번출구,201911,415,417,832,37.508587,126.963493
동작구,2026, 흑석역 4번출구,201912,184,196,380,37.508587,126.963493
동작구,2026, 흑석역 4번출구,202001,169,183,352,37.508587,126.963493
동작구,2026, 흑석역 4번출구,202002,148,138,286,37.508587,126.963493
동작구,2026, 흑석역 4번출구,202003,390,396,786,37.508587,126.963493
동작구,2026, 흑석역 4번출구,202004,664,664,1328,37.508587,126.963493
동작구,2026, 흑석역 4번출구,202005,825,844,1669,37.508587,126.963493
동작구,2026, 흑석역 4번출구,202006,1002,1018,2020,37.508587,126.963493
동작구,2027, 중앙대학교 정문,201901,219,279,498,37.507042,126.959152
동작구,2027, 중앙대학교 정문,201902,183,176,359,37.507042,126.959152
동작구,2027, 중앙대학교 정문,201903,352,368,720,37.507042,126.959152
동작구,2027, 중앙대학교 정문,201904,689,687,1376,37.507042,126.959152
동작구,2027, 중앙대학교 정문,201905,1046,1091,2137,37.507042,126.959152
동작구,2027, 중앙대학교 정문,201906,1041,1070,2111,37.507042,126.959152
동작구,2027, 중앙대학교 정문,201907,1022,1072,2094,37.507042,126.959152
동작구,2027, 중앙대학교 정문,201908,988,1038,2026,37.507042,126.959152
동작구,2027, 중앙대학교 정문,201909,1102,1134,2236,37.507042,126.959152
동작구,2027, 중앙대학교 정문,201910,1052,1122,2174,37.507042,126.959152
동작구,2027, 중앙대학교 정문,201911,590,614,1204,37.507042,126.959152
동작구,2027, 중앙대학교 정문,201912,269,302,571,37.507042,126.959152
동작구,2027, 중앙대학교 정문,202001,215,231,446,37.507042,126.959152
동작구,2027, 중앙대학교 정문,202002,200,210,410,37.507042,126.959152
동작구,2027, 중앙대학교 정문,202003,573,569,1142,37.507042,126.959152
동작구,2027, 중앙대학교 정문,202004,986,974,1960,37.507042,126.959152
동작구,2027, 중앙대학교 정문,202005,1118,1104,2222,37.507042,126.959152
동작구,2027, 중앙대학교 정문,202006,1157,1157,2314,37.507042,126.959152
동작구,2028, 남성역 2번출구 뒷편,201901,271,300,571,#N/A,#N/A
동작구,2028, 남성역 2번출구 뒷편,201902,225,259,484,#N/A,#N/A
동작구,2028, 남성역 2번출구 뒷편,201903,305,334,639,#N/A,#N/A
동작구,2032, 이수역 11번출구쪽,201901,546,679,1225,37.485508,126.981621
동작구,2032, 이수역 11번출구쪽,201902,535,696,1231,37.485508,126.981621
동작구,2032, 이수역 11번출구쪽,201903,905,1170,2075,37.485508,126.981621
동작구,2032, 이수역 11번출구쪽,201904,1430,1827,3257,37.485508,126.981621
동작구,2032, 이수역 11번출구쪽,201905,2220,2593,4813,37.485508,126.981621
동작구,2032, 이수역 11번출구쪽,201906,2337,2601,4938,37.485508,126.981621
동작구,2032, 이수역 11번출구쪽,201907,1242,1324,2566,37.485508,126.981621
동작구,2032, 이수역 11번출구쪽,201909,1291,1347,2638,37.485508,126.981621
동작구,2032, 이수역 11번출구쪽,201910,2334,2488,4822,37.485508,126.981621
동작구,2032, 이수역 11번출구쪽,201911,1578,1782,3360,37.485508,126.981621
동작구,2032, 이수역 11번출구쪽,201912,903,962,1865,37.485508,126.981621
동작구,2032, 이수역 11번출구쪽,202001,794,843,1637,37.485508,126.981621
동작구,2032, 이수역 11번출구쪽,202002,703,750,1453,37.485508,126.981621
동작구,2032, 이수역 11번출구쪽,202003,1229,1234,2463,37.485508,126.981621
동작구,2032, 이수역 11번출구쪽,202004,1682,1758,3440,37.485508,126.981621
동작구,2032, 이수역 11번출구쪽,202005,2015,2017,4032,37.485508,126.981621
동작구,2032, 이수역 11번출구쪽,202006,2230,2298,4528,37.485508,126.981621
동작구,2033, 사당동 아르테스 웨딩앞,201901,247,256,503,37.481491,126.981583
동작구,2033, 사당동 아르테스 웨딩앞,201902,174,213,387,37.481491,126.981583
동작구,2033, 사당동 아르테스 웨딩앞,201903,420,496,916,37.481491,126.981583
동작구,2033, 사당동 아르테스 웨딩앞,201904,577,663,1240,37.481491,126.981583
동작구,2033, 사당동 아르테스 웨딩앞,201905,1132,1233,2365,37.481491,126.981583
동작구,2033, 사당동 아르테스 웨딩앞,201906,1263,1391,2654,37.481491,126.981583
동작구,2033, 사당동 아르테스 웨딩앞,201907,1331,1481,2812,37.481491,126.981583
동작구,2033, 사당동 아르테스 웨딩앞,201908,1232,1375,2607,37.481491,126.981583
동작구,2033, 사당동 아르테스 웨딩앞,201909,1149,1305,2454,37.481491,126.981583
동작구,2033, 사당동 아르테스 웨딩앞,201910,1322,1437,2759,37.481491,126.981583
동작구,2033, 사당동 아르테스 웨딩앞,201911,714,842,1556,37.481491,126.981583
동작구,2033, 사당동 아르테스 웨딩앞,201912,446,497,943,37.481491,126.981583
동작구,2033, 사당동 아르테스 웨딩앞,202001,324,401,725,37.481491,126.981583
동작구,2033, 사당동 아르테스 웨딩앞,202002,453,520,973,37.481491,126.981583
동작구,2033, 사당동 아르테스 웨딩앞,202003,691,734,1425,37.481491,126.981583
동작구,2033, 사당동 아르테스 웨딩앞,202004,1154,1189,2343,37.481491,126.981583
동작구,2033, 사당동 아르테스 웨딩앞,202005,1277,1320,2597,37.481491,126.981583
동작구,2033, 사당동 아르테스 웨딩앞,202006,1468,1515,2983,37.481491,126.981583
동작구,2034, 사당역 7번출구쪽,201901,226,269,495,37.476891,126.980576
동작구,2034, 사당역 7번출구쪽,201902,209,256,465,37.476891,126.980576
동작구,2034, 사당역 7번출구쪽,201903,428,490,918,37.476891,126.980576
동작구,2034, 사당역 7번출구쪽,201904,754,932,1686,37.476891,126.980576
동작구,2034, 사당역 7번출구쪽,201905,1365,1530,2895,37.476891,126.980576
동작구,2034, 사당역 7번출구쪽,201906,1513,1648,3161,37.476891,126.980576
동작구,2034, 사당역 7번출구쪽,201907,1488,1646,3134,37.476891,126.980576
동작구,2034, 사당역 7번출구쪽,201908,1411,1582,2993,37.476891,126.980576
동작구,2034, 사당역 7번출구쪽,201909,1421,1521,2942,37.476891,126.980576
동작구,2034, 사당역 7번출구쪽,201910,1625,1797,3422,37.476891,126.980576
동작구,2034, 사당역 7번출구쪽,201911,938,988,1926,37.476891,126.980576
동작구,2034, 사당역 7번출구쪽,201912,545,603,1148,37.476891,126.980576
동작구,2034, 사당역 7번출구쪽,202001,429,485,914,37.476891,126.980576
동작구,2034, 사당역 7번출구쪽,202002,415,413,828,37.476891,126.980576
동작구,2034, 사당역 7번출구쪽,202003,971,1008,1979,37.476891,126.980576
동작구,2034, 사당역 7번출구쪽,202004,1444,1479,2923,37.476891,126.980576
동작구,2034, 사당역 7번출구쪽,202005,1651,1659,3310,37.476891,126.980576
동작구,2034, 사당역 7번출구쪽,202006,1796,1898,3694,37.476891,126.980576
동작구,2036, 정금마을 마을버스정류장,201901,68,104,172,37.494705,126.982391
동작구,2036, 정금마을 마을버스정류장,201902,86,131,217,37.494705,126.982391
동작구,2036, 정금마을 마을버스정류장,201903,159,172,331,37.494705,126.982391
동작구,2036, 정금마을 마을버스정류장,201904,320,346,666,37.494705,126.982391
동작구,2036, 정금마을 마을버스정류장,201905,522,637,1159,37.494705,126.982391
동작구,2036, 정금마을 마을버스정류장,201906,617,704,1321,37.494705,126.982391
동작구,2036, 정금마을 마을버스정류장,201907,548,588,1136,37.494705,126.982391
동작구,2036, 정금마을 마을버스정류장,201908,600,624,1224,37.494705,126.982391
동작구,2036, 정금마을 마을버스정류장,201909,573,626,1199,37.494705,126.982391
동작구,2036, 정금마을 마을버스정류장,201910,1829,2140,3969,37.494705,126.982391
동작구,2036, 정금마을 마을버스정류장,201911,583,729,1312,37.494705,126.982391
동작구,2036, 정금마을 마을버스정류장,201912,275,321,596,37.494705,126.982391
동작구,2036, 정금마을 마을버스정류장,202001,261,280,541,37.494705,126.982391
동작구,2036, 정금마을 마을버스정류장,202002,256,272,528,37.494705,126.982391
동작구,2036, 정금마을 마을버스정류장,202003,523,527,1050,37.494705,126.982391
동작구,2036, 정금마을 마을버스정류장,202004,753,728,1481,37.494705,126.982391
동작구,2036, 정금마을 마을버스정류장,202005,850,835,1685,37.494705,126.982391
동작구,2036, 정금마을 마을버스정류장,202006,948,983,1931,37.494705,126.982391
동작구,2037, 동작역 5번출구 동작주차공원,201901,60,68,128,37.503189,126.97715
동작구,2037, 동작역 5번출구 동작주차공원,201902,103,113,216,37.503189,126.97715
동작구,2037, 동작역 5번출구 동작주차공원,201903,308,299,607,37.503189,126.97715
동작구,2037, 동작역 5번출구 동작주차공원,201904,717,686,1403,37.503189,126.97715
동작구,2037, 동작역 5번출구 동작주차공원,201905,1076,1049,2125,37.503189,126.97715
동작구,2037, 동작역 5번출구 동작주차공원,201906,1090,1064,2154,37.503189,126.97715
동작구,2037, 동작역 5번출구 동작주차공원,201907,728,704,1432,37.503189,126.97715
동작구,2037, 동작역 5번출구 동작주차공원,201908,838,773,1611,37.503189,126.97715
동작구,2037, 동작역 5번출구 동작주차공원,201909,970,939,1909,37.503189,126.97715
동작구,2037, 동작역 5번출구 동작주차공원,201910,953,889,1842,37.503189,126.97715
동작구,2037, 동작역 5번출구 동작주차공원,201911,382,333,715,37.503189,126.97715
동작구,2037, 동작역 5번출구 동작주차공원,201912,148,146,294,37.503189,126.97715
동작구,2037, 동작역 5번출구 동작주차공원,202001,144,126,270,37.503189,126.97715
동작구,2037, 동작역 5번출구 동작주차공원,202002,220,203,423,37.503189,126.97715
동작구,2037, 동작역 5번출구 동작주차공원,202003,1117,1065,2182,37.503189,126.97715
동작구,2037, 동작역 5번출구 동작주차공원,202004,1374,1345,2719,37.503189,126.97715
동작구,2037, 동작역 5번출구 동작주차공원,202005,1505,1483,2988,37.503189,126.97715
동작구,2037, 동작역 5번출구 동작주차공원,202006,1241,1244,2485,37.503189,126.97715
동작구,2038, 동작역 7번출구,201901,38,45,83,37.503181,126.976089
동작구,2038, 동작역 7번출구,201902,36,55,91,37.503181,126.976089
동작구,2038, 동작역 7번출구,201903,97,93,190,37.503181,126.976089
동작구,2038, 동작역 7번출구,201904,216,208,424,37.503181,126.976089
동작구,2038, 동작역 7번출구,201905,275,271,546,37.503181,126.976089
동작구,2038, 동작역 7번출구,201906,236,227,463,37.503181,126.976089
동작구,2038, 동작역 7번출구,201907,201,182,383,37.503181,126.976089
동작구,2038, 동작역 7번출구,201908,155,152,307,37.503181,126.976089
동작구,2038, 동작역 7번출구,201909,275,256,531,37.503181,126.976089
동작구,2038, 동작역 7번출구,201910,359,346,705,37.503181,126.976089
동작구,2038, 동작역 7번출구,201911,143,144,287,37.503181,126.976089
동작구,2038, 동작역 7번출구,201912,62,58,120,37.503181,126.976089
동작구,2038, 동작역 7번출구,202001,43,50,93,37.503181,126.976089
동작구,2038, 동작역 7번출구,202002,55,57,112,37.503181,126.976089
동작구,2038, 동작역 7번출구,202003,233,225,458,37.503181,126.976089
동작구,2038, 동작역 7번출구,202004,271,253,524,37.503181,126.976089
동작구,2038, 동작역 7번출구,202005,285,276,561,37.503181,126.976089
동작구,2038, 동작역 7번출구,202006,250,245,495,37.503181,126.976089
동작구,2040, 비계 버스정류소,201901,70,54,124,37.506359,126.969078
동작구,2040, 비계 버스정류소,201902,51,31,82,37.506359,126.969078
동작구,2040, 비계 버스정류소,201903,128,91,219,37.506359,126.969078
동작구,2040, 비계 버스정류소,201904,173,107,280,37.506359,126.969078
동작구,2040, 비계 버스정류소,201905,206,174,380,37.506359,126.969078
동작구,2040, 비계 버스정류소,201906,164,160,324,37.506359,126.969078
동작구,2040, 비계 버스정류소,201907,183,170,353,37.506359,126.969078
동작구,2040, 비계 버스정류소,201908,226,197,423,37.506359,126.969078
동작구,2040, 비계 버스정류소,201909,206,188,394,37.506359,126.969078
동작구,2040, 비계 버스정류소,201910,194,147,341,37.506359,126.969078
동작구,2040, 비계 버스정류소,201911,122,64,186,37.506359,126.969078
동작구,2040, 비계 버스정류소,201912,81,47,128,37.506359,126.969078
동작구,2040, 비계 버스정류소,202001,91,57,148,37.506359,126.969078
동작구,2040, 비계 버스정류소,202002,109,85,194,37.506359,126.969078
동작구,2040, 비계 버스정류소,202003,294,240,534,37.506359,126.969078
동작구,2040, 비계 버스정류소,202004,357,296,653,37.506359,126.969078
동작구,2040, 비계 버스정류소,202005,406,322,728,37.506359,126.969078
동작구,2040, 비계 버스정류소,202006,421,360,781,37.506359,126.969078
동작구,2041, 사당중학교 버스정류소,201901,69,46,115,37.486835,126.968048
동작구,2041, 사당중학교 버스정류소,201902,76,62,138,37.486835,126.968048
동작구,2041, 사당중학교 버스정류소,201903,168,155,323,37.486835,126.968048
동작구,2041, 사당중학교 버스정류소,201904,251,239,490,37.486835,126.968048
동작구,2041, 사당중학교 버스정류소,201905,351,353,704,37.486835,126.968048
동작구,2041, 사당중학교 버스정류소,201906,406,396,802,37.486835,126.968048
동작구,2041, 사당중학교 버스정류소,201907,331,315,646,37.486835,126.968048
동작구,2041, 사당중학교 버스정류소,201908,252,245,497,37.486835,126.968048
동작구,2041, 사당중학교 버스정류소,201909,287,280,567,37.486835,126.968048
동작구,2041, 사당중학교 버스정류소,201910,444,398,842,37.486835,126.968048
동작구,2041, 사당중학교 버스정류소,201911,322,275,597,37.486835,126.968048
동작구,2041, 사당중학교 버스정류소,201912,191,169,360,37.486835,126.968048
동작구,2041, 사당중학교 버스정류소,202001,147,148,295,37.486835,126.968048
동작구,2041, 사당중학교 버스정류소,202002,125,118,243,37.486835,126.968048
동작구,2041, 사당중학교 버스정류소,202003,189,178,367,37.486835,126.968048
동작구,2041, 사당중학교 버스정류소,202004,303,257,560,37.486835,126.968048
동작구,2041, 사당중학교 버스정류소,202005,366,336,702,37.486835,126.968048
동작구,2041, 사당중학교 버스정류소,202006,439,404,843,37.486835,126.968048
동작구,2048, 삼일초등학교 인근,201901,381,278,659,37.489087,126.97358
동작구,2048, 삼일초등학교 인근,201902,297,191,488,37.489087,126.97358
동작구,2048, 삼일초등학교 인근,201903,524,304,828,37.489087,126.97358
동작구,2048, 삼일초등학교 인근,201904,711,454,1165,37.489087,126.97358
동작구,2048, 삼일초등학교 인근,201905,890,713,1603,37.489087,126.97358
동작구,2048, 삼일초등학교 인근,201906,842,686,1528,37.489087,126.97358
동작구,2048, 삼일초등학교 인근,201907,734,625,1359,37.489087,126.97358
동작구,2048, 삼일초등학교 인근,201908,681,538,1219,37.489087,126.97358
동작구,2048, 삼일초등학교 인근,201909,667,578,1245,37.489087,126.97358
동작구,2048, 삼일초등학교 인근,201910,848,727,1575,37.489087,126.97358
동작구,2048, 삼일초등학교 인근,201911,569,442,1011,37.489087,126.97358
동작구,2048, 삼일초등학교 인근,201912,274,239,513,37.489087,126.97358
동작구,2048, 삼일초등학교 인근,202001,244,220,464,37.489087,126.97358
동작구,2048, 삼일초등학교 인근,202002,210,200,410,37.489087,126.97358
동작구,2048, 삼일초등학교 인근,202003,347,333,680,37.489087,126.97358
동작구,2048, 삼일초등학교 인근,202004,582,517,1099,37.489087,126.97358
동작구,2048, 삼일초등학교 인근,202005,654,595,1249,37.489087,126.97358
동작구,2048, 삼일초등학교 인근,202006,926,768,1694,37.489087,126.97358
동작구,2050, 노량진역 5번출구,201901,727,980,1707,37.513248,126.939972
동작구,2050, 노량진역 5번출구,201902,646,884,1530,37.513248,126.939972
동작구,2050, 노량진역 5번출구,201903,1142,1609,2751,37.513248,126.939972
동작구,2050, 노량진역 5번출구,201904,1720,2256,3976,37.513248,126.939972
동작구,2050, 노량진역 5번출구,201905,2801,3399,6200,37.513248,126.939972
동작구,2050, 노량진역 5번출구,201906,3121,3643,6764,37.513248,126.939972
동작구,2050, 노량진역 5번출구,201907,3259,3680,6939,37.513248,126.939972
동작구,2050, 노량진역 5번출구,201908,2890,3637,6527,37.513248,126.939972
동작구,2050, 노량진역 5번출구,201909,2693,3254,5947,37.513248,126.939972
동작구,2050, 노량진역 5번출구,201910,3423,4053,7476,37.513248,126.939972
동작구,2050, 노량진역 5번출구,201911,1908,2470,4378,37.513248,126.939972
동작구,2050, 노량진역 5번출구,201912,1110,1487,2597,37.513248,126.939972
동작구,2050, 노량진역 5번출구,202001,1112,1468,2580,37.513248,126.939972
동작구,2050, 노량진역 5번출구,202002,1019,1304,2323,37.513248,126.939972
동작구,2050, 노량진역 5번출구,202003,2022,2194,4216,37.513248,126.939972
동작구,2050, 노량진역 5번출구,202004,3056,3247,6303,37.513248,126.939972
동작구,2050, 노량진역 5번출구,202005,3368,3500,6868,37.513248,126.939972
동작구,2050, 노량진역 5번출구,202006,3599,3984,7583,37.513248,126.939972
동작구,2054, 삼익아파트,201901,255,233,488,37.510548,126.944847
동작구,2054, 삼익아파트,201902,267,219,486,37.510548,126.944847
동작구,2054, 삼익아파트,201903,571,518,1089,37.510548,126.944847
동작구,2054, 삼익아파트,201904,701,651,1352,37.510548,126.944847
동작구,2054, 삼익아파트,201905,1053,1013,2066,37.510548,126.944847
동작구,2054, 삼익아파트,201906,1295,1303,2598,37.510548,126.944847
동작구,2054, 삼익아파트,201907,1432,1425,2857,37.510548,126.944847
동작구,2054, 삼익아파트,201908,1488,1444,2932,37.510548,126.944847
동작구,2054, 삼익아파트,201909,1288,1298,2586,37.510548,126.944847
동작구,2054, 삼익아파트,201910,1430,1375,2805,37.510548,126.944847
동작구,2054, 삼익아파트,201911,1006,968,1974,37.510548,126.944847
동작구,2054, 삼익아파트,201912,475,458,933,37.510548,126.944847
동작구,2054, 삼익아파트,202001,344,351,695,37.510548,126.944847
동작구,2054, 삼익아파트,202002,354,340,694,37.510548,126.944847
동작구,2054, 삼익아파트,202003,802,784,1586,37.510548,126.944847
동작구,2054, 삼익아파트,202004,1221,1200,2421,37.510548,126.944847
동작구,2054, 삼익아파트,202005,1210,1220,2430,37.510548,126.944847
동작구,2054, 삼익아파트,202006,1563,1538,3101,37.510548,126.944847
동작구,2056, 동작구민 체육센터,201901,506,496,1002,37.494499,126.916527
동작구,2056, 동작구민 체육센터,201902,416,399,815,37.494499,126.916527
동작구,2056, 동작구민 체육센터,201903,621,628,1249,37.494499,126.916527
동작구,2056, 동작구민 체육센터,201904,1075,1073,2148,37.494499,126.916527
동작구,2056, 동작구민 체육센터,201905,1546,1589,3135,37.494499,126.916527
동작구,2056, 동작구민 체육센터,201906,1632,1626,3258,37.494499,126.916527
동작구,2056, 동작구민 체육센터,201907,1533,1515,3048,37.494499,126.916527
동작구,2056, 동작구민 체육센터,201908,1475,1475,2950,37.494499,126.916527
동작구,2056, 동작구민 체육센터,201909,1399,1389,2788,37.494499,126.916527
동작구,2056, 동작구민 체육센터,201910,1579,1566,3145,37.494499,126.916527
동작구,2056, 동작구민 체육센터,201911,1102,1085,2187,37.494499,126.916527
동작구,2056, 동작구민 체육센터,201912,668,655,1323,37.494499,126.916527
동작구,2056, 동작구민 체육센터,202001,639,596,1235,37.494499,126.916527
동작구,2056, 동작구민 체육센터,202002,574,519,1093,37.494499,126.916527
동작구,2056, 동작구민 체육센터,202003,709,694,1403,37.494499,126.916527
동작구,2056, 동작구민 체육센터,202004,1044,1043,2087,37.494499,126.916527
동작구,2056, 동작구민 체육센터,202005,1238,1236,2474,37.494499,126.916527
동작구,2056, 동작구민 체육센터,202006,1275,1269,2544,37.494499,126.916527
동작구,2057, 상도 아이파크 아파트,201901,123,73,196,37.500881,126.94175
동작구,2057, 상도 아이파크 아파트,201902,190,85,275,37.500881,126.94175
동작구,2057, 상도 아이파크 아파트,201903,292,153,445,37.500881,126.94175
동작구,2057, 상도 아이파크 아파트,201904,467,226,693,37.500881,126.94175
동작구,2057, 상도 아이파크 아파트,201905,509,292,801,37.500881,126.94175
동작구,2057, 상도 아이파크 아파트,201906,434,313,747,37.500881,126.94175
동작구,2057, 상도 아이파크 아파트,201907,434,315,749,37.500881,126.94175
동작구,2057, 상도 아이파크 아파트,201908,532,302,834,37.500881,126.94175
동작구,2057, 상도 아이파크 아파트,201909,447,278,725,37.500881,126.94175
동작구,2057, 상도 아이파크 아파트,201910,639,304,943,37.500881,126.94175
동작구,2057, 상도 아이파크 아파트,201911,495,220,715,37.500881,126.94175
동작구,2057, 상도 아이파크 아파트,201912,290,134,424,37.500881,126.94175
동작구,2057, 상도 아이파크 아파트,202001,234,127,361,37.500881,126.94175
동작구,2057, 상도 아이파크 아파트,202002,237,120,357,37.500881,126.94175
동작구,2057, 상도 아이파크 아파트,202003,358,227,585,37.500881,126.94175
동작구,2057, 상도 아이파크 아파트,202004,525,371,896,37.500881,126.94175
동작구,2057, 상도 아이파크 아파트,202005,408,363,771,37.500881,126.94175
동작구,2057, 상도 아이파크 아파트,202006,593,391,984,37.500881,126.94175
동작구,2058, 노량진동 맥도널드앞,201901,439,545,984,37.513523,126.943527
동작구,2058, 노량진동 맥도널드앞,201902,482,535,1017,37.513523,126.943527
동작구,2058, 노량진동 맥도널드앞,201903,968,1166,2134,37.513523,126.943527
동작구,2058, 노량진동 맥도널드앞,201904,1397,1679,3076,37.513523,126.943527
동작구,2058, 노량진동 맥도널드앞,201905,2279,2484,4763,37.513523,126.943527
동작구,2058, 노량진동 맥도널드앞,201906,2402,2448,4850,37.513523,126.943527
동작구,2058, 노량진동 맥도널드앞,201907,2311,2383,4694,37.513523,126.943527
동작구,2058, 노량진동 맥도널드앞,201908,2319,2379,4698,37.513523,126.943527
동작구,2058, 노량진동 맥도널드앞,201909,2366,2383,4749,37.513523,126.943527
동작구,2058, 노량진동 맥도널드앞,201910,2622,2673,5295,37.513523,126.943527
동작구,2058, 노량진동 맥도널드앞,201911,1615,1667,3282,37.513523,126.943527
동작구,2058, 노량진동 맥도널드앞,201912,859,984,1843,37.513523,126.943527
동작구,2058, 노량진동 맥도널드앞,202001,869,951,1820,37.513523,126.943527
동작구,2058, 노량진동 맥도널드앞,202002,814,936,1750,37.513523,126.943527
동작구,2058, 노량진동 맥도널드앞,202003,1531,1544,3075,37.513523,126.943527
동작구,2058, 노량진동 맥도널드앞,202004,2413,2408,4821,37.513523,126.943527
동작구,2058, 노량진동 맥도널드앞,202005,2787,2796,5583,37.513523,126.943527
동작구,2058, 노량진동 맥도널드앞,202006,2965,3006,5971,37.513523,126.943527
동작구,2059, 보라매공원 정문,201901,341,316,657,37.497078,126.917793
동작구,2059, 보라매공원 정문,201902,346,383,729,37.497078,126.917793
동작구,2059, 보라매공원 정문,201903,613,666,1279,37.497078,126.917793
동작구,2059, 보라매공원 정문,201904,983,1050,2033,37.497078,126.917793
동작구,2059, 보라매공원 정문,201905,1626,1685,3311,37.497078,126.917793
동작구,2059, 보라매공원 정문,201906,1707,1764,3471,37.497078,126.917793
동작구,2059, 보라매공원 정문,201907,1749,1787,3536,37.497078,126.917793
동작구,2059, 보라매공원 정문,201908,1629,1679,3308,37.497078,126.917793
동작구,2059, 보라매공원 정문,201909,1560,1579,3139,37.497078,126.917793
동작구,2059, 보라매공원 정문,201910,1642,1652,3294,37.497078,126.917793
동작구,2059, 보라매공원 정문,201911,973,1041,2014,37.497078,126.917793
동작구,2059, 보라매공원 정문,201912,644,650,1294,37.497078,126.917793
동작구,2059, 보라매공원 정문,202001,552,550,1102,37.497078,126.917793
동작구,2059, 보라매공원 정문,202002,572,597,1169,37.497078,126.917793
동작구,2059, 보라매공원 정문,202003,1040,1041,2081,37.497078,126.917793
동작구,2059, 보라매공원 정문,202004,1793,1808,3601,37.497078,126.917793
동작구,2059, 보라매공원 정문,202005,2067,2079,4146,37.497078,126.917793
동작구,2059, 보라매공원 정문,202006,2251,2282,4533,37.497078,126.917793
동작구,2060, 남성역3번출구 뒤,201901,160,156,316,37.484631,126.97155
동작구,2060, 남성역3번출구 뒤,201902,147,180,327,37.484631,126.97155
동작구,2060, 남성역3번출구 뒤,201903,379,456,835,37.484631,126.97155
동작구,2060, 남성역3번출구 뒤,201904,926,1308,2234,37.484631,126.97155
동작구,2060, 남성역3번출구 뒤,201905,1349,1937,3286,37.484631,126.97155
동작구,2060, 남성역3번출구 뒤,201906,1420,2044,3464,37.484631,126.97155
동작구,2060, 남성역3번출구 뒤,201907,1310,1940,3250,37.484631,126.97155
동작구,2060, 남성역3번출구 뒤,201908,1270,1906,3176,37.484631,126.97155
동작구,2060, 남성역3번출구 뒤,201909,1360,1790,3150,37.484631,126.97155
동작구,2060, 남성역3번출구 뒤,201910,1537,2109,3646,37.484631,126.97155
동작구,2060, 남성역3번출구 뒤,201911,922,1173,2095,37.484631,126.97155
동작구,2060, 남성역3번출구 뒤,201912,580,727,1307,37.484631,126.97155
동작구,2060, 남성역3번출구 뒤,202001,367,417,784,37.484631,126.97155
동작구,2060, 남성역3번출구 뒤,202002,476,515,991,37.484631,126.97155
동작구,2060, 남성역3번출구 뒤,202003,931,1029,1960,37.484631,126.97155
동작구,2060, 남성역3번출구 뒤,202004,1310,1664,2974,37.484631,126.97155
동작구,2060, 남성역3번출구 뒤,202005,1629,1929,3558,37.484631,126.97155
동작구,2060, 남성역3번출구 뒤,202006,1794,2121,3915,37.484631,126.97155
동작구,2061, 한강 현대아파트 건너편,201901,54,49,103,37.505928,126.969231
동작구,2061, 한강 현대아파트 건너편,201902,47,23,70,37.505928,126.969231
동작구,2061, 한강 현대아파트 건너편,201903,78,40,118,37.505928,126.969231
동작구,2061, 한강 현대아파트 건너편,201904,133,70,203,37.505928,126.969231
동작구,2061, 한강 현대아파트 건너편,201905,154,132,286,37.505928,126.969231
동작구,2061, 한강 현대아파트 건너편,201906,123,111,234,37.505928,126.969231
동작구,2061, 한강 현대아파트 건너편,201907,165,141,306,37.505928,126.969231
동작구,2061, 한강 현대아파트 건너편,201908,135,103,238,37.505928,126.969231
동작구,2061, 한강 현대아파트 건너편,201909,147,117,264,37.505928,126.969231
동작구,2061, 한강 현대아파트 건너편,201910,216,153,369,37.505928,126.969231
동작구,2061, 한강 현대아파트 건너편,201911,158,77,235,37.505928,126.969231
동작구,2061, 한강 현대아파트 건너편,201912,81,39,120,37.505928,126.969231
동작구,2061, 한강 현대아파트 건너편,202001,119,67,186,37.505928,126.969231
동작구,2061, 한강 현대아파트 건너편,202002,78,46,124,37.505928,126.969231
동작구,2061, 한강 현대아파트 건너편,202003,139,57,196,37.505928,126.969231
동작구,2061, 한강 현대아파트 건너편,202004,184,74,258,37.505928,126.969231
동작구,2061, 한강 현대아파트 건너편,202005,202,108,310,37.505928,126.969231
동작구,2061, 한강 현대아파트 건너편,202006,223,130,353,37.505928,126.969231
동작구,2062, 사당새마을금고,201901,82,66,148,37.486652,126.967842
동작구,2062, 사당새마을금고,201902,101,72,173,37.486652,126.967842
동작구,2062, 사당새마을금고,201903,180,160,340,37.486652,126.967842
동작구,2062, 사당새마을금고,201904,218,195,413,37.486652,126.967842
동작구,2062, 사당새마을금고,201905,306,304,610,37.486652,126.967842
동작구,2062, 사당새마을금고,201906,320,296,616,37.486652,126.967842
동작구,2062, 사당새마을금고,201907,403,394,797,37.486652,126.967842
동작구,2062, 사당새마을금고,201908,355,370,725,37.486652,126.967842
동작구,2062, 사당새마을금고,201909,379,351,730,37.486652,126.967842
동작구,2062, 사당새마을금고,201910,465,425,890,37.486652,126.967842
동작구,2062, 사당새마을금고,201911,323,305,628,37.486652,126.967842
동작구,2062, 사당새마을금고,201912,180,161,341,37.486652,126.967842
동작구,2062, 사당새마을금고,202001,146,144,290,37.486652,126.967842
동작구,2062, 사당새마을금고,202002,121,99,220,37.486652,126.967842
동작구,2062, 사당새마을금고,202003,193,189,382,37.486652,126.967842
동작구,2062, 사당새마을금고,202004,349,317,666,37.486652,126.967842
동작구,2062, 사당새마을금고,202005,448,419,867,37.486652,126.967842
동작구,2062, 사당새마을금고,202006,479,437,916,37.486652,126.967842
동작구,2063, 대방역 4번출구,201901,476,434,910,37.512901,126.926613
동작구,2063, 대방역 4번출구,201902,409,421,830,37.512901,126.926613
동작구,2063, 대방역 4번출구,201903,743,736,1479,37.512901,126.926613
동작구,2063, 대방역 4번출구,201904,1048,1059,2107,37.512901,126.926613
동작구,2063, 대방역 4번출구,201905,1670,1675,3345,37.512901,126.926613
동작구,2063, 대방역 4번출구,201906,1709,1720,3429,37.512901,126.926613
동작구,2063, 대방역 4번출구,201907,1803,1824,3627,37.512901,126.926613
동작구,2063, 대방역 4번출구,201908,1572,1611,3183,37.512901,126.926613
동작구,2063, 대방역 4번출구,201909,1488,1482,2970,37.512901,126.926613
동작구,2063, 대방역 4번출구,201910,1931,1932,3863,37.512901,126.926613
동작구,2063, 대방역 4번출구,201911,1341,1384,2725,37.512901,126.926613
동작구,2063, 대방역 4번출구,201912,710,718,1428,37.512901,126.926613
동작구,2063, 대방역 4번출구,202001,580,570,1150,37.512901,126.926613
동작구,2063, 대방역 4번출구,202002,646,655,1301,37.512901,126.926613
동작구,2063, 대방역 4번출구,202003,1165,1175,2340,37.512901,126.926613
동작구,2063, 대방역 4번출구,202004,1776,1757,3533,37.512901,126.926613
동작구,2063, 대방역 4번출구,202005,1766,1770,3536,37.512901,126.926613
동작구,2063, 대방역 4번출구,202006,1882,1854,3736,37.512901,126.926613
동작구,2064, 흑석한강푸르지오 106동앞,201901,107,48,155,37.505356,126.966179
동작구,2064, 흑석한강푸르지오 106동앞,201902,74,37,111,37.505356,126.966179
동작구,2064, 흑석한강푸르지오 106동앞,201903,104,44,148,37.505356,126.966179
동작구,2064, 흑석한강푸르지오 106동앞,201904,157,77,234,37.505356,126.966179
동작구,2064, 흑석한강푸르지오 106동앞,201905,232,216,448,37.505356,126.966179
동작구,2064, 흑석한강푸르지오 106동앞,201906,241,237,478,37.505356,126.966179
동작구,2064, 흑석한강푸르지오 106동앞,201907,227,198,425,37.505356,126.966179
동작구,2064, 흑석한강푸르지오 106동앞,201908,211,173,384,37.505356,126.966179
동작구,2064, 흑석한강푸르지오 106동앞,201909,209,173,382,37.505356,126.966179
동작구,2064, 흑석한강푸르지오 106동앞,201910,257,199,456,37.505356,126.966179
동작구,2064, 흑석한강푸르지오 106동앞,201911,195,149,344,37.505356,126.966179
동작구,2064, 흑석한강푸르지오 106동앞,201912,77,46,123,37.505356,126.966179
동작구,2064, 흑석한강푸르지오 106동앞,202001,104,50,154,37.505356,126.966179
동작구,2064, 흑석한강푸르지오 106동앞,202002,114,58,172,37.505356,126.966179
동작구,2064, 흑석한강푸르지오 106동앞,202003,224,152,376,37.505356,126.966179
동작구,2064, 흑석한강푸르지오 106동앞,202004,335,226,561,37.505356,126.966179
동작구,2064, 흑석한강푸르지오 106동앞,202005,352,255,607,37.505356,126.966179
동작구,2064, 흑석한강푸르지오 106동앞,202006,424,279,703,37.505356,126.966179
동작구,2065, 서울시여성가족재단,201901,232,284,516,37.51199,126.927086
동작구,2065, 서울시여성가족재단,201902,184,204,388,37.51199,126.927086
동작구,2065, 서울시여성가족재단,201903,489,488,977,37.51199,126.927086
동작구,2065, 서울시여성가족재단,201904,809,745,1554,37.51199,126.927086
동작구,2065, 서울시여성가족재단,201905,1069,1082,2151,37.51199,126.927086
동작구,2065, 서울시여성가족재단,201906,1085,1072,2157,37.51199,126.927086
동작구,2065, 서울시여성가족재단,201907,1268,1277,2545,37.51199,126.927086
동작구,2065, 서울시여성가족재단,201908,1130,1187,2317,37.51199,126.927086
동작구,2065, 서울시여성가족재단,201909,1035,993,2028,37.51199,126.927086
동작구,2065, 서울시여성가족재단,201910,1251,1223,2474,37.51199,126.927086
동작구,2065, 서울시여성가족재단,201911,858,854,1712,37.51199,126.927086
동작구,2065, 서울시여성가족재단,201912,529,545,1074,37.51199,126.927086
동작구,2065, 서울시여성가족재단,202001,432,429,861,37.51199,126.927086
동작구,2065, 서울시여성가족재단,202002,408,418,826,37.51199,126.927086
동작구,2065, 서울시여성가족재단,202003,689,672,1361,37.51199,126.927086
동작구,2065, 서울시여성가족재단,202004,1075,1049,2124,37.51199,126.927086
동작구,2065, 서울시여성가족재단,202005,1107,1075,2182,37.51199,126.927086
동작구,2065, 서울시여성가족재단,202006,1159,1138,2297,37.51199,126.927086
동작구,2066, 양문교회 앞,201901,471,567,1038,37.489399,126.907112
동작구,2066, 양문교회 앞,201902,317,432,749,37.489399,126.907112
동작구,2066, 양문교회 앞,201903,613,726,1339,37.489399,126.907112
동작구,2066, 양문교회 앞,201904,925,976,1901,37.489399,126.907112
동작구,2066, 양문교회 앞,201905,1533,1623,3156,37.489399,126.907112
동작구,2066, 양문교회 앞,201906,1950,2054,4004,37.489399,126.907112
동작구,2066, 양문교회 앞,201907,2224,2299,4523,37.489399,126.907112
동작구,2066, 양문교회 앞,201908,2093,2257,4350,37.489399,126.907112
동작구,2066, 양문교회 앞,201909,1809,1974,3783,37.489399,126.907112
동작구,2066, 양문교회 앞,201910,2454,2803,5257,37.489399,126.907112
동작구,2066, 양문교회 앞,201911,1629,1927,3556,37.489399,126.907112
동작구,2066, 양문교회 앞,201912,1218,1467,2685,37.489399,126.907112
동작구,2066, 양문교회 앞,202001,998,1206,2204,37.489399,126.907112
동작구,2066, 양문교회 앞,202002,796,889,1685,37.489399,126.907112
동작구,2066, 양문교회 앞,202003,719,733,1452,37.489399,126.907112
동작구,2066, 양문교회 앞,202004,1254,1252,2506,37.489399,126.907112
동작구,2066, 양문교회 앞,202005,1604,1586,3190,37.489399,126.907112
동작구,2066, 양문교회 앞,202006,2114,2116,4230,37.489399,126.907112
동작구,2067, LG전자 베스트? 대리점 앞,201901,256,260,516,37.497669,126.919868
동작구,2067, LG전자 베스트? 대리점 앞,201902,228,248,476,37.497669,126.919868
동작구,2067, LG전자 베스트? 대리점 앞,201903,385,437,822,37.497669,126.919868
동작구,2067, LG전자 베스트? 대리점 앞,201904,708,747,1455,37.497669,126.919868
동작구,2067, LG전자 베스트? 대리점 앞,201905,1287,1305,2592,37.497669,126.919868
동작구,2067, LG전자 베스트? 대리점 앞,201906,1457,1469,2926,37.497669,126.919868
동작구,2067, LG전자 베스트? 대리점 앞,201907,1375,1413,2788,37.497669,126.919868
동작구,2067, LG전자 베스트? 대리점 앞,201908,1259,1294,2553,37.497669,126.919868
동작구,2067, LG전자 베스트? 대리점 앞,201909,1210,1213,2423,37.497669,126.919868
동작구,2067, LG전자 베스트? 대리점 앞,201910,1444,1435,2879,37.497669,126.919868
동작구,2067, LG전자 베스트? 대리점 앞,201911,979,999,1978,37.497669,126.919868
동작구,2067, LG전자 베스트? 대리점 앞,201912,533,540,1073,37.497669,126.919868
동작구,2067, LG전자 베스트? 대리점 앞,202001,413,424,837,37.497669,126.919868
동작구,2067, LG전자 베스트? 대리점 앞,202002,426,443,869,37.497669,126.919868
동작구,2067, LG전자 베스트? 대리점 앞,202003,700,698,1398,37.497669,126.919868
동작구,2067, LG전자 베스트? 대리점 앞,202004,1003,1002,2005,37.497669,126.919868
동작구,2067, LG전자 베스트? 대리점 앞,202005,1117,1116,2233,37.497669,126.919868
동작구,2067, LG전자 베스트? 대리점 앞,202006,1236,1264,2500,37.497669,126.919868
동작구,2068, 총신대 앞(육교),201901,48,22,70,37.488159,126.966476
동작구,2068, 총신대 앞(육교),201902,59,15,74,37.488159,126.966476
동작구,2068, 총신대 앞(육교),201903,134,54,188,37.488159,126.966476
동작구,2068, 총신대 앞(육교),201904,242,123,365,37.488159,126.966476
동작구,2068, 총신대 앞(육교),201905,177,135,312,37.488159,126.966476
동작구,2068, 총신대 앞(육교),201906,154,149,303,37.488159,126.966476
동작구,2068, 총신대 앞(육교),201907,122,120,242,37.488159,126.966476
동작구,2068, 총신대 앞(육교),201908,88,86,174,37.488159,126.966476
동작구,2068, 총신대 앞(육교),201909,107,91,198,37.488159,126.966476
동작구,2068, 총신대 앞(육교),201910,125,93,218,37.488159,126.966476
동작구,2068, 총신대 앞(육교),201911,152,51,203,37.488159,126.966476
동작구,2068, 총신대 앞(육교),201912,60,24,84,37.488159,126.966476
동작구,2068, 총신대 앞(육교),202001,32,19,51,37.488159,126.966476
동작구,2068, 총신대 앞(육교),202002,52,40,92,37.488159,126.966476
동작구,2068, 총신대 앞(육교),202003,104,98,202,37.488159,126.966476
동작구,2068, 총신대 앞(육교),202004,160,121,281,37.488159,126.966476
동작구,2068, 총신대 앞(육교),202005,150,133,283,37.488159,126.966476
동작구,2068, 총신대 앞(육교),202006,166,115,281,37.488159,126.966476
동작구,2069, 숭실대 입구역3번 출구 앞,201901,176,129,305,37.496601,126.953682
동작구,2069, 숭실대 입구역3번 출구 앞,201902,181,105,286,37.496601,126.953682
동작구,2069, 숭실대 입구역3번 출구 앞,201903,434,286,720,37.496601,126.953682
동작구,2069, 숭실대 입구역3번 출구 앞,201904,881,559,1440,37.496601,126.953682
동작구,2069, 숭실대 입구역3번 출구 앞,201905,1016,793,1809,37.496601,126.953682
동작구,2069, 숭실대 입구역3번 출구 앞,201906,1021,863,1884,37.496601,126.953682
동작구,2069, 숭실대 입구역3번 출구 앞,201907,780,684,1464,37.496601,126.953682
동작구,2069, 숭실대 입구역3번 출구 앞,201908,749,653,1402,37.496601,126.953682
동작구,2069, 숭실대 입구역3번 출구 앞,201909,798,707,1505,37.496601,126.953682
동작구,2069, 숭실대 입구역3번 출구 앞,201910,928,800,1728,37.496601,126.953682
동작구,2069, 숭실대 입구역3번 출구 앞,201911,583,459,1042,37.496601,126.953682
동작구,2069, 숭실대 입구역3번 출구 앞,201912,273,201,474,37.496601,126.953682
동작구,2069, 숭실대 입구역3번 출구 앞,202001,309,208,517,37.496601,126.953682
동작구,2069, 숭실대 입구역3번 출구 앞,202002,267,200,467,37.496601,126.953682
동작구,2069, 숭실대 입구역3번 출구 앞,202003,616,550,1166,37.496601,126.953682
동작구,2069, 숭실대 입구역3번 출구 앞,202004,939,793,1732,37.496601,126.953682
동작구,2069, 숭실대 입구역3번 출구 앞,202005,994,866,1860,37.496601,126.953682
동작구,2069, 숭실대 입구역3번 출구 앞,202006,959,800,1759,37.496601,126.953682
동작구,2070, 노량진역 2번 출구 앞,201901,193,240,433,37.51392,126.943069
동작구,2070, 노량진역 2번 출구 앞,201902,228,250,478,37.51392,126.943069
동작구,2070, 노량진역 2번 출구 앞,201903,541,591,1132,37.51392,126.943069
동작구,2070, 노량진역 2번 출구 앞,201904,991,1031,2022,37.51392,126.943069
동작구,2070, 노량진역 2번 출구 앞,201905,1903,1924,3827,37.51392,126.943069
동작구,2070, 노량진역 2번 출구 앞,201906,2069,2085,4154,37.51392,126.943069
동작구,2070, 노량진역 2번 출구 앞,201907,1958,1969,3927,37.51392,126.943069
동작구,2070, 노량진역 2번 출구 앞,201908,1827,1850,3677,37.51392,126.943069
동작구,2070, 노량진역 2번 출구 앞,201909,1882,1924,3806,37.51392,126.943069
동작구,2070, 노량진역 2번 출구 앞,201910,2327,2402,4729,37.51392,126.943069
동작구,2070, 노량진역 2번 출구 앞,201911,1151,1247,2398,37.51392,126.943069
동작구,2070, 노량진역 2번 출구 앞,201912,513,577,1090,37.51392,126.943069
동작구,2070, 노량진역 2번 출구 앞,202001,474,510,984,37.51392,126.943069
동작구,2070, 노량진역 2번 출구 앞,202002,488,572,1060,37.51392,126.943069
동작구,2070, 노량진역 2번 출구 앞,202003,1378,1416,2794,37.51392,126.943069
동작구,2070, 노량진역 2번 출구 앞,202004,1946,1957,3903,37.51392,126.943069
동작구,2070, 노량진역 2번 출구 앞,202005,1984,1980,3964,37.51392,126.943069
동작구,2070, 노량진역 2번 출구 앞,202006,2045,2043,4088,37.51392,126.943069
동작구,2071, 대림아파트 후문 상가 옆,201903,37,6,43,37.488869,126.971909
동작구,2071, 대림아파트 후문 상가 옆,201904,411,145,556,37.488869,126.971909
동작구,2071, 대림아파트 후문 상가 옆,201905,444,197,641,37.488869,126.971909
동작구,2071, 대림아파트 후문 상가 옆,201906,412,197,609,37.488869,126.971909
동작구,2071, 대림아파트 후문 상가 옆,201907,442,242,684,37.488869,126.971909
동작구,2071, 대림아파트 후문 상가 옆,201908,371,170,541,37.488869,126.971909
동작구,2071, 대림아파트 후문 상가 옆,201909,300,165,465,37.488869,126.971909
동작구,2071, 대림아파트 후문 상가 옆,201910,439,212,651,37.488869,126.971909
동작구,2071, 대림아파트 후문 상가 옆,201911,293,108,401,37.488869,126.971909
동작구,2071, 대림아파트 후문 상가 옆,201912,136,73,209,37.488869,126.971909
동작구,2071, 대림아파트 후문 상가 옆,202001,62,52,114,37.488869,126.971909
동작구,2071, 대림아파트 후문 상가 옆,202002,52,43,95,37.488869,126.971909
동작구,2071, 대림아파트 후문 상가 옆,202003,109,91,200,37.488869,126.971909
동작구,2071, 대림아파트 후문 상가 옆,202004,259,136,395,37.488869,126.971909
동작구,2071, 대림아파트 후문 상가 옆,202005,276,202,478,37.488869,126.971909
동작구,2071, 대림아파트 후문 상가 옆,202006,350,178,528,37.488869,126.971909
동작구,2073,동작상떼빌 103동 앞,202005,1,1,2,#N/A,#N/A
동작구,2073,동작상떼빌 103동 앞,202006,1,1,2,#N/A,#N/A
동작구,2076,노들나루공원 입구,202006,1728,1755,3483,37.513577,126.955551
동작구,2077,노들역 3번출구,202006,370,370,740,37.511936,126.954163
동작구,2080,빕스 대방점 앞,202005,1,1,2,37.512135,126.925438
동작구,2080,빕스 대방점 앞,202006,255,208,463,37.512135,126.925438
동작구,2081,대방1차 e편한세상 앞,202005,1,1,2,37.513062,126.929512
동작구,2081,대방1차 e편한세상 앞,202006,318,304,622,37.513062,126.929512
동작구,2082,7호선 이수역7번출구,202005,6,6,12,37.485615,126.981979
동작구,2082,7호선 이수역7번출구,202006,17,19,36,37.485615,126.981979
동작구,2083,흑석롯데캐슬에듀포레(107동),202006,10,6,16,37.504704,126.960732
동작구,2084,e편한세상 상도노빌리티 앞,202006,280,276,556,37.504562,126.946785
동작구,2085,강남중학교 앞,202005,1,1,2,37.502743,126.921578
동작구,2085,강남중학교 앞,202006,266,257,523,37.502743,126.921578
동작구,2086,삼일수영장 앞,202006,46,40,86,37.487412,126.974739
동작구,2088,상도중앙하이츠빌 입구,202006,195,156,351,37.500248,126.94973
동작구,2089,사당역10번출구(금강빌딩),202005,1,1,2,37.479107,126.981506
동작구,2089,사당역10번출구(금강빌딩),202006,282,280,562,37.479107,126.981506
동작구,2090,기아자동차 사당점 앞,202005,0,1,1,37.48378,126.977921
동작구,2090,기아자동차 사당점 앞,202006,235,220,455,37.48378,126.977921
동작구,2091,이수역9번출구(맥도날드),202005,1,1,2,37.484135,126.977882
동작구,2091,이수역9번출구(맥도날드),202006,217,210,427,37.484135,126.977882
동작구,2092,흑석한강푸르지오(110동),202006,103,37,140,37.503113,126.964714
동작구,2093,상도SH빌아파트 입구,202006,34,25,59,37.503212,126.954598
동작구,2094,숭실대학교(중문),202006,77,33,110,37.495506,126.956375
동작구,2095,경문고등학교 앞,202006,208,204,412,37.491501,126.982407
동작구,2096,서울특별시 동작관악교육지원청,202006,34,19,53,37.502838,126.940338
관악구,2102, 봉림교 교통섬,201901,1414,1463,2877,37.48423,126.926392
관악구,2102, 봉림교 교통섬,201902,1365,1380,2745,37.48423,126.926392
관악구,2102, 봉림교 교통섬,201903,3212,3235,6447,37.48423,126.926392
관악구,2102, 봉림교 교통섬,201904,5362,5617,10979,37.48423,126.926392
관악구,2102, 봉림교 교통섬,201905,9366,9604,18970,37.48423,126.926392
관악구,2102, 봉림교 교통섬,201906,10049,10097,20146,37.48423,126.926392
관악구,2102, 봉림교 교통섬,201907,8808,8802,17610,37.48423,126.926392
관악구,2102, 봉림교 교통섬,201908,8242,8261,16503,37.48423,126.926392
관악구,2102, 봉림교 교통섬,201909,7678,7690,15368,37.48423,126.926392
관악구,2102, 봉림교 교통섬,201910,8911,8926,17837,37.48423,126.926392
관악구,2102, 봉림교 교통섬,201911,4805,4824,9629,37.48423,126.926392
관악구,2102, 봉림교 교통섬,201912,2340,2392,4732,37.48423,126.926392
관악구,2102, 봉림교 교통섬,202001,2292,2287,4579,37.48423,126.926392
관악구,2102, 봉림교 교통섬,202002,2418,2435,4853,37.48423,126.926392
관악구,2102, 봉림교 교통섬,202003,5164,5140,10304,37.48423,126.926392
관악구,2102, 봉림교 교통섬,202004,8832,8779,17611,37.48423,126.926392
관악구,2102, 봉림교 교통섬,202005,9927,9889,19816,37.48423,126.926392
관악구,2102, 봉림교 교통섬,202006,11414,11442,22856,37.48423,126.926392
관악구,2103, 신림동 우방아파트,201901,415,406,821,37.489178,126.919273
관악구,2103, 신림동 우방아파트,201902,344,346,690,37.489178,126.919273
관악구,2103, 신림동 우방아파트,201903,697,693,1390,37.489178,126.919273
관악구,2103, 신림동 우방아파트,201904,1067,1066,2133,37.489178,126.919273
관악구,2103, 신림동 우방아파트,201905,1451,1458,2909,37.489178,126.919273
관악구,2103, 신림동 우방아파트,201906,1579,1597,3176,37.489178,126.919273
관악구,2103, 신림동 우방아파트,201907,1762,1867,3629,37.489178,126.919273
관악구,2103, 신림동 우방아파트,201908,1794,1948,3742,37.489178,126.919273
관악구,2103, 신림동 우방아파트,201909,1634,1695,3329,37.489178,126.919273
관악구,2103, 신림동 우방아파트,201910,1772,1797,3569,37.489178,126.919273
관악구,2103, 신림동 우방아파트,201911,1193,1253,2446,37.489178,126.919273
관악구,2103, 신림동 우방아파트,201912,754,759,1513,37.489178,126.919273
관악구,2103, 신림동 우방아파트,202001,564,551,1115,37.489178,126.919273
관악구,2103, 신림동 우방아파트,202002,575,590,1165,37.489178,126.919273
관악구,2103, 신림동 우방아파트,202003,808,807,1615,37.489178,126.919273
관악구,2103, 신림동 우방아파트,202004,1545,1451,2996,37.489178,126.919273
관악구,2103, 신림동 우방아파트,202005,1631,1613,3244,37.489178,126.919273
관악구,2103, 신림동 우방아파트,202006,2338,2275,4613,37.489178,126.919273
관악구,2104, 사당역 5번출구,201901,266,397,663,37.476089,126.981331
관악구,2104, 사당역 5번출구,201902,287,339,626,37.476089,126.981331
관악구,2104, 사당역 5번출구,201903,423,615,1038,37.476089,126.981331
관악구,2104, 사당역 5번출구,201904,775,1044,1819,37.476089,126.981331
관악구,2104, 사당역 5번출구,201905,1415,1656,3071,37.476089,126.981331
관악구,2104, 사당역 5번출구,201906,1511,1775,3286,37.476089,126.981331
관악구,2104, 사당역 5번출구,201907,1410,1575,2985,37.476089,126.981331
관악구,2104, 사당역 5번출구,201908,1433,1639,3072,37.476089,126.981331
관악구,2104, 사당역 5번출구,201909,1317,1527,2844,37.476089,126.981331
관악구,2104, 사당역 5번출구,201910,1594,1801,3395,37.476089,126.981331
관악구,2104, 사당역 5번출구,201911,969,1191,2160,37.476089,126.981331
관악구,2104, 사당역 5번출구,201912,553,624,1177,37.476089,126.981331
관악구,2104, 사당역 5번출구,202001,504,635,1139,37.476089,126.981331
관악구,2104, 사당역 5번출구,202002,514,567,1081,37.476089,126.981331
관악구,2104, 사당역 5번출구,202003,995,1028,2023,37.476089,126.981331
관악구,2104, 사당역 5번출구,202004,1468,1515,2983,37.476089,126.981331
관악구,2104, 사당역 5번출구,202005,1727,1741,3468,37.476089,126.981331
관악구,2104, 사당역 5번출구,202006,1894,1930,3824,37.476089,126.981331
관악구,2105, 미성동 신림체육센터,201901,259,283,542,37.480251,126.914604
관악구,2105, 미성동 신림체육센터,201902,207,236,443,37.480251,126.914604
관악구,2105, 미성동 신림체육센터,201903,440,438,878,37.480251,126.914604
관악구,2105, 미성동 신림체육센터,201904,647,654,1301,37.480251,126.914604
관악구,2105, 미성동 신림체육센터,201905,1104,1096,2200,37.480251,126.914604
관악구,2105, 미성동 신림체육센터,201906,1214,1229,2443,37.480251,126.914604
관악구,2105, 미성동 신림체육센터,201907,1047,1079,2126,37.480251,126.914604
관악구,2105, 미성동 신림체육센터,201908,886,900,1786,37.480251,126.914604
관악구,2105, 미성동 신림체육센터,201909,888,886,1774,37.480251,126.914604
관악구,2105, 미성동 신림체육센터,201910,1013,1006,2019,37.480251,126.914604
관악구,2105, 미성동 신림체육센터,201911,770,795,1565,37.480251,126.914604
관악구,2105, 미성동 신림체육센터,201912,568,567,1135,37.480251,126.914604
관악구,2105, 미성동 신림체육센터,202001,473,474,947,37.480251,126.914604
관악구,2105, 미성동 신림체육센터,202002,460,461,921,37.480251,126.914604
관악구,2105, 미성동 신림체육센터,202003,687,694,1381,37.480251,126.914604
관악구,2105, 미성동 신림체육센터,202004,1224,1222,2446,37.480251,126.914604
관악구,2105, 미성동 신림체육센터,202005,1368,1366,2734,37.480251,126.914604
관악구,2105, 미성동 신림체육센터,202006,1645,1670,3315,37.480251,126.914604
관악구,2106, 난곡 새마을금고,201901,423,464,887,37.473728,126.918404
관악구,2106, 난곡 새마을금고,201902,445,500,945,37.473728,126.918404
관악구,2106, 난곡 새마을금고,201903,758,962,1720,37.473728,126.918404
관악구,2106, 난곡 새마을금고,201904,984,1402,2386,37.473728,126.918404
관악구,2106, 난곡 새마을금고,201905,1454,2268,3722,37.473728,126.918404
관악구,2106, 난곡 새마을금고,201906,1882,2475,4357,37.473728,126.918404
관악구,2106, 난곡 새마을금고,201907,1895,2392,4287,37.473728,126.918404
관악구,2106, 난곡 새마을금고,201908,1829,2280,4109,37.473728,126.918404
관악구,2106, 난곡 새마을금고,201909,1711,2086,3797,37.473728,126.918404
관악구,2106, 난곡 새마을금고,201910,1972,2451,4423,37.473728,126.918404
관악구,2106, 난곡 새마을금고,201911,1518,1645,3163,37.473728,126.918404
관악구,2106, 난곡 새마을금고,201912,944,1010,1954,37.473728,126.918404
관악구,2106, 난곡 새마을금고,202001,939,996,1935,37.473728,126.918404
관악구,2106, 난곡 새마을금고,202002,831,885,1716,37.473728,126.918404
관악구,2106, 난곡 새마을금고,202003,1113,1140,2253,37.473728,126.918404
관악구,2106, 난곡 새마을금고,202004,1824,1920,3744,37.473728,126.918404
관악구,2106, 난곡 새마을금고,202005,2283,2461,4744,37.473728,126.918404
관악구,2106, 난곡 새마을금고,202006,2428,3047,5475,37.473728,126.918404
관악구,2107, 도림천 신화교,201901,857,831,1688,37.475471,126.936455
관악구,2107, 도림천 신화교,201902,787,846,1633,37.475471,126.936455
관악구,2107, 도림천 신화교,201903,1631,1429,3060,37.475471,126.936455
관악구,2107, 도림천 신화교,201904,2055,2045,4100,37.475471,126.936455
관악구,2107, 도림천 신화교,201905,3393,3502,6895,37.475471,126.936455
관악구,2107, 도림천 신화교,201906,3481,3705,7186,37.475471,126.936455
관악구,2107, 도림천 신화교,201907,3121,3312,6433,37.475471,126.936455
관악구,2107, 도림천 신화교,201908,2985,3198,6183,37.475471,126.936455
관악구,2107, 도림천 신화교,201909,2657,2723,5380,37.475471,126.936455
관악구,2107, 도림천 신화교,201910,2890,2939,5829,37.475471,126.936455
관악구,2107, 도림천 신화교,201911,1824,1789,3613,37.475471,126.936455
관악구,2107, 도림천 신화교,201912,1069,1048,2117,37.475471,126.936455
관악구,2107, 도림천 신화교,202001,1039,1041,2080,37.475471,126.936455
관악구,2107, 도림천 신화교,202002,996,974,1970,37.475471,126.936455
관악구,2107, 도림천 신화교,202003,1775,1761,3536,37.475471,126.936455
관악구,2107, 도림천 신화교,202004,2659,2662,5321,37.475471,126.936455
관악구,2107, 도림천 신화교,202005,3006,2998,6004,37.475471,126.936455
관악구,2107, 도림천 신화교,202006,3625,3605,7230,37.475471,126.936455
관악구,2108, 은천치안센터,201901,350,340,690,37.483341,126.943199
관악구,2108, 은천치안센터,201902,315,313,628,37.483341,126.943199
관악구,2108, 은천치안센터,201903,515,519,1034,37.483341,126.943199
관악구,2108, 은천치안센터,201904,825,900,1725,37.483341,126.943199
관악구,2108, 은천치안센터,201905,1476,1389,2865,37.483341,126.943199
관악구,2108, 은천치안센터,201906,1577,1525,3102,37.483341,126.943199
관악구,2108, 은천치안센터,201907,1548,1456,3004,37.483341,126.943199
관악구,2108, 은천치안센터,201908,1411,1309,2720,37.483341,126.943199
관악구,2108, 은천치안센터,201909,1283,1195,2478,37.483341,126.943199
관악구,2108, 은천치안센터,201910,1422,1349,2771,37.483341,126.943199
관악구,2108, 은천치안센터,201911,987,922,1909,37.483341,126.943199
관악구,2108, 은천치안센터,201912,540,535,1075,37.483341,126.943199
관악구,2108, 은천치안센터,202001,480,455,935,37.483341,126.943199
관악구,2108, 은천치안센터,202002,433,409,842,37.483341,126.943199
관악구,2108, 은천치안센터,202003,729,710,1439,37.483341,126.943199
관악구,2108, 은천치안센터,202004,1156,1109,2265,37.483341,126.943199
관악구,2108, 은천치안센터,202005,1289,1222,2511,37.483341,126.943199
관악구,2108, 은천치안센터,202006,1785,1763,3548,37.483341,126.943199
관악구,2109, 은천로입구 가로공원,201901,467,474,941,37.486225,126.935829
관악구,2109, 은천로입구 가로공원,201902,422,433,855,37.486225,126.935829
관악구,2109, 은천로입구 가로공원,201903,921,893,1814,37.486225,126.935829
관악구,2109, 은천로입구 가로공원,201904,1275,1342,2617,37.486225,126.935829
관악구,2109, 은천로입구 가로공원,201905,2171,2180,4351,37.486225,126.935829
관악구,2109, 은천로입구 가로공원,201906,2466,2463,4929,37.486225,126.935829
관악구,2109, 은천로입구 가로공원,201907,2221,2388,4609,37.486225,126.935829
관악구,2109, 은천로입구 가로공원,201908,2206,2310,4516,37.486225,126.935829
관악구,2109, 은천로입구 가로공원,201909,2270,2326,4596,37.486225,126.935829
관악구,2109, 은천로입구 가로공원,201910,2359,2427,4786,37.486225,126.935829
관악구,2109, 은천로입구 가로공원,201911,1570,1540,3110,37.486225,126.935829
관악구,2109, 은천로입구 가로공원,201912,881,861,1742,37.486225,126.935829
관악구,2109, 은천로입구 가로공원,202001,803,790,1593,37.486225,126.935829
관악구,2109, 은천로입구 가로공원,202002,763,788,1551,37.486225,126.935829
관악구,2109, 은천로입구 가로공원,202003,1270,1272,2542,37.486225,126.935829
관악구,2109, 은천로입구 가로공원,202004,2049,2064,4113,37.486225,126.935829
관악구,2109, 은천로입구 가로공원,202005,2483,2529,5012,37.486225,126.935829
관악구,2109, 은천로입구 가로공원,202006,3246,3445,6691,37.486225,126.935829
관악구,2110, 조원동 미성아파트,201901,270,269,539,37.483192,126.902031
관악구,2110, 조원동 미성아파트,201902,230,240,470,37.483192,126.902031
관악구,2110, 조원동 미성아파트,201903,415,431,846,37.483192,126.902031
관악구,2110, 조원동 미성아파트,201904,621,604,1225,37.483192,126.902031
관악구,2110, 조원동 미성아파트,201905,886,866,1752,37.483192,126.902031
관악구,2110, 조원동 미성아파트,201906,1020,1003,2023,37.483192,126.902031
관악구,2110, 조원동 미성아파트,201907,1068,1018,2086,37.483192,126.902031
관악구,2110, 조원동 미성아파트,201908,1011,999,2010,37.483192,126.902031
관악구,2110, 조원동 미성아파트,201909,866,855,1721,37.483192,126.902031
관악구,2110, 조원동 미성아파트,201910,973,970,1943,37.483192,126.902031
관악구,2110, 조원동 미성아파트,201911,715,682,1397,37.483192,126.902031
관악구,2110, 조원동 미성아파트,201912,488,469,957,37.483192,126.902031
관악구,2110, 조원동 미성아파트,202001,387,386,773,37.483192,126.902031
관악구,2110, 조원동 미성아파트,202002,312,308,620,37.483192,126.902031
관악구,2110, 조원동 미성아파트,202003,471,465,936,37.483192,126.902031
관악구,2110, 조원동 미성아파트,202004,723,704,1427,37.483192,126.902031
관악구,2110, 조원동 미성아파트,202005,864,858,1722,37.483192,126.902031
관악구,2110, 조원동 미성아파트,202006,1201,1195,2396,37.483192,126.902031
관악구,2111, 서울대입구역 1번출구,201901,286,281,567,37.480869,126.953316
관악구,2111, 서울대입구역 1번출구,201902,271,275,546,37.480869,126.953316
관악구,2111, 서울대입구역 1번출구,201903,476,439,915,37.480869,126.953316
관악구,2111, 서울대입구역 1번출구,201904,834,777,1611,37.480869,126.953316
관악구,2111, 서울대입구역 1번출구,201905,1314,1265,2579,37.480869,126.953316
관악구,2111, 서울대입구역 1번출구,201906,1281,1227,2508,37.480869,126.953316
관악구,2111, 서울대입구역 1번출구,201907,1344,1299,2643,37.480869,126.953316
관악구,2111, 서울대입구역 1번출구,201908,1289,1244,2533,37.480869,126.953316
관악구,2111, 서울대입구역 1번출구,201909,1123,1086,2209,37.480869,126.953316
관악구,2111, 서울대입구역 1번출구,201910,1220,1212,2432,37.480869,126.953316
관악구,2111, 서울대입구역 1번출구,201911,743,746,1489,37.480869,126.953316
관악구,2111, 서울대입구역 1번출구,201912,453,433,886,37.480869,126.953316
관악구,2111, 서울대입구역 1번출구,202001,377,387,764,37.480869,126.953316
관악구,2111, 서울대입구역 1번출구,202002,385,365,750,37.480869,126.953316
관악구,2111, 서울대입구역 1번출구,202003,564,545,1109,37.480869,126.953316
관악구,2111, 서울대입구역 1번출구,202004,1053,1035,2088,37.480869,126.953316
관악구,2111, 서울대입구역 1번출구,202005,1208,1170,2378,37.480869,126.953316
관악구,2111, 서울대입구역 1번출구,202006,1420,1384,2804,37.480869,126.953316
관악구,2112, 서울대입구역 마에스트로,201901,257,259,516,37.481339,126.950645
관악구,2112, 서울대입구역 마에스트로,201902,252,248,500,37.481339,126.950645
관악구,2112, 서울대입구역 마에스트로,201903,505,510,1015,37.481339,126.950645
관악구,2112, 서울대입구역 마에스트로,201904,754,748,1502,37.481339,126.950645
관악구,2112, 서울대입구역 마에스트로,201905,1251,1232,2483,37.481339,126.950645
관악구,2112, 서울대입구역 마에스트로,201906,1334,1327,2661,37.481339,126.950645
관악구,2112, 서울대입구역 마에스트로,201907,1171,1165,2336,37.481339,126.950645
관악구,2112, 서울대입구역 마에스트로,201908,1204,1193,2397,37.481339,126.950645
관악구,2112, 서울대입구역 마에스트로,201909,1089,1069,2158,37.481339,126.950645
관악구,2112, 서울대입구역 마에스트로,201910,1131,1135,2266,37.481339,126.950645
관악구,2112, 서울대입구역 마에스트로,201911,725,729,1454,37.481339,126.950645
관악구,2112, 서울대입구역 마에스트로,201912,401,391,792,37.481339,126.950645
관악구,2112, 서울대입구역 마에스트로,202001,390,388,778,37.481339,126.950645
관악구,2112, 서울대입구역 마에스트로,202002,363,369,732,37.481339,126.950645
관악구,2112, 서울대입구역 마에스트로,202003,575,562,1137,37.481339,126.950645
관악구,2112, 서울대입구역 마에스트로,202004,859,844,1703,37.481339,126.950645
관악구,2112, 서울대입구역 마에스트로,202005,1022,1009,2031,37.481339,126.950645
관악구,2112, 서울대입구역 마에스트로,202006,1333,1296,2629,37.481339,126.950645
관악구,2113, 관악동작견인차량보관소,201901,304,283,587,37.484661,126.9039
관악구,2113, 관악동작견인차량보관소,201902,325,318,643,37.484661,126.9039
관악구,2113, 관악동작견인차량보관소,201903,605,600,1205,37.484661,126.9039
관악구,2113, 관악동작견인차량보관소,201904,1292,1161,2453,37.484661,126.9039
관악구,2113, 관악동작견인차량보관소,201905,1759,1664,3423,37.484661,126.9039
관악구,2113, 관악동작견인차량보관소,201906,1999,1962,3961,37.484661,126.9039
관악구,2113, 관악동작견인차량보관소,201907,1758,1698,3456,37.484661,126.9039
관악구,2113, 관악동작견인차량보관소,201908,1680,1617,3297,37.484661,126.9039
관악구,2113, 관악동작견인차량보관소,201909,1500,1460,2960,37.484661,126.9039
관악구,2113, 관악동작견인차량보관소,201910,1727,1691,3418,37.484661,126.9039
관악구,2113, 관악동작견인차량보관소,201911,967,926,1893,37.484661,126.9039
관악구,2113, 관악동작견인차량보관소,201912,528,517,1045,37.484661,126.9039
관악구,2113, 관악동작견인차량보관소,202001,527,498,1025,37.484661,126.9039
관악구,2113, 관악동작견인차량보관소,202002,616,589,1205,37.484661,126.9039
관악구,2113, 관악동작견인차량보관소,202003,1430,1398,2828,37.484661,126.9039
관악구,2113, 관악동작견인차량보관소,202004,2218,2195,4413,37.484661,126.9039
관악구,2113, 관악동작견인차량보관소,202005,2434,2392,4826,37.484661,126.9039
관악구,2113, 관악동작견인차량보관소,202006,2725,2712,5437,37.484661,126.9039
관악구,2115, 관악농협농산물백화점,201901,407,313,720,37.479916,126.90284
관악구,2115, 관악농협농산물백화점,201902,331,278,609,37.479916,126.90284
관악구,2115, 관악농협농산물백화점,201903,651,502,1153,37.479916,126.90284
관악구,2115, 관악농협농산물백화점,201904,894,667,1561,37.479916,126.90284
관악구,2115, 관악농협농산물백화점,201905,1217,967,2184,37.479916,126.90284
관악구,2115, 관악농협농산물백화점,201906,1191,1063,2254,37.479916,126.90284
관악구,2115, 관악농협농산물백화점,201907,1332,1164,2496,37.479916,126.90284
관악구,2115, 관악농협농산물백화점,201908,1209,1037,2246,37.479916,126.90284
관악구,2115, 관악농협농산물백화점,201909,1059,895,1954,37.479916,126.90284
관악구,2115, 관악농협농산물백화점,201910,1116,998,2114,37.479916,126.90284
관악구,2115, 관악농협농산물백화점,201911,780,734,1514,37.479916,126.90284
관악구,2115, 관악농협농산물백화점,201912,529,481,1010,37.479916,126.90284
관악구,2115, 관악농협농산물백화점,202001,468,412,880,37.479916,126.90284
관악구,2115, 관악농협농산물백화점,202002,463,438,901,37.479916,126.90284
관악구,2115, 관악농협농산물백화점,202003,516,479,995,37.479916,126.90284
관악구,2115, 관악농협농산물백화점,202004,924,878,1802,37.479916,126.90284
관악구,2115, 관악농협농산물백화점,202005,938,897,1835,37.479916,126.90284
관악구,2115, 관악농협농산물백화점,202006,1402,1295,2697,37.479916,126.90284
관악구,2116, 에이스에이존빌딩,201901,173,173,346,37.481705,126.950829
관악구,2116, 에이스에이존빌딩,201902,145,139,284,37.481705,126.950829
관악구,2116, 에이스에이존빌딩,201903,293,314,607,37.481705,126.950829
관악구,2116, 에이스에이존빌딩,201904,450,475,925,37.481705,126.950829
관악구,2116, 에이스에이존빌딩,201905,781,758,1539,37.481705,126.950829
관악구,2116, 에이스에이존빌딩,201906,798,785,1583,37.481705,126.950829
관악구,2116, 에이스에이존빌딩,201907,777,761,1538,37.481705,126.950829
관악구,2116, 에이스에이존빌딩,201908,480,470,950,37.481705,126.950829
관악구,2116, 에이스에이존빌딩,201909,365,364,729,37.481705,126.950829
관악구,2116, 에이스에이존빌딩,201910,796,801,1597,37.481705,126.950829
관악구,2116, 에이스에이존빌딩,201911,521,510,1031,37.481705,126.950829
관악구,2116, 에이스에이존빌딩,201912,274,265,539,37.481705,126.950829
관악구,2116, 에이스에이존빌딩,202001,230,213,443,37.481705,126.950829
관악구,2116, 에이스에이존빌딩,202002,252,241,493,37.481705,126.950829
관악구,2116, 에이스에이존빌딩,202003,568,504,1072,37.481705,126.950829
관악구,2116, 에이스에이존빌딩,202004,923,823,1746,37.481705,126.950829
관악구,2116, 에이스에이존빌딩,202005,811,760,1571,37.481705,126.950829
관악구,2116, 에이스에이존빌딩,202006,1164,1127,2291,37.481705,126.950829
관악구,2119, 중앙동 동진빌딩,201901,357,338,695,37.484257,126.954697
관악구,2119, 중앙동 동진빌딩,201902,307,315,622,37.484257,126.954697
관악구,2119, 중앙동 동진빌딩,201903,590,598,1188,37.484257,126.954697
관악구,2119, 중앙동 동진빌딩,201904,887,924,1811,37.484257,126.954697
관악구,2119, 중앙동 동진빌딩,201905,1232,1242,2474,37.484257,126.954697
관악구,2119, 중앙동 동진빌딩,201906,1228,1234,2462,37.484257,126.954697
관악구,2119, 중앙동 동진빌딩,201907,1165,1154,2319,37.484257,126.954697
관악구,2119, 중앙동 동진빌딩,201908,1202,1199,2401,37.484257,126.954697
관악구,2119, 중앙동 동진빌딩,201909,1072,1079,2151,37.484257,126.954697
관악구,2119, 중앙동 동진빌딩,201910,1154,1143,2297,37.484257,126.954697
관악구,2119, 중앙동 동진빌딩,201911,798,777,1575,37.484257,126.954697
관악구,2119, 중앙동 동진빌딩,201912,480,456,936,37.484257,126.954697
관악구,2119, 중앙동 동진빌딩,202001,450,451,901,37.484257,126.954697
관악구,2119, 중앙동 동진빌딩,202002,390,391,781,37.484257,126.954697
관악구,2119, 중앙동 동진빌딩,202003,591,581,1172,37.484257,126.954697
관악구,2119, 중앙동 동진빌딩,202004,1111,1049,2160,37.484257,126.954697
관악구,2119, 중앙동 동진빌딩,202005,1271,1212,2483,37.484257,126.954697
관악구,2119, 중앙동 동진빌딩,202006,1500,1445,2945,37.484257,126.954697
관악구,2122, 낙성대로 입구,201901,338,326,664,37.478058,126.960495
관악구,2122, 낙성대로 입구,201902,286,278,564,37.478058,126.960495
관악구,2122, 낙성대로 입구,201903,547,525,1072,37.478058,126.960495
관악구,2122, 낙성대로 입구,201904,909,906,1815,37.478058,126.960495
관악구,2122, 낙성대로 입구,201905,1494,1328,2822,37.478058,126.960495
관악구,2122, 낙성대로 입구,201906,1183,1072,2255,37.478058,126.960495
관악구,2122, 낙성대로 입구,201907,1082,1008,2090,37.478058,126.960495
관악구,2122, 낙성대로 입구,201908,1197,1079,2276,37.478058,126.960495
관악구,2122, 낙성대로 입구,201909,1174,1084,2258,37.478058,126.960495
관악구,2122, 낙성대로 입구,201910,1310,1247,2557,37.478058,126.960495
관악구,2122, 낙성대로 입구,201911,767,694,1461,37.478058,126.960495
관악구,2122, 낙성대로 입구,201912,458,384,842,37.478058,126.960495
관악구,2122, 낙성대로 입구,202001,417,369,786,37.478058,126.960495
관악구,2122, 낙성대로 입구,202002,332,314,646,37.478058,126.960495
관악구,2122, 낙성대로 입구,202003,644,599,1243,37.478058,126.960495
관악구,2122, 낙성대로 입구,202004,1204,1171,2375,37.478058,126.960495
관악구,2122, 낙성대로 입구,202005,1390,1343,2733,37.478058,126.960495
관악구,2122, 낙성대로 입구,202006,1478,1441,2919,37.478058,126.960495
관악구,2127, 보성운수차고지 맞은편,201901,124,92,216,37.464886,126.919479
관악구,2127, 보성운수차고지 맞은편,201902,148,76,224,37.464886,126.919479
관악구,2127, 보성운수차고지 맞은편,201903,262,130,392,37.464886,126.919479
관악구,2127, 보성운수차고지 맞은편,201904,408,269,677,37.464886,126.919479
관악구,2127, 보성운수차고지 맞은편,201905,574,479,1053,37.464886,126.919479
관악구,2127, 보성운수차고지 맞은편,201906,662,537,1199,37.464886,126.919479
관악구,2127, 보성운수차고지 맞은편,201907,619,425,1044,37.464886,126.919479
관악구,2127, 보성운수차고지 맞은편,201908,579,408,987,37.464886,126.919479
관악구,2127, 보성운수차고지 맞은편,201909,493,397,890,37.464886,126.919479
관악구,2127, 보성운수차고지 맞은편,201910,563,477,1040,37.464886,126.919479
관악구,2127, 보성운수차고지 맞은편,201911,286,252,538,37.464886,126.919479
관악구,2127, 보성운수차고지 맞은편,201912,160,140,300,37.464886,126.919479
관악구,2127, 보성운수차고지 맞은편,202001,161,143,304,37.464886,126.919479
관악구,2127, 보성운수차고지 맞은편,202002,142,117,259,37.464886,126.919479
관악구,2127, 보성운수차고지 맞은편,202003,192,180,372,37.464886,126.919479
관악구,2127, 보성운수차고지 맞은편,202004,271,252,523,37.464886,126.919479
관악구,2127, 보성운수차고지 맞은편,202005,439,404,843,37.464886,126.919479
관악구,2127, 보성운수차고지 맞은편,202006,811,661,1472,37.464886,126.919479
관악구,2128, 관악구청교차로,201901,162,176,338,37.479164,126.952583
관악구,2128, 관악구청교차로,201902,147,144,291,37.479164,126.952583
관악구,2128, 관악구청교차로,201903,297,270,567,37.479164,126.952583
관악구,2128, 관악구청교차로,201904,477,423,900,37.479164,126.952583
관악구,2128, 관악구청교차로,201905,585,547,1132,37.479164,126.952583
관악구,2128, 관악구청교차로,201906,594,573,1167,37.479164,126.952583
관악구,2128, 관악구청교차로,201907,576,566,1142,37.479164,126.952583
관악구,2128, 관악구청교차로,201908,504,474,978,37.479164,126.952583
관악구,2128, 관악구청교차로,201909,458,454,912,37.479164,126.952583
관악구,2128, 관악구청교차로,201910,459,455,914,37.479164,126.952583
관악구,2128, 관악구청교차로,201911,338,340,678,37.479164,126.952583
관악구,2128, 관악구청교차로,201912,213,209,422,37.479164,126.952583
관악구,2128, 관악구청교차로,202001,223,228,451,37.479164,126.952583
관악구,2128, 관악구청교차로,202002,123,126,249,37.479164,126.952583
관악구,2128, 관악구청교차로,202003,235,222,457,37.479164,126.952583
관악구,2128, 관악구청교차로,202004,490,486,976,37.479164,126.952583
관악구,2128, 관악구청교차로,202005,472,470,942,37.479164,126.952583
관악구,2128, 관악구청교차로,202006,740,649,1389,37.479164,126.952583
관악구,2129, 낙성대 과학전시관,201901,235,128,363,37.469055,126.958145
관악구,2129, 낙성대 과학전시관,201902,218,98,316,37.469055,126.958145
관악구,2129, 낙성대 과학전시관,201903,359,217,576,37.469055,126.958145
관악구,2129, 낙성대 과학전시관,201904,592,381,973,37.469055,126.958145
관악구,2129, 낙성대 과학전시관,201905,634,561,1195,37.469055,126.958145
관악구,2129, 낙성대 과학전시관,201906,546,491,1037,37.469055,126.958145
관악구,2129, 낙성대 과학전시관,201907,506,437,943,37.469055,126.958145
관악구,2129, 낙성대 과학전시관,201908,443,367,810,37.469055,126.958145
관악구,2129, 낙성대 과학전시관,201909,491,444,935,37.469055,126.958145
관악구,2129, 낙성대 과학전시관,201910,542,519,1061,37.469055,126.958145
관악구,2129, 낙성대 과학전시관,201911,371,334,705,37.469055,126.958145
관악구,2129, 낙성대 과학전시관,201912,244,246,490,37.469055,126.958145
관악구,2129, 낙성대 과학전시관,202001,249,224,473,37.469055,126.958145
관악구,2129, 낙성대 과학전시관,202002,175,158,333,37.469055,126.958145
관악구,2129, 낙성대 과학전시관,202003,200,169,369,37.469055,126.958145
관악구,2129, 낙성대 과학전시관,202004,573,473,1046,37.469055,126.958145
관악구,2129, 낙성대 과학전시관,202005,610,544,1154,37.469055,126.958145
관악구,2129, 낙성대 과학전시관,202006,770,661,1431,37.469055,126.958145
관악구,2130, 영어마을 관악캠프,201901,90,50,140,37.471989,126.958427
관악구,2130, 영어마을 관악캠프,201902,80,57,137,37.471989,126.958427
관악구,2130, 영어마을 관악캠프,201903,201,128,329,37.471989,126.958427
관악구,2130, 영어마을 관악캠프,201904,419,254,673,37.471989,126.958427
관악구,2130, 영어마을 관악캠프,201905,543,291,834,37.471989,126.958427
관악구,2130, 영어마을 관악캠프,201906,389,244,633,37.471989,126.958427
관악구,2130, 영어마을 관악캠프,201907,337,211,548,37.471989,126.958427
관악구,2130, 영어마을 관악캠프,201908,324,216,540,37.471989,126.958427
관악구,2130, 영어마을 관악캠프,201909,312,229,541,37.471989,126.958427
관악구,2130, 영어마을 관악캠프,201910,182,141,323,37.471989,126.958427
관악구,2130, 영어마을 관악캠프,201911,80,72,152,37.471989,126.958427
관악구,2130, 영어마을 관악캠프,201912,80,55,135,37.471989,126.958427
관악구,2130, 영어마을 관악캠프,202001,94,41,135,37.471989,126.958427
관악구,2130, 영어마을 관악캠프,202002,33,17,50,37.471989,126.958427
관악구,2130, 영어마을 관악캠프,202003,240,138,378,37.471989,126.958427
관악구,2130, 영어마을 관악캠프,202004,504,335,839,37.471989,126.958427
관악구,2130, 영어마을 관악캠프,202005,516,345,861,37.471989,126.958427
관악구,2130, 영어마을 관악캠프,202006,538,329,867,37.471989,126.958427
관악구,2135, 신림역 5번출구,201901,358,349,707,37.484409,126.928909
관악구,2135, 신림역 5번출구,201902,341,331,672,37.484409,126.928909
관악구,2135, 신림역 5번출구,201903,693,691,1384,37.484409,126.928909
관악구,2135, 신림역 5번출구,201904,999,1027,2026,37.484409,126.928909
관악구,2135, 신림역 5번출구,201905,1560,1677,3237,37.484409,126.928909
관악구,2135, 신림역 5번출구,201906,2130,2191,4321,37.484409,126.928909
관악구,2135, 신림역 5번출구,201907,1817,2017,3834,37.484409,126.928909
관악구,2135, 신림역 5번출구,201908,1738,1876,3614,37.484409,126.928909
관악구,2135, 신림역 5번출구,201909,1490,1544,3034,37.484409,126.928909
관악구,2135, 신림역 5번출구,201910,1891,1923,3814,37.484409,126.928909
관악구,2135, 신림역 5번출구,201911,1368,1421,2789,37.484409,126.928909
관악구,2135, 신림역 5번출구,201912,911,914,1825,37.484409,126.928909
관악구,2135, 신림역 5번출구,202001,777,786,1563,37.484409,126.928909
관악구,2135, 신림역 5번출구,202002,764,773,1537,37.484409,126.928909
관악구,2135, 신림역 5번출구,202003,809,828,1637,37.484409,126.928909
관악구,2135, 신림역 5번출구,202004,1407,1399,2806,37.484409,126.928909
관악구,2135, 신림역 5번출구,202005,1493,1485,2978,37.484409,126.928909
관악구,2135, 신림역 5번출구,202006,2069,2068,4137,37.484409,126.928909
관악구,2136, 신림역 8번출구,201901,623,703,1326,37.484577,126.929916
관악구,2136, 신림역 8번출구,201902,518,540,1058,37.484577,126.929916
관악구,2136, 신림역 8번출구,201903,934,1064,1998,37.484577,126.929916
관악구,2136, 신림역 8번출구,201904,1291,1454,2745,37.484577,126.929916
관악구,2136, 신림역 8번출구,201905,2114,2483,4597,37.484577,126.929916
관악구,2136, 신림역 8번출구,201906,2495,2798,5293,37.484577,126.929916
관악구,2136, 신림역 8번출구,201907,2622,2731,5353,37.484577,126.929916
관악구,2136, 신림역 8번출구,201908,2343,2519,4862,37.484577,126.929916
관악구,2136, 신림역 8번출구,201909,2147,2255,4402,37.484577,126.929916
관악구,2136, 신림역 8번출구,201910,2592,2751,5343,37.484577,126.929916
관악구,2136, 신림역 8번출구,201911,1693,1797,3490,37.484577,126.929916
관악구,2136, 신림역 8번출구,201912,1013,1032,2045,37.484577,126.929916
관악구,2136, 신림역 8번출구,202001,880,880,1760,37.484577,126.929916
관악구,2136, 신림역 8번출구,202002,777,791,1568,37.484577,126.929916
관악구,2136, 신림역 8번출구,202003,1329,1340,2669,37.484577,126.929916
관악구,2136, 신림역 8번출구,202004,2025,2042,4067,37.484577,126.929916
관악구,2136, 신림역 8번출구,202005,2317,2317,4634,37.484577,126.929916
관악구,2136, 신림역 8번출구,202006,3180,3186,6366,37.484577,126.929916
관악구,2137, KT&G 관악지점,201901,218,212,430,37.484901,126.936531
관악구,2137, KT&G 관악지점,201902,135,136,271,37.484901,126.936531
관악구,2137, KT&G 관악지점,201903,259,239,498,37.484901,126.936531
관악구,2137, KT&G 관악지점,201904,474,450,924,37.484901,126.936531
관악구,2137, KT&G 관악지점,201905,642,607,1249,37.484901,126.936531
관악구,2137, KT&G 관악지점,201906,943,913,1856,37.484901,126.936531
관악구,2137, KT&G 관악지점,201907,822,807,1629,37.484901,126.936531
관악구,2137, KT&G 관악지점,201908,788,716,1504,37.484901,126.936531
관악구,2137, KT&G 관악지점,201909,680,659,1339,37.484901,126.936531
관악구,2137, KT&G 관악지점,201910,827,801,1628,37.484901,126.936531
관악구,2137, KT&G 관악지점,201911,575,520,1095,37.484901,126.936531
관악구,2137, KT&G 관악지점,201912,313,314,627,37.484901,126.936531
관악구,2137, KT&G 관악지점,202001,266,266,532,37.484901,126.936531
관악구,2137, KT&G 관악지점,202002,274,274,548,37.484901,126.936531
관악구,2137, KT&G 관악지점,202003,354,342,696,37.484901,126.936531
관악구,2137, KT&G 관악지점,202004,658,630,1288,37.484901,126.936531
관악구,2137, KT&G 관악지점,202005,463,485,948,37.484901,126.936531
관악구,2137, KT&G 관악지점,202006,819,802,1621,37.484901,126.936531
관악구,2139, 서울신성초등학교,201901,737,758,1495,37.471165,126.937019
관악구,2139, 서울신성초등학교,201902,599,618,1217,37.471165,126.937019
관악구,2139, 서울신성초등학교,201903,1100,1147,2247,37.471165,126.937019
관악구,2139, 서울신성초등학교,201904,1546,1574,3120,37.471165,126.937019
관악구,2139, 서울신성초등학교,201905,2491,2513,5004,37.471165,126.937019
관악구,2139, 서울신성초등학교,201906,2709,2770,5479,37.471165,126.937019
관악구,2139, 서울신성초등학교,201907,2605,2743,5348,37.471165,126.937019
관악구,2139, 서울신성초등학교,201908,2560,2577,5137,37.471165,126.937019
관악구,2139, 서울신성초등학교,201909,2232,2287,4519,37.471165,126.937019
관악구,2139, 서울신성초등학교,201910,1847,1840,3687,37.471165,126.937019
관악구,2139, 서울신성초등학교,201911,1146,1135,2281,37.471165,126.937019
관악구,2139, 서울신성초등학교,201912,648,656,1304,37.471165,126.937019
관악구,2139, 서울신성초등학교,202001,560,554,1114,37.471165,126.937019
관악구,2139, 서울신성초등학교,202002,550,558,1108,37.471165,126.937019
관악구,2139, 서울신성초등학교,202003,819,821,1640,37.471165,126.937019
관악구,2139, 서울신성초등학교,202004,1176,1177,2353,37.471165,126.937019
관악구,2139, 서울신성초등학교,202005,1172,1170,2342,37.471165,126.937019
관악구,2139, 서울신성초등학교,202006,1352,1361,2713,37.471165,126.937019
관악구,2140, 신림1교 교차로,201901,665,665,1330,37.478428,126.931862
관악구,2140, 신림1교 교차로,201902,516,553,1069,37.478428,126.931862
관악구,2140, 신림1교 교차로,201903,1076,1065,2141,37.478428,126.931862
관악구,2140, 신림1교 교차로,201904,1380,1443,2823,37.478428,126.931862
관악구,2140, 신림1교 교차로,201905,2174,2245,4419,37.478428,126.931862
관악구,2140, 신림1교 교차로,201906,2371,2407,4778,37.478428,126.931862
관악구,2140, 신림1교 교차로,201907,2263,2359,4622,37.478428,126.931862
관악구,2140, 신림1교 교차로,201908,2122,2196,4318,37.478428,126.931862
관악구,2140, 신림1교 교차로,201909,1979,2010,3989,37.478428,126.931862
관악구,2140, 신림1교 교차로,201910,2257,2251,4508,37.478428,126.931862
관악구,2140, 신림1교 교차로,201911,1513,1495,3008,37.478428,126.931862
관악구,2140, 신림1교 교차로,201912,970,953,1923,37.478428,126.931862
관악구,2140, 신림1교 교차로,202001,933,938,1871,37.478428,126.931862
관악구,2140, 신림1교 교차로,202002,841,836,1677,37.478428,126.931862
관악구,2140, 신림1교 교차로,202003,1245,1265,2510,37.478428,126.931862
관악구,2140, 신림1교 교차로,202004,2032,2037,4069,37.478428,126.931862
관악구,2140, 신림1교 교차로,202005,2435,2420,4855,37.478428,126.931862
관악구,2140, 신림1교 교차로,202006,2784,2806,5590,37.478428,126.931862
관악구,2141, 미림여고입구 교차로,201901,111,125,236,37.472294,126.933411
관악구,2141, 미림여고입구 교차로,201902,114,110,224,37.472294,126.933411
관악구,2141, 미림여고입구 교차로,201903,146,132,278,37.472294,126.933411
관악구,2141, 미림여고입구 교차로,201904,195,187,382,37.472294,126.933411
관악구,2141, 미림여고입구 교차로,201905,262,244,506,37.472294,126.933411
관악구,2141, 미림여고입구 교차로,201906,242,237,479,37.472294,126.933411
관악구,2141, 미림여고입구 교차로,201907,264,273,537,37.472294,126.933411
관악구,2141, 미림여고입구 교차로,201908,239,233,472,37.472294,126.933411
관악구,2141, 미림여고입구 교차로,201909,259,251,510,37.472294,126.933411
관악구,2141, 미림여고입구 교차로,201910,277,277,554,37.472294,126.933411
관악구,2141, 미림여고입구 교차로,201911,180,178,358,37.472294,126.933411
관악구,2141, 미림여고입구 교차로,201912,93,94,187,37.472294,126.933411
관악구,2141, 미림여고입구 교차로,202001,112,104,216,37.472294,126.933411
관악구,2141, 미림여고입구 교차로,202002,95,97,192,37.472294,126.933411
관악구,2141, 미림여고입구 교차로,202003,155,153,308,37.472294,126.933411
관악구,2141, 미림여고입구 교차로,202004,216,213,429,37.472294,126.933411
관악구,2141, 미림여고입구 교차로,202005,178,181,359,37.472294,126.933411
관악구,2141, 미림여고입구 교차로,202006,196,197,393,37.472294,126.933411
관악구,2143, 서울산업정보학교,201901,207,206,413,37.470695,126.9422
관악구,2143, 서울산업정보학교,201902,196,191,387,37.470695,126.9422
관악구,2143, 서울산업정보학교,201903,468,414,882,37.470695,126.9422
관악구,2143, 서울산업정보학교,201904,731,632,1363,37.470695,126.9422
관악구,2143, 서울산업정보학교,201905,872,828,1700,37.470695,126.9422
관악구,2143, 서울산업정보학교,201906,813,757,1570,37.470695,126.9422
관악구,2143, 서울산업정보학교,201907,728,719,1447,37.470695,126.9422
관악구,2143, 서울산업정보학교,201908,663,655,1318,37.470695,126.9422
관악구,2143, 서울산업정보학교,201909,561,549,1110,37.470695,126.9422
관악구,2143, 서울산업정보학교,201910,420,400,820,37.470695,126.9422
관악구,2143, 서울산업정보학교,201911,262,251,513,37.470695,126.9422
관악구,2143, 서울산업정보학교,201912,188,184,372,37.470695,126.9422
관악구,2143, 서울산업정보학교,202001,173,172,345,37.470695,126.9422
관악구,2143, 서울산업정보학교,202002,151,144,295,37.470695,126.9422
관악구,2143, 서울산업정보학교,202003,254,247,501,37.470695,126.9422
관악구,2143, 서울산업정보학교,202004,323,292,615,37.470695,126.9422
관악구,2143, 서울산업정보학교,202005,336,322,658,37.470695,126.9422
관악구,2143, 서울산업정보학교,202006,424,423,847,37.470695,126.9422
관악구,2144, 난우길입구,201901,179,183,362,37.477776,126.916756
관악구,2144, 난우길입구,201902,166,164,330,37.477776,126.916756
관악구,2144, 난우길입구,201903,377,361,738,37.477776,126.916756
관악구,2144, 난우길입구,201904,503,489,992,37.477776,126.916756
관악구,2144, 난우길입구,201905,866,816,1682,37.477776,126.916756
관악구,2144, 난우길입구,201906,957,944,1901,37.477776,126.916756
관악구,2144, 난우길입구,201907,837,858,1695,37.477776,126.916756
관악구,2144, 난우길입구,201908,699,686,1385,37.477776,126.916756
관악구,2144, 난우길입구,201909,655,656,1311,37.477776,126.916756
관악구,2144, 난우길입구,201910,787,778,1565,37.477776,126.916756
관악구,2144, 난우길입구,201911,440,439,879,37.477776,126.916756
관악구,2144, 난우길입구,201912,252,243,495,37.477776,126.916756
관악구,2144, 난우길입구,202001,264,266,530,37.477776,126.916756
관악구,2144, 난우길입구,202002,220,220,440,37.477776,126.916756
관악구,2144, 난우길입구,202003,346,332,678,37.477776,126.916756
관악구,2144, 난우길입구,202004,583,571,1154,37.477776,126.916756
관악구,2144, 난우길입구,202005,692,698,1390,37.477776,126.916756
관악구,2144, 난우길입구,202006,736,724,1460,37.477776,126.916756
관악구,2145, 은천초등학교 육교,201901,215,167,382,37.486359,126.942924
관악구,2145, 은천초등학교 육교,201902,135,134,269,37.486359,126.942924
관악구,2145, 은천초등학교 육교,201903,286,256,542,37.486359,126.942924
관악구,2145, 은천초등학교 육교,201904,551,494,1045,37.486359,126.942924
관악구,2145, 은천초등학교 육교,201905,809,784,1593,37.486359,126.942924
관악구,2145, 은천초등학교 육교,201906,875,845,1720,37.486359,126.942924
관악구,2145, 은천초등학교 육교,201907,940,934,1874,37.486359,126.942924
관악구,2145, 은천초등학교 육교,201908,885,869,1754,37.486359,126.942924
관악구,2145, 은천초등학교 육교,201909,688,684,1372,37.486359,126.942924
관악구,2145, 은천초등학교 육교,201910,763,773,1536,37.486359,126.942924
관악구,2145, 은천초등학교 육교,201911,602,604,1206,37.486359,126.942924
관악구,2145, 은천초등학교 육교,201912,419,412,831,37.486359,126.942924
관악구,2145, 은천초등학교 육교,202001,268,267,535,37.486359,126.942924
관악구,2145, 은천초등학교 육교,202002,293,286,579,37.486359,126.942924
관악구,2145, 은천초등학교 육교,202003,413,439,852,37.486359,126.942924
관악구,2145, 은천초등학교 육교,202004,801,810,1611,37.486359,126.942924
관악구,2145, 은천초등학교 육교,202005,877,879,1756,37.486359,126.942924
관악구,2145, 은천초등학교 육교,202006,1054,1051,2105,37.486359,126.942924
관악구,2148, 낙성대역 3번출구 뒤,201901,325,336,661,37.477028,126.963394
관악구,2148, 낙성대역 3번출구 뒤,201902,263,250,513,37.477028,126.963394
관악구,2148, 낙성대역 3번출구 뒤,201903,532,531,1063,37.477028,126.963394
관악구,2148, 낙성대역 3번출구 뒤,201904,767,774,1541,37.477028,126.963394
관악구,2148, 낙성대역 3번출구 뒤,201905,1098,1080,2178,37.477028,126.963394
관악구,2148, 낙성대역 3번출구 뒤,201906,1034,1005,2039,37.477028,126.963394
관악구,2148, 낙성대역 3번출구 뒤,201907,1075,1057,2132,37.477028,126.963394
관악구,2148, 낙성대역 3번출구 뒤,201908,898,876,1774,37.477028,126.963394
관악구,2148, 낙성대역 3번출구 뒤,201909,725,695,1420,37.477028,126.963394
관악구,2148, 낙성대역 3번출구 뒤,201910,806,798,1604,37.477028,126.963394
관악구,2148, 낙성대역 3번출구 뒤,201911,570,560,1130,37.477028,126.963394
관악구,2148, 낙성대역 3번출구 뒤,201912,348,327,675,37.477028,126.963394
관악구,2148, 낙성대역 3번출구 뒤,202001,322,311,633,37.477028,126.963394
관악구,2148, 낙성대역 3번출구 뒤,202002,245,247,492,37.477028,126.963394
관악구,2148, 낙성대역 3번출구 뒤,202003,366,354,720,37.477028,126.963394
관악구,2148, 낙성대역 3번출구 뒤,202004,669,652,1321,37.477028,126.963394
관악구,2148, 낙성대역 3번출구 뒤,202005,690,694,1384,37.477028,126.963394
관악구,2148, 낙성대역 3번출구 뒤,202006,860,841,1701,37.477028,126.963394
관악구,2153, 서울남부초등학교 옆,201901,241,268,509,#N/A,#N/A
관악구,2153, 서울남부초등학교 옆,201902,242,245,487,#N/A,#N/A
관악구,2153, 서울남부초등학교 옆,201903,474,456,930,#N/A,#N/A
관악구,2153, 서울남부초등학교 옆,201904,568,643,1211,#N/A,#N/A
관악구,2153, 서울남부초등학교 옆,201905,1025,1059,2084,#N/A,#N/A
관악구,2153, 서울남부초등학교 옆,201906,1298,1395,2693,#N/A,#N/A
관악구,2153, 서울남부초등학교 옆,201907,752,758,1510,#N/A,#N/A
관악구,2156, 농협 관악문성지점,201901,280,257,537,37.480721,126.909325
관악구,2156, 농협 관악문성지점,201902,226,227,453,37.480721,126.909325
관악구,2156, 농협 관악문성지점,201903,379,365,744,37.480721,126.909325
관악구,2156, 농협 관악문성지점,201904,588,609,1197,37.480721,126.909325
관악구,2156, 농협 관악문성지점,201905,963,955,1918,37.480721,126.909325
관악구,2156, 농협 관악문성지점,201906,1096,1084,2180,37.480721,126.909325
관악구,2156, 농협 관악문성지점,201907,1197,1208,2405,37.480721,126.909325
관악구,2156, 농협 관악문성지점,201908,1008,1006,2014,37.480721,126.909325
관악구,2156, 농협 관악문성지점,201909,881,864,1745,37.480721,126.909325
관악구,2156, 농협 관악문성지점,201910,1046,1028,2074,37.480721,126.909325
관악구,2156, 농협 관악문성지점,201911,702,697,1399,37.480721,126.909325
관악구,2156, 농협 관악문성지점,201912,468,468,936,37.480721,126.909325
관악구,2156, 농협 관악문성지점,202001,382,381,763,37.480721,126.909325
관악구,2156, 농협 관악문성지점,202002,378,377,755,37.480721,126.909325
관악구,2156, 농협 관악문성지점,202003,464,464,928,37.480721,126.909325
관악구,2156, 농협 관악문성지점,202004,774,771,1545,37.480721,126.909325
관악구,2156, 농협 관악문성지점,202005,949,940,1889,37.480721,126.909325
관악구,2156, 농협 관악문성지점,202006,1220,1081,2301,37.480721,126.909325
관악구,2157, 난곡 사거리,201901,315,323,638,#N/A,#N/A
관악구,2157, 난곡 사거리,201902,228,232,460,#N/A,#N/A
관악구,2157, 난곡 사거리,201903,575,565,1140,#N/A,#N/A
관악구,2157, 난곡 사거리,201904,814,763,1577,#N/A,#N/A
관악구,2157, 난곡 사거리,201905,1369,1315,2684,#N/A,#N/A
관악구,2157, 난곡 사거리,201906,1574,1596,3170,#N/A,#N/A
관악구,2157, 난곡 사거리,201907,1632,1645,3277,#N/A,#N/A
관악구,2157, 난곡 사거리,201908,1450,1438,2888,#N/A,#N/A
관악구,2157, 난곡 사거리,201909,1115,1113,2228,#N/A,#N/A
관악구,2157, 난곡 사거리,201910,1430,1418,2848,#N/A,#N/A
관악구,2157, 난곡 사거리,201911,684,675,1359,#N/A,#N/A
관악구,2159, 인헌초교,201901,158,164,322,37.47509,126.959229
관악구,2159, 인헌초교,201902,115,129,244,37.47509,126.959229
관악구,2159, 인헌초교,201903,253,236,489,37.47509,126.959229
관악구,2159, 인헌초교,201904,506,481,987,37.47509,126.959229
관악구,2159, 인헌초교,201905,664,642,1306,37.47509,126.959229
관악구,2159, 인헌초교,201906,658,621,1279,37.47509,126.959229
관악구,2159, 인헌초교,201907,739,702,1441,37.47509,126.959229
관악구,2159, 인헌초교,201908,562,526,1088,37.47509,126.959229
관악구,2159, 인헌초교,201909,498,471,969,37.47509,126.959229
관악구,2159, 인헌초교,201910,492,480,972,37.47509,126.959229
관악구,2159, 인헌초교,201911,303,271,574,37.47509,126.959229
관악구,2159, 인헌초교,201912,130,132,262,37.47509,126.959229
관악구,2159, 인헌초교,202001,183,171,354,37.47509,126.959229
관악구,2159, 인헌초교,202002,104,90,194,37.47509,126.959229
관악구,2159, 인헌초교,202003,196,169,365,37.47509,126.959229
관악구,2159, 인헌초교,202004,470,392,862,37.47509,126.959229
관악구,2159, 인헌초교,202005,492,397,889,37.47509,126.959229
관악구,2159, 인헌초교,202006,633,502,1135,37.47509,126.959229
관악구,2160, 관악구 보건소,201901,189,159,348,#N/A,#N/A
관악구,2160, 관악구 보건소,201902,123,93,216,#N/A,#N/A
관악구,2160, 관악구 보건소,201903,319,225,544,#N/A,#N/A
관악구,2160, 관악구 보건소,201904,495,387,882,#N/A,#N/A
관악구,2160, 관악구 보건소,201905,886,604,1490,#N/A,#N/A
관악구,2160, 관악구 보건소,201906,702,512,1214,#N/A,#N/A
관악구,2160, 관악구 보건소,201907,684,494,1178,#N/A,#N/A
관악구,2160, 관악구 보건소,201908,686,525,1211,#N/A,#N/A
관악구,2160, 관악구 보건소,201909,615,453,1068,#N/A,#N/A
관악구,2160, 관악구 보건소,201910,599,446,1045,#N/A,#N/A
관악구,2160, 관악구 보건소,201911,431,300,731,#N/A,#N/A
관악구,2160, 관악구 보건소,201912,195,181,376,#N/A,#N/A
관악구,2160, 관악구 보건소,202001,179,133,312,#N/A,#N/A
관악구,2160, 관악구 보건소,202002,193,130,323,#N/A,#N/A
관악구,2160, 관악구 보건소,202003,266,262,528,#N/A,#N/A
관악구,2160, 관악구 보건소,202004,443,404,847,#N/A,#N/A
관악구,2160, 관악구 보건소,202005,491,474,965,#N/A,#N/A
관악구,2160, 관악구 보건소,202006,592,533,1125,#N/A,#N/A
관악구,2164, 관악우체국,201901,213,209,422,37.484768,126.932877
관악구,2164, 관악우체국,201902,185,179,364,37.484768,126.932877
관악구,2164, 관악우체국,201903,431,433,864,37.484768,126.932877
관악구,2164, 관악우체국,201904,665,626,1291,37.484768,126.932877
관악구,2164, 관악우체국,201905,1156,1128,2284,37.484768,126.932877
관악구,2164, 관악우체국,201906,438,501,939,37.484768,126.932877
관악구,2164, 관악우체국,201907,613,611,1224,37.484768,126.932877
관악구,2164, 관악우체국,201908,1145,1119,2264,37.484768,126.932877
관악구,2164, 관악우체국,201909,1138,1122,2260,37.484768,126.932877
관악구,2164, 관악우체국,201910,1326,1305,2631,37.484768,126.932877
관악구,2164, 관악우체국,201911,934,928,1862,37.484768,126.932877
관악구,2164, 관악우체국,201912,492,488,980,37.484768,126.932877
관악구,2164, 관악우체국,202001,430,444,874,37.484768,126.932877
관악구,2164, 관악우체국,202002,457,449,906,37.484768,126.932877
관악구,2164, 관악우체국,202003,691,685,1376,37.484768,126.932877
관악구,2164, 관악우체국,202004,1149,1147,2296,37.484768,126.932877
관악구,2164, 관악우체국,202005,1343,1336,2679,37.484768,126.932877
관악구,2164, 관악우체국,202006,1693,1671,3364,37.484768,126.932877
관악구,2165, JK장평타워,201901,108,102,210,37.476482,126.965363
관악구,2165, JK장평타워,201902,102,78,180,37.476482,126.965363
관악구,2165, JK장평타워,201903,195,152,347,37.476482,126.965363
관악구,2165, JK장평타워,201904,406,301,707,37.476482,126.965363
관악구,2165, JK장평타워,201905,473,430,903,37.476482,126.965363
관악구,2165, JK장평타워,201906,487,456,943,37.476482,126.965363
관악구,2165, JK장평타워,201907,458,394,852,37.476482,126.965363
관악구,2165, JK장평타워,201908,354,303,657,37.476482,126.965363
관악구,2165, JK장평타워,201909,497,381,878,37.476482,126.965363
관악구,2165, JK장평타워,201910,424,393,817,37.476482,126.965363
관악구,2165, JK장평타워,201911,219,194,413,37.476482,126.965363
관악구,2165, JK장평타워,201912,174,132,306,37.476482,126.965363
관악구,2165, JK장평타워,202001,164,141,305,37.476482,126.965363
관악구,2165, JK장평타워,202002,79,79,158,37.476482,126.965363
관악구,2165, JK장평타워,202003,213,203,416,37.476482,126.965363
관악구,2165, JK장평타워,202004,399,320,719,37.476482,126.965363
관악구,2165, JK장평타워,202005,493,429,922,37.476482,126.965363
관악구,2165, JK장평타워,202006,385,321,706,37.476482,126.965363
관악구,2167, 낙성대역 1번출구,201901,129,111,240,37.476295,126.964958
관악구,2167, 낙성대역 1번출구,201902,125,120,245,37.476295,126.964958
관악구,2167, 낙성대역 1번출구,201903,255,217,472,37.476295,126.964958
관악구,2167, 낙성대역 1번출구,201904,557,468,1025,37.476295,126.964958
관악구,2167, 낙성대역 1번출구,201905,784,680,1464,37.476295,126.964958
관악구,2167, 낙성대역 1번출구,201906,773,704,1477,37.476295,126.964958
관악구,2167, 낙성대역 1번출구,201907,760,656,1416,37.476295,126.964958
관악구,2167, 낙성대역 1번출구,201908,686,614,1300,37.476295,126.964958
관악구,2167, 낙성대역 1번출구,201909,578,529,1107,37.476295,126.964958
관악구,2167, 낙성대역 1번출구,201910,672,617,1289,37.476295,126.964958
관악구,2167, 낙성대역 1번출구,201911,400,360,760,37.476295,126.964958
관악구,2167, 낙성대역 1번출구,201912,229,208,437,37.476295,126.964958
관악구,2167, 낙성대역 1번출구,202001,184,162,346,37.476295,126.964958
관악구,2167, 낙성대역 1번출구,202002,186,189,375,37.476295,126.964958
관악구,2167, 낙성대역 1번출구,202003,327,308,635,37.476295,126.964958
관악구,2167, 낙성대역 1번출구,202004,616,599,1215,37.476295,126.964958
관악구,2167, 낙성대역 1번출구,202005,654,638,1292,37.476295,126.964958
관악구,2167, 낙성대역 1번출구,202006,855,813,1668,37.476295,126.964958
관악구,2169, 봉천역 2번출구,201901,407,449,856,37.482189,126.942131
관악구,2169, 봉천역 2번출구,201902,309,318,627,37.482189,126.942131
관악구,2169, 봉천역 2번출구,201903,596,641,1237,37.482189,126.942131
관악구,2169, 봉천역 2번출구,201904,825,942,1767,37.482189,126.942131
관악구,2169, 봉천역 2번출구,201905,1440,1537,2977,37.482189,126.942131
관악구,2169, 봉천역 2번출구,201906,1587,1583,3170,37.482189,126.942131
관악구,2169, 봉천역 2번출구,201907,1579,1613,3192,37.482189,126.942131
관악구,2169, 봉천역 2번출구,201908,1556,1572,3128,37.482189,126.942131
관악구,2169, 봉천역 2번출구,201909,1418,1428,2846,37.482189,126.942131
관악구,2169, 봉천역 2번출구,201910,1667,1681,3348,37.482189,126.942131
관악구,2169, 봉천역 2번출구,201911,1092,1122,2214,37.482189,126.942131
관악구,2169, 봉천역 2번출구,201912,691,704,1395,37.482189,126.942131
관악구,2169, 봉천역 2번출구,202001,603,629,1232,37.482189,126.942131
관악구,2169, 봉천역 2번출구,202002,550,540,1090,37.482189,126.942131
관악구,2169, 봉천역 2번출구,202003,677,673,1350,37.482189,126.942131
관악구,2169, 봉천역 2번출구,202004,1233,1234,2467,37.482189,126.942131
관악구,2169, 봉천역 2번출구,202005,1475,1490,2965,37.482189,126.942131
관악구,2169, 봉천역 2번출구,202006,1638,1628,3266,37.482189,126.942131
관악구,2170, 조원동서울본병원,201901,142,146,288,37.481529,126.912033
관악구,2170, 조원동서울본병원,201902,126,116,242,37.481529,126.912033
관악구,2170, 조원동서울본병원,201903,304,296,600,37.481529,126.912033
관악구,2170, 조원동서울본병원,201904,478,463,941,37.481529,126.912033
관악구,2170, 조원동서울본병원,201905,757,768,1525,37.481529,126.912033
관악구,2170, 조원동서울본병원,201906,949,953,1902,37.481529,126.912033
관악구,2170, 조원동서울본병원,201907,888,887,1775,37.481529,126.912033
관악구,2170, 조원동서울본병원,201908,893,858,1751,37.481529,126.912033
관악구,2170, 조원동서울본병원,201909,734,731,1465,37.481529,126.912033
관악구,2170, 조원동서울본병원,201910,862,849,1711,37.481529,126.912033
관악구,2170, 조원동서울본병원,201911,580,585,1165,37.481529,126.912033
관악구,2170, 조원동서울본병원,201912,435,422,857,37.481529,126.912033
관악구,2170, 조원동서울본병원,202001,404,392,796,37.481529,126.912033
관악구,2170, 조원동서울본병원,202002,351,350,701,37.481529,126.912033
관악구,2170, 조원동서울본병원,202003,556,565,1121,37.481529,126.912033
관악구,2170, 조원동서울본병원,202004,926,945,1871,37.481529,126.912033
관악구,2170, 조원동서울본병원,202005,1081,1075,2156,37.481529,126.912033
관악구,2170, 조원동서울본병원,202006,1492,1528,3020,37.481529,126.912033
관악구,2171, 서울대입구역 5번출구,201901,384,364,748,37.481548,126.952003
관악구,2171, 서울대입구역 5번출구,201902,303,279,582,37.481548,126.952003
관악구,2171, 서울대입구역 5번출구,201903,587,514,1101,37.481548,126.952003
관악구,2171, 서울대입구역 5번출구,201904,1090,989,2079,37.481548,126.952003
관악구,2171, 서울대입구역 5번출구,201905,1640,1484,3124,37.481548,126.952003
관악구,2171, 서울대입구역 5번출구,201906,1748,1614,3362,37.481548,126.952003
관악구,2171, 서울대입구역 5번출구,201907,1539,1429,2968,37.481548,126.952003
관악구,2171, 서울대입구역 5번출구,201908,1534,1431,2965,37.481548,126.952003
관악구,2171, 서울대입구역 5번출구,201909,1503,1447,2950,37.481548,126.952003
관악구,2171, 서울대입구역 5번출구,201910,1574,1545,3119,37.481548,126.952003
관악구,2171, 서울대입구역 5번출구,201911,1004,965,1969,37.481548,126.952003
관악구,2171, 서울대입구역 5번출구,201912,613,489,1102,37.481548,126.952003
관악구,2171, 서울대입구역 5번출구,202001,525,424,949,37.481548,126.952003
관악구,2171, 서울대입구역 5번출구,202002,564,445,1009,37.481548,126.952003
관악구,2171, 서울대입구역 5번출구,202003,970,787,1757,37.481548,126.952003
관악구,2171, 서울대입구역 5번출구,202004,1266,1211,2477,37.481548,126.952003
관악구,2171, 서울대입구역 5번출구,202005,1417,1365,2782,37.481548,126.952003
관악구,2171, 서울대입구역 5번출구,202006,1880,1813,3693,37.481548,126.952003
관악구,2172, 나들목공원,201901,323,228,551,37.469406,126.944511
관악구,2172, 나들목공원,201902,228,165,393,37.469406,126.944511
관악구,2172, 나들목공원,201903,413,287,700,37.469406,126.944511
관악구,2172, 나들목공원,201904,792,524,1316,37.469406,126.944511
관악구,2172, 나들목공원,201905,908,601,1509,37.469406,126.944511
관악구,2172, 나들목공원,201906,766,612,1378,37.469406,126.944511
관악구,2172, 나들목공원,201907,804,601,1405,37.469406,126.944511
관악구,2172, 나들목공원,201908,675,568,1243,37.469406,126.944511
관악구,2172, 나들목공원,201909,502,425,927,37.469406,126.944511
관악구,2172, 나들목공원,201910,569,488,1057,37.469406,126.944511
관악구,2172, 나들목공원,201911,395,310,705,37.469406,126.944511
관악구,2172, 나들목공원,201912,375,232,607,37.469406,126.944511
관악구,2172, 나들목공원,202001,412,281,693,37.469406,126.944511
관악구,2172, 나들목공원,202002,266,145,411,37.469406,126.944511
관악구,2172, 나들목공원,202003,331,238,569,37.469406,126.944511
관악구,2172, 나들목공원,202004,524,401,925,37.469406,126.944511
관악구,2172, 나들목공원,202005,475,419,894,37.469406,126.944511
관악구,2172, 나들목공원,202006,526,377,903,37.469406,126.944511
관악구,2173, 당곡사거리,201901,854,991,1845,37.48975,126.927467
관악구,2173, 당곡사거리,201902,801,855,1656,37.48975,126.927467
관악구,2173, 당곡사거리,201903,1573,1682,3255,37.48975,126.927467
관악구,2173, 당곡사거리,201904,2326,2552,4878,37.48975,126.927467
관악구,2173, 당곡사거리,201905,3843,4201,8044,37.48975,126.927467
관악구,2173, 당곡사거리,201906,4626,4828,9454,37.48975,126.927467
관악구,2173, 당곡사거리,201907,4216,4363,8579,37.48975,126.927467
관악구,2173, 당곡사거리,201908,4018,4175,8193,37.48975,126.927467
관악구,2173, 당곡사거리,201909,3876,3999,7875,37.48975,126.927467
관악구,2173, 당곡사거리,201910,4377,4502,8879,37.48975,126.927467
관악구,2173, 당곡사거리,201911,2802,2860,5662,37.48975,126.927467
관악구,2173, 당곡사거리,201912,1671,1685,3356,37.48975,126.927467
관악구,2173, 당곡사거리,202001,1421,1443,2864,37.48975,126.927467
관악구,2173, 당곡사거리,202002,1413,1427,2840,37.48975,126.927467
관악구,2173, 당곡사거리,202003,2455,2472,4927,37.48975,126.927467
관악구,2173, 당곡사거리,202004,4171,4265,8436,37.48975,126.927467
관악구,2173, 당곡사거리,202005,4914,4936,9850,37.48975,126.927467
관악구,2173, 당곡사거리,202006,5457,5623,11080,37.48975,126.927467
관악구,2174, 삼성디지털프라자관악점,201901,326,318,644,37.488564,126.928482
관악구,2174, 삼성디지털프라자관악점,201902,236,227,463,37.488564,126.928482
관악구,2174, 삼성디지털프라자관악점,201903,434,419,853,37.488564,126.928482
관악구,2174, 삼성디지털프라자관악점,201904,629,540,1169,37.488564,126.928482
관악구,2174, 삼성디지털프라자관악점,201905,861,798,1659,37.488564,126.928482
관악구,2174, 삼성디지털프라자관악점,201906,872,806,1678,37.488564,126.928482
관악구,2174, 삼성디지털프라자관악점,201907,979,909,1888,37.488564,126.928482
관악구,2174, 삼성디지털프라자관악점,201908,960,873,1833,37.488564,126.928482
관악구,2174, 삼성디지털프라자관악점,201909,790,725,1515,37.488564,126.928482
관악구,2174, 삼성디지털프라자관악점,201910,959,893,1852,37.488564,126.928482
관악구,2174, 삼성디지털프라자관악점,201911,697,612,1309,37.488564,126.928482
관악구,2174, 삼성디지털프라자관악점,201912,354,341,695,37.488564,126.928482
관악구,2174, 삼성디지털프라자관악점,202001,288,287,575,37.488564,126.928482
관악구,2174, 삼성디지털프라자관악점,202002,288,291,579,37.488564,126.928482
관악구,2174, 삼성디지털프라자관악점,202003,457,456,913,37.488564,126.928482
관악구,2174, 삼성디지털프라자관악점,202004,932,864,1796,37.488564,126.928482
관악구,2174, 삼성디지털프라자관악점,202005,914,900,1814,37.488564,126.928482
관악구,2174, 삼성디지털프라자관악점,202006,1121,1063,2184,37.488564,126.928482
관악구,2175, 신림동걷고싶은문화의거리입구,201901,108,116,224,37.487301,126.928703
관악구,2175, 신림동걷고싶은문화의거리입구,201902,103,98,201,37.487301,126.928703
관악구,2175, 신림동걷고싶은문화의거리입구,201903,203,206,409,37.487301,126.928703
관악구,2175, 신림동걷고싶은문화의거리입구,201904,385,317,702,37.487301,126.928703
관악구,2175, 신림동걷고싶은문화의거리입구,201905,487,453,940,37.487301,126.928703
관악구,2175, 신림동걷고싶은문화의거리입구,201906,524,472,996,37.487301,126.928703
관악구,2175, 신림동걷고싶은문화의거리입구,201907,550,511,1061,37.487301,126.928703
관악구,2175, 신림동걷고싶은문화의거리입구,201908,431,428,859,37.487301,126.928703
관악구,2175, 신림동걷고싶은문화의거리입구,201909,411,408,819,37.487301,126.928703
관악구,2175, 신림동걷고싶은문화의거리입구,201910,473,456,929,37.487301,126.928703
관악구,2175, 신림동걷고싶은문화의거리입구,201911,308,299,607,37.487301,126.928703
관악구,2175, 신림동걷고싶은문화의거리입구,201912,151,153,304,37.487301,126.928703
관악구,2175, 신림동걷고싶은문화의거리입구,202001,172,167,339,37.487301,126.928703
관악구,2175, 신림동걷고싶은문화의거리입구,202002,133,139,272,37.487301,126.928703
관악구,2175, 신림동걷고싶은문화의거리입구,202003,607,615,1222,37.487301,126.928703
관악구,2175, 신림동걷고싶은문화의거리입구,202004,1203,1180,2383,37.487301,126.928703
관악구,2175, 신림동걷고싶은문화의거리입구,202005,1286,1283,2569,37.487301,126.928703
관악구,2175, 신림동걷고싶은문화의거리입구,202006,1567,1574,3141,37.487301,126.928703
관악구,2176, 보라매공원 보도육교,201901,356,341,697,37.488991,126.916382
관악구,2176, 보라매공원 보도육교,201902,280,271,551,37.488991,126.916382
관악구,2176, 보라매공원 보도육교,201903,647,650,1297,37.488991,126.916382
관악구,2176, 보라매공원 보도육교,201904,1142,1125,2267,37.488991,126.916382
관악구,2176, 보라매공원 보도육교,201905,1835,1832,3667,37.488991,126.916382
관악구,2176, 보라매공원 보도육교,201906,1991,1971,3962,37.488991,126.916382
관악구,2176, 보라매공원 보도육교,201907,2149,2188,4337,37.488991,126.916382
관악구,2176, 보라매공원 보도육교,201908,2081,2071,4152,37.488991,126.916382
관악구,2176, 보라매공원 보도육교,201909,1944,1939,3883,37.488991,126.916382
관악구,2176, 보라매공원 보도육교,201910,2025,2014,4039,37.488991,126.916382
관악구,2176, 보라매공원 보도육교,201911,1189,1227,2416,37.488991,126.916382
관악구,2176, 보라매공원 보도육교,201912,526,503,1029,37.488991,126.916382
관악구,2176, 보라매공원 보도육교,202001,590,579,1169,37.488991,126.916382
관악구,2176, 보라매공원 보도육교,202002,613,585,1198,37.488991,126.916382
관악구,2176, 보라매공원 보도육교,202003,1133,1136,2269,37.488991,126.916382
관악구,2176, 보라매공원 보도육교,202004,1914,1908,3822,37.488991,126.916382
관악구,2176, 보라매공원 보도육교,202005,2346,2345,4691,37.488991,126.916382
관악구,2176, 보라매공원 보도육교,202006,2987,2973,5960,37.488991,126.916382
관악구,2177, 신대방역 2번 출구,201901,915,973,1888,37.487129,126.913017
관악구,2177, 신대방역 2번 출구,201902,855,878,1733,37.487129,126.913017
관악구,2177, 신대방역 2번 출구,201903,1743,1782,3525,37.487129,126.913017
관악구,2177, 신대방역 2번 출구,201904,3080,3182,6262,37.487129,126.913017
관악구,2177, 신대방역 2번 출구,201905,4978,5247,10225,37.487129,126.913017
관악구,2177, 신대방역 2번 출구,201906,5663,5937,11600,37.487129,126.913017
관악구,2177, 신대방역 2번 출구,201907,5351,5692,11043,37.487129,126.913017
관악구,2177, 신대방역 2번 출구,201908,5102,5408,10510,37.487129,126.913017
관악구,2177, 신대방역 2번 출구,201909,4861,5105,9966,37.487129,126.913017
관악구,2177, 신대방역 2번 출구,201910,5805,5933,11738,37.487129,126.913017
관악구,2177, 신대방역 2번 출구,201911,3365,3448,6813,37.487129,126.913017
관악구,2177, 신대방역 2번 출구,201912,2082,2086,4168,37.487129,126.913017
관악구,2177, 신대방역 2번 출구,202001,1922,1928,3850,37.487129,126.913017
관악구,2177, 신대방역 2번 출구,202002,1822,1816,3638,37.487129,126.913017
관악구,2177, 신대방역 2번 출구,202003,3313,3328,6641,37.487129,126.913017
관악구,2177, 신대방역 2번 출구,202004,5674,5679,11353,37.487129,126.913017
관악구,2177, 신대방역 2번 출구,202005,6654,6668,13322,37.487129,126.913017
관악구,2177, 신대방역 2번 출구,202006,8061,8100,16161,37.487129,126.913017
관악구,2178, 서울대학교 정문,201901,331,207,538,37.46682,126.948807
관악구,2178, 서울대학교 정문,201902,286,243,529,37.46682,126.948807
관악구,2178, 서울대학교 정문,201903,578,488,1066,37.46682,126.948807
관악구,2178, 서울대학교 정문,201904,1032,747,1779,37.46682,126.948807
관악구,2178, 서울대학교 정문,201905,1117,828,1945,37.46682,126.948807
관악구,2178, 서울대학교 정문,201906,787,683,1470,37.46682,126.948807
관악구,2178, 서울대학교 정문,201907,790,554,1344,37.46682,126.948807
관악구,2178, 서울대학교 정문,201908,719,515,1234,37.46682,126.948807
관악구,2178, 서울대학교 정문,201909,763,627,1390,37.46682,126.948807
관악구,2178, 서울대학교 정문,201910,772,717,1489,37.46682,126.948807
관악구,2178, 서울대학교 정문,201911,482,448,930,37.46682,126.948807
관악구,2178, 서울대학교 정문,201912,294,289,583,37.46682,126.948807
관악구,2178, 서울대학교 정문,202001,341,312,653,37.46682,126.948807
관악구,2178, 서울대학교 정문,202002,341,320,661,37.46682,126.948807
관악구,2178, 서울대학교 정문,202003,424,416,840,37.46682,126.948807
관악구,2178, 서울대학교 정문,202004,534,503,1037,37.46682,126.948807
관악구,2178, 서울대학교 정문,202005,591,552,1143,37.46682,126.948807
관악구,2178, 서울대학교 정문,202006,704,585,1289,37.46682,126.948807
관악구,2179, 양녕로 입구,201901,259,254,513,37.482189,126.946159
관악구,2179, 양녕로 입구,201902,258,246,504,37.482189,126.946159
관악구,2179, 양녕로 입구,201903,426,412,838,37.482189,126.946159
관악구,2179, 양녕로 입구,201904,764,737,1501,37.482189,126.946159
관악구,2179, 양녕로 입구,201905,1299,1269,2568,37.482189,126.946159
관악구,2179, 양녕로 입구,201906,1323,1312,2635,37.482189,126.946159
관악구,2179, 양녕로 입구,201907,1297,1261,2558,37.482189,126.946159
관악구,2179, 양녕로 입구,201908,1303,1241,2544,37.482189,126.946159
관악구,2179, 양녕로 입구,201909,1114,1094,2208,37.482189,126.946159
관악구,2179, 양녕로 입구,201910,1248,1210,2458,37.482189,126.946159
관악구,2179, 양녕로 입구,201911,820,808,1628,37.482189,126.946159
관악구,2179, 양녕로 입구,201912,399,391,790,37.482189,126.946159
관악구,2179, 양녕로 입구,202001,357,350,707,37.482189,126.946159
관악구,2179, 양녕로 입구,202002,359,359,718,37.482189,126.946159
관악구,2179, 양녕로 입구,202003,656,663,1319,37.482189,126.946159
관악구,2179, 양녕로 입구,202004,1262,1229,2491,37.482189,126.946159
관악구,2179, 양녕로 입구,202005,1211,1186,2397,37.482189,126.946159
관악구,2179, 양녕로 입구,202006,1682,1653,3335,37.482189,126.946159
관악구,2180, 신림동주민센터,201901,203,210,413,#N/A,#N/A
관악구,2180, 신림동주민센터,201902,203,207,410,#N/A,#N/A
관악구,2180, 신림동주민센터,201903,414,411,825,#N/A,#N/A
관악구,2180, 신림동주민센터,201904,647,601,1248,#N/A,#N/A
관악구,2180, 신림동주민센터,201905,1226,1225,2451,#N/A,#N/A
관악구,2180, 신림동주민센터,201906,1455,1362,2817,#N/A,#N/A
관악구,2180, 신림동주민센터,201907,1400,1300,2700,#N/A,#N/A
관악구,2180, 신림동주민센터,201908,1175,1149,2324,#N/A,#N/A
관악구,2180, 신림동주민센터,201909,1143,1126,2269,#N/A,#N/A
관악구,2180, 신림동주민센터,201910,1227,1217,2444,#N/A,#N/A
관악구,2180, 신림동주민센터,201911,702,706,1408,#N/A,#N/A
관악구,2180, 신림동주민센터,201912,390,381,771,#N/A,#N/A
관악구,2180, 신림동주민센터,202001,354,351,705,#N/A,#N/A
관악구,2180, 신림동주민센터,202002,387,398,785,#N/A,#N/A
관악구,2180, 신림동주민센터,202003,76,75,151,#N/A,#N/A
관악구,2180, 신림동주민센터,202004,4,15,19,#N/A,#N/A
관악구,2180, 신림동주민센터,202005,11,3,14,#N/A,#N/A
관악구,2180, 신림동주민센터,202006,6,4,10,#N/A,#N/A
관악구,2183, 동방1교,201901,1126,1268,2394,37.471828,126.933922
관악구,2183, 동방1교,201902,1091,1182,2273,37.471828,126.933922
관악구,2183, 동방1교,201903,2259,2412,4671,37.471828,126.933922
관악구,2183, 동방1교,201904,3609,3817,7426,37.471828,126.933922
관악구,2183, 동방1교,201905,6079,6284,12363,37.471828,126.933922
관악구,2183, 동방1교,201906,6327,6553,12880,37.471828,126.933922
관악구,2183, 동방1교,201907,5924,6082,12006,37.471828,126.933922
관악구,2183, 동방1교,201908,5474,5511,10985,37.471828,126.933922
관악구,2183, 동방1교,201909,5068,5196,10264,37.471828,126.933922
관악구,2183, 동방1교,201910,5825,5826,11651,37.471828,126.933922
관악구,2183, 동방1교,201911,3507,3475,6982,37.471828,126.933922
관악구,2183, 동방1교,201912,2060,1993,4053,37.471828,126.933922
관악구,2183, 동방1교,202001,2007,1927,3934,37.471828,126.933922
관악구,2183, 동방1교,202002,2006,2013,4019,37.471828,126.933922
관악구,2183, 동방1교,202003,3883,3886,7769,37.471828,126.933922
관악구,2183, 동방1교,202004,5688,5653,11341,37.471828,126.933922
관악구,2183, 동방1교,202005,5980,5935,11915,37.471828,126.933922
관악구,2183, 동방1교,202006,6664,6618,13282,37.471828,126.933922
관악구,2184, 구암초등학교 버스정류장,201901,133,82,215,37.489491,126.945923
관악구,2184, 구암초등학교 버스정류장,201902,67,54,121,37.489491,126.945923
관악구,2184, 구암초등학교 버스정류장,201903,187,89,276,37.489491,126.945923
관악구,2184, 구암초등학교 버스정류장,201904,363,208,571,37.489491,126.945923
관악구,2184, 구암초등학교 버스정류장,201905,481,377,858,37.489491,126.945923
관악구,2184, 구암초등학교 버스정류장,201906,450,392,842,37.489491,126.945923
관악구,2184, 구암초등학교 버스정류장,201907,430,365,795,37.489491,126.945923
관악구,2184, 구암초등학교 버스정류장,201908,337,298,635,37.489491,126.945923
관악구,2184, 구암초등학교 버스정류장,201909,302,293,595,37.489491,126.945923
관악구,2184, 구암초등학교 버스정류장,201910,302,277,579,37.489491,126.945923
관악구,2184, 구암초등학교 버스정류장,201911,217,186,403,37.489491,126.945923
관악구,2184, 구암초등학교 버스정류장,201912,104,105,209,37.489491,126.945923
관악구,2184, 구암초등학교 버스정류장,202001,165,165,330,37.489491,126.945923
관악구,2184, 구암초등학교 버스정류장,202002,112,107,219,37.489491,126.945923
관악구,2184, 구암초등학교 버스정류장,202003,155,159,314,37.489491,126.945923
관악구,2184, 구암초등학교 버스정류장,202004,353,275,628,37.489491,126.945923
관악구,2184, 구암초등학교 버스정류장,202005,323,298,621,37.489491,126.945923
관악구,2184, 구암초등학교 버스정류장,202006,319,264,583,37.489491,126.945923
관악구,2185, 대학동 고시촌,201909,75,76,151,37.470467,126.938652
관악구,2185, 대학동 고시촌,201910,1069,1044,2113,37.470467,126.938652
관악구,2185, 대학동 고시촌,201911,821,803,1624,37.470467,126.938652
관악구,2185, 대학동 고시촌,201912,602,592,1194,37.470467,126.938652
관악구,2185, 대학동 고시촌,202001,646,636,1282,37.470467,126.938652
관악구,2185, 대학동 고시촌,202002,545,555,1100,37.470467,126.938652
관악구,2185, 대학동 고시촌,202003,810,795,1605,37.470467,126.938652
관악구,2185, 대학동 고시촌,202004,1197,1158,2355,37.470467,126.938652
관악구,2185, 대학동 고시촌,202005,1207,1205,2412,37.470467,126.938652
관악구,2185, 대학동 고시촌,202006,1425,1381,2806,37.470467,126.938652
관악구,2186,우리은행 낙성대역지점,202006,212,204,416,37.478821,126.95961
관악구,2187,현대시장사거리(신한은행),202006,448,440,888,37.486736,126.947517
관악구,2189,삼성서비스센터(관악점),202006,303,300,603,37.482754,126.941406
관악구,2190,도원맨션,202006,124,123,247,37.483688,126.939156
관악구,2191,대학동주민센터,202006,269,268,537,37.470688,126.936485
관악구,2194,봉림교 남측,202006,51,49,100,#N/A,#N/A
관악구,2195,은천교회,202006,321,323,644,37.484646,126.934509
관악구,2196,삼화페인트 봉천점,202006,217,213,430,37.483311,126.939026
관악구,2198,사랑의병원,202006,253,241,494,37.479465,126.956932
관악구,2199,신봉천주유소,202006,106,85,191,37.478771,126.958695
관악구,2200,관악문화원 건너편,202006,26,22,48,37.468567,126.946755
서초구,2201, 본마을 정류소 앞,201901,61,48,109,37.453281,127.051483
서초구,2201, 본마을 정류소 앞,201902,54,48,102,37.453281,127.051483
서초구,2201, 본마을 정류소 앞,201903,93,93,186,37.453281,127.051483
서초구,2201, 본마을 정류소 앞,201904,207,218,425,37.453281,127.051483
서초구,2201, 본마을 정류소 앞,201905,281,275,556,37.453281,127.051483
서초구,2201, 본마을 정류소 앞,201906,284,283,567,37.453281,127.051483
서초구,2201, 본마을 정류소 앞,201907,230,245,475,37.453281,127.051483
서초구,2201, 본마을 정류소 앞,201908,282,276,558,37.453281,127.051483
서초구,2201, 본마을 정류소 앞,201909,216,200,416,37.453281,127.051483
서초구,2201, 본마을 정류소 앞,201910,259,275,534,37.453281,127.051483
서초구,2201, 본마을 정류소 앞,201911,175,181,356,37.453281,127.051483
서초구,2201, 본마을 정류소 앞,201912,108,108,216,37.453281,127.051483
서초구,2201, 본마을 정류소 앞,202001,82,80,162,37.453281,127.051483
서초구,2201, 본마을 정류소 앞,202002,70,57,127,37.453281,127.051483
서초구,2201, 본마을 정류소 앞,202003,228,202,430,37.453281,127.051483
서초구,2201, 본마을 정류소 앞,202004,255,207,462,37.453281,127.051483
서초구,2201, 본마을 정류소 앞,202005,330,299,629,37.453281,127.051483
서초구,2201, 본마을 정류소 앞,202006,245,222,467,37.453281,127.051483
서초구,2202,청계산입구역 1번출구,201901,571,568,1139,37.448936,127.054375
서초구,2202,청계산입구역 1번출구,201902,494,479,973,37.448936,127.054375
서초구,2202,청계산입구역 1번출구,201903,833,913,1746,37.448936,127.054375
서초구,2202,청계산입구역 1번출구,201904,1079,1146,2225,37.448936,127.054375
서초구,2202,청계산입구역 1번출구,201905,1554,1618,3172,37.448936,127.054375
서초구,2202,청계산입구역 1번출구,201906,1749,1802,3551,37.448936,127.054375
서초구,2202,청계산입구역 1번출구,201907,1620,1736,3356,37.448936,127.054375
서초구,2202,청계산입구역 1번출구,201908,1604,1653,3257,37.448936,127.054375
서초구,2202,청계산입구역 1번출구,201909,1544,1528,3072,37.448936,127.054375
서초구,2202,청계산입구역 1번출구,201910,1643,1603,3246,37.448936,127.054375
서초구,2202,청계산입구역 1번출구,201911,1305,1298,2603,37.448936,127.054375
서초구,2202,청계산입구역 1번출구,201912,862,853,1715,37.448936,127.054375
서초구,2202,청계산입구역 1번출구,202001,751,741,1492,37.448936,127.054375
서초구,2202,청계산입구역 1번출구,202002,618,621,1239,37.448936,127.054375
서초구,2202,청계산입구역 1번출구,202003,777,768,1545,37.448936,127.054375
서초구,2202,청계산입구역 1번출구,202004,976,945,1921,37.448936,127.054375
서초구,2202,청계산입구역 1번출구,202005,877,865,1742,37.448936,127.054375
서초구,2202,청계산입구역 1번출구,202006,1231,1194,2425,37.448936,127.054375
서초구,2203, 청계산입구역 2번출구,201901,54,53,107,37.447659,127.055016
서초구,2203, 청계산입구역 2번출구,201902,69,51,120,37.447659,127.055016
서초구,2203, 청계산입구역 2번출구,201903,140,111,251,37.447659,127.055016
서초구,2203, 청계산입구역 2번출구,201904,222,187,409,37.447659,127.055016
서초구,2203, 청계산입구역 2번출구,201905,246,196,442,37.447659,127.055016
서초구,2203, 청계산입구역 2번출구,201906,293,214,507,37.447659,127.055016
서초구,2203, 청계산입구역 2번출구,201907,356,247,603,37.447659,127.055016
서초구,2203, 청계산입구역 2번출구,201908,256,165,421,37.447659,127.055016
서초구,2203, 청계산입구역 2번출구,201909,236,173,409,37.447659,127.055016
서초구,2203, 청계산입구역 2번출구,201910,268,215,483,37.447659,127.055016
서초구,2203, 청계산입구역 2번출구,201911,222,158,380,37.447659,127.055016
서초구,2203, 청계산입구역 2번출구,201912,126,77,203,37.447659,127.055016
서초구,2203, 청계산입구역 2번출구,202001,121,95,216,37.447659,127.055016
서초구,2203, 청계산입구역 2번출구,202002,124,107,231,37.447659,127.055016
서초구,2203, 청계산입구역 2번출구,202003,201,161,362,37.447659,127.055016
서초구,2203, 청계산입구역 2번출구,202004,257,219,476,37.447659,127.055016
서초구,2203, 청계산입구역 2번출구,202005,225,216,441,37.447659,127.055016
서초구,2203, 청계산입구역 2번출구,202006,275,230,505,37.447659,127.055016
서초구,2205, 내곡3단지 어린이공원 앞,201901,272,259,531,37.453751,127.05938
서초구,2205, 내곡3단지 어린이공원 앞,201902,234,191,425,37.453751,127.05938
서초구,2205, 내곡3단지 어린이공원 앞,201903,431,317,748,37.453751,127.05938
서초구,2205, 내곡3단지 어린이공원 앞,201904,626,496,1122,37.453751,127.05938
서초구,2205, 내곡3단지 어린이공원 앞,201905,731,639,1370,37.453751,127.05938
서초구,2205, 내곡3단지 어린이공원 앞,201906,811,723,1534,37.453751,127.05938
서초구,2205, 내곡3단지 어린이공원 앞,201907,755,660,1415,37.453751,127.05938
서초구,2205, 내곡3단지 어린이공원 앞,201908,690,572,1262,37.453751,127.05938
서초구,2205, 내곡3단지 어린이공원 앞,201909,620,555,1175,37.453751,127.05938
서초구,2205, 내곡3단지 어린이공원 앞,201910,573,452,1025,37.453751,127.05938
서초구,2205, 내곡3단지 어린이공원 앞,201911,513,377,890,37.453751,127.05938
서초구,2205, 내곡3단지 어린이공원 앞,201912,289,276,565,37.453751,127.05938
서초구,2205, 내곡3단지 어린이공원 앞,202001,318,272,590,37.453751,127.05938
서초구,2205, 내곡3단지 어린이공원 앞,202002,305,282,587,37.453751,127.05938
서초구,2205, 내곡3단지 어린이공원 앞,202003,441,345,786,37.453751,127.05938
서초구,2205, 내곡3단지 어린이공원 앞,202004,457,394,851,37.453751,127.05938
서초구,2205, 내곡3단지 어린이공원 앞,202005,500,437,937,37.453751,127.05938
서초구,2205, 내곡3단지 어린이공원 앞,202006,730,687,1417,37.453751,127.05938
서초구,2206, 언남초등학교 앞,201901,399,389,788,37.454357,127.062103
서초구,2206, 언남초등학교 앞,201902,338,325,663,37.454357,127.062103
서초구,2206, 언남초등학교 앞,201903,664,617,1281,37.454357,127.062103
서초구,2206, 언남초등학교 앞,201904,937,874,1811,37.454357,127.062103
서초구,2206, 언남초등학교 앞,201905,1202,1158,2360,37.454357,127.062103
서초구,2206, 언남초등학교 앞,201906,1320,1243,2563,37.454357,127.062103
서초구,2206, 언남초등학교 앞,201907,1130,1140,2270,37.454357,127.062103
서초구,2206, 언남초등학교 앞,201908,1154,1171,2325,37.454357,127.062103
서초구,2206, 언남초등학교 앞,201909,1078,1033,2111,37.454357,127.062103
서초구,2206, 언남초등학교 앞,201910,1219,1177,2396,37.454357,127.062103
서초구,2206, 언남초등학교 앞,201911,961,925,1886,37.454357,127.062103
서초구,2206, 언남초등학교 앞,201912,585,571,1156,37.454357,127.062103
서초구,2206, 언남초등학교 앞,202001,501,498,999,37.454357,127.062103
서초구,2206, 언남초등학교 앞,202002,493,497,990,37.454357,127.062103
서초구,2206, 언남초등학교 앞,202003,710,688,1398,37.454357,127.062103
서초구,2206, 언남초등학교 앞,202004,966,922,1888,37.454357,127.062103
서초구,2206, 언남초등학교 앞,202005,959,880,1839,37.454357,127.062103
서초구,2206, 언남초등학교 앞,202006,1174,1083,2257,37.454357,127.062103
서초구,2207, 내곡파출소 뒤 정자,201901,34,21,55,37.454407,127.064926
서초구,2207, 내곡파출소 뒤 정자,201902,59,42,101,37.454407,127.064926
서초구,2207, 내곡파출소 뒤 정자,201903,124,64,188,37.454407,127.064926
서초구,2207, 내곡파출소 뒤 정자,201904,180,125,305,37.454407,127.064926
서초구,2207, 내곡파출소 뒤 정자,201905,194,158,352,37.454407,127.064926
서초구,2207, 내곡파출소 뒤 정자,201906,166,130,296,37.454407,127.064926
서초구,2207, 내곡파출소 뒤 정자,201907,167,148,315,37.454407,127.064926
서초구,2207, 내곡파출소 뒤 정자,201908,191,150,341,37.454407,127.064926
서초구,2207, 내곡파출소 뒤 정자,201909,189,127,316,37.454407,127.064926
서초구,2207, 내곡파출소 뒤 정자,201910,203,160,363,37.454407,127.064926
서초구,2207, 내곡파출소 뒤 정자,201911,128,93,221,37.454407,127.064926
서초구,2207, 내곡파출소 뒤 정자,201912,83,58,141,37.454407,127.064926
서초구,2207, 내곡파출소 뒤 정자,202001,67,48,115,37.454407,127.064926
서초구,2207, 내곡파출소 뒤 정자,202002,41,21,62,37.454407,127.064926
서초구,2207, 내곡파출소 뒤 정자,202003,104,62,166,37.454407,127.064926
서초구,2207, 내곡파출소 뒤 정자,202004,115,86,201,37.454407,127.064926
서초구,2207, 내곡파출소 뒤 정자,202005,132,89,221,37.454407,127.064926
서초구,2207, 내곡파출소 뒤 정자,202006,131,108,239,37.454407,127.064926
서초구,2210, 반포1동 주민센터 앞,201901,85,56,141,37.505096,127.013107
서초구,2210, 반포1동 주민센터 앞,201902,98,75,173,37.505096,127.013107
서초구,2210, 반포1동 주민센터 앞,201903,187,164,351,37.505096,127.013107
서초구,2210, 반포1동 주민센터 앞,201904,400,306,706,37.505096,127.013107
서초구,2210, 반포1동 주민센터 앞,201905,524,466,990,37.505096,127.013107
서초구,2210, 반포1동 주민센터 앞,201906,633,501,1134,37.505096,127.013107
서초구,2210, 반포1동 주민센터 앞,201907,674,558,1232,37.505096,127.013107
서초구,2210, 반포1동 주민센터 앞,201908,520,416,936,37.505096,127.013107
서초구,2210, 반포1동 주민센터 앞,201909,556,409,965,37.505096,127.013107
서초구,2210, 반포1동 주민센터 앞,201910,533,444,977,37.505096,127.013107
서초구,2210, 반포1동 주민센터 앞,201911,389,283,672,37.505096,127.013107
서초구,2210, 반포1동 주민센터 앞,201912,173,132,305,37.505096,127.013107
서초구,2210, 반포1동 주민센터 앞,202001,167,113,280,37.505096,127.013107
서초구,2210, 반포1동 주민센터 앞,202002,190,128,318,37.505096,127.013107
서초구,2210, 반포1동 주민센터 앞,202003,380,261,641,37.505096,127.013107
서초구,2210, 반포1동 주민센터 앞,202004,506,442,948,37.505096,127.013107
서초구,2210, 반포1동 주민센터 앞,202005,617,477,1094,37.505096,127.013107
서초구,2210, 반포1동 주민센터 앞,202006,623,500,1123,37.505096,127.013107
서초구,2211, 서초구립반포도서관 앞,201901,257,249,506,37.502636,127.012314
서초구,2211, 서초구립반포도서관 앞,201902,246,240,486,37.502636,127.012314
서초구,2211, 서초구립반포도서관 앞,201903,591,571,1162,37.502636,127.012314
서초구,2211, 서초구립반포도서관 앞,201904,839,830,1669,37.502636,127.012314
서초구,2211, 서초구립반포도서관 앞,201905,1156,1077,2233,37.502636,127.012314
서초구,2211, 서초구립반포도서관 앞,201906,1188,1099,2287,37.502636,127.012314
서초구,2211, 서초구립반포도서관 앞,201907,1090,1005,2095,37.502636,127.012314
서초구,2211, 서초구립반포도서관 앞,201908,1077,990,2067,37.502636,127.012314
서초구,2211, 서초구립반포도서관 앞,201909,978,888,1866,37.502636,127.012314
서초구,2211, 서초구립반포도서관 앞,201910,1238,1097,2335,37.502636,127.012314
서초구,2211, 서초구립반포도서관 앞,201911,831,774,1605,37.502636,127.012314
서초구,2211, 서초구립반포도서관 앞,201912,456,448,904,37.502636,127.012314
서초구,2211, 서초구립반포도서관 앞,202001,412,375,787,37.502636,127.012314
서초구,2211, 서초구립반포도서관 앞,202002,289,246,535,37.502636,127.012314
서초구,2211, 서초구립반포도서관 앞,202003,499,434,933,37.502636,127.012314
서초구,2211, 서초구립반포도서관 앞,202004,899,855,1754,37.502636,127.012314
서초구,2211, 서초구립반포도서관 앞,202005,976,923,1899,37.502636,127.012314
서초구,2211, 서초구립반포도서관 앞,202006,993,925,1918,37.502636,127.012314
서초구,2212,서초현대4차아파트 201동 맞은편,201901,177,161,338,37.500961,127.017929
서초구,2212,서초현대4차아파트 201동 맞은편,201902,168,149,317,37.500961,127.017929
서초구,2212,서초현대4차아파트 201동 맞은편,201903,335,283,618,37.500961,127.017929
서초구,2212,서초현대4차아파트 201동 맞은편,201904,410,382,792,37.500961,127.017929
서초구,2212,서초현대4차아파트 201동 맞은편,201905,634,541,1175,37.500961,127.017929
서초구,2212,서초현대4차아파트 201동 맞은편,201906,697,584,1281,37.500961,127.017929
서초구,2212,서초현대4차아파트 201동 맞은편,201907,653,555,1208,37.500961,127.017929
서초구,2212,서초현대4차아파트 201동 맞은편,201908,669,547,1216,37.500961,127.017929
서초구,2212,서초현대4차아파트 201동 맞은편,201909,478,426,904,37.500961,127.017929
서초구,2212,서초현대4차아파트 201동 맞은편,201910,671,550,1221,37.500961,127.017929
서초구,2212,서초현대4차아파트 201동 맞은편,201911,419,346,765,37.500961,127.017929
서초구,2212,서초현대4차아파트 201동 맞은편,201912,234,224,458,37.500961,127.017929
서초구,2212,서초현대4차아파트 201동 맞은편,202001,264,193,457,37.500961,127.017929
서초구,2212,서초현대4차아파트 201동 맞은편,202002,145,144,289,37.500961,127.017929
서초구,2212,서초현대4차아파트 201동 맞은편,202003,371,291,662,37.500961,127.017929
서초구,2212,서초현대4차아파트 201동 맞은편,202004,425,362,787,37.500961,127.017929
서초구,2212,서초현대4차아파트 201동 맞은편,202005,474,449,923,37.500961,127.017929
서초구,2212,서초현대4차아파트 201동 맞은편,202006,460,396,856,37.500961,127.017929
서초구,2213, 고속터미널역 5번출구 앞,201901,314,256,570,37.502232,127.002258
서초구,2213, 고속터미널역 5번출구 앞,201902,312,248,560,37.502232,127.002258
서초구,2213, 고속터미널역 5번출구 앞,201903,658,498,1156,37.502232,127.002258
서초구,2213, 고속터미널역 5번출구 앞,201904,1267,873,2140,37.502232,127.002258
서초구,2213, 고속터미널역 5번출구 앞,201905,1669,1226,2895,37.502232,127.002258
서초구,2213, 고속터미널역 5번출구 앞,201906,1845,1343,3188,37.502232,127.002258
서초구,2213, 고속터미널역 5번출구 앞,201907,1458,1052,2510,37.502232,127.002258
서초구,2213, 고속터미널역 5번출구 앞,201908,1559,1027,2586,37.502232,127.002258
서초구,2213, 고속터미널역 5번출구 앞,201909,1543,1142,2685,37.502232,127.002258
서초구,2213, 고속터미널역 5번출구 앞,201910,2023,1574,3597,37.502232,127.002258
서초구,2213, 고속터미널역 5번출구 앞,201911,1206,902,2108,37.502232,127.002258
서초구,2213, 고속터미널역 5번출구 앞,201912,638,412,1050,37.502232,127.002258
서초구,2213, 고속터미널역 5번출구 앞,202001,636,385,1021,37.502232,127.002258
서초구,2213, 고속터미널역 5번출구 앞,202002,626,382,1008,37.502232,127.002258
서초구,2213, 고속터미널역 5번출구 앞,202003,1271,901,2172,37.502232,127.002258
서초구,2213, 고속터미널역 5번출구 앞,202004,1597,1231,2828,37.502232,127.002258
서초구,2213, 고속터미널역 5번출구 앞,202005,1573,1277,2850,37.502232,127.002258
서초구,2213, 고속터미널역 5번출구 앞,202006,1636,1379,3015,37.502232,127.002258
서초구,2214, 신반포역 2번출구 앞,201901,143,153,296,37.504116,126.99749
서초구,2214, 신반포역 2번출구 앞,201902,160,202,362,37.504116,126.99749
서초구,2214, 신반포역 2번출구 앞,201903,444,514,958,37.504116,126.99749
서초구,2214, 신반포역 2번출구 앞,201904,1036,1125,2161,37.504116,126.99749
서초구,2214, 신반포역 2번출구 앞,201905,2291,2381,4672,37.504116,126.99749
서초구,2214, 신반포역 2번출구 앞,201906,1968,1982,3950,37.504116,126.99749
서초구,2214, 신반포역 2번출구 앞,201907,1594,1607,3201,37.504116,126.99749
서초구,2214, 신반포역 2번출구 앞,201908,1874,1882,3756,37.504116,126.99749
서초구,2214, 신반포역 2번출구 앞,201909,2040,2040,4080,37.504116,126.99749
서초구,2214, 신반포역 2번출구 앞,201910,1947,1990,3937,37.504116,126.99749
서초구,2214, 신반포역 2번출구 앞,201911,768,737,1505,37.504116,126.99749
서초구,2214, 신반포역 2번출구 앞,201912,322,315,637,37.504116,126.99749
서초구,2214, 신반포역 2번출구 앞,202001,304,326,630,37.504116,126.99749
서초구,2214, 신반포역 2번출구 앞,202002,413,411,824,37.504116,126.99749
서초구,2214, 신반포역 2번출구 앞,202003,1825,1924,3749,37.504116,126.99749
서초구,2214, 신반포역 2번출구 앞,202004,2223,2283,4506,37.504116,126.99749
서초구,2214, 신반포역 2번출구 앞,202005,2433,2453,4886,37.504116,126.99749
서초구,2214, 신반포역 2번출구 앞,202006,1857,1871,3728,37.504116,126.99749
서초구,2215, 반포종합운동장 입구,201901,146,150,296,37.501713,126.995476
서초구,2215, 반포종합운동장 입구,201902,160,168,328,37.501713,126.995476
서초구,2215, 반포종합운동장 입구,201903,327,353,680,37.501713,126.995476
서초구,2215, 반포종합운동장 입구,201904,639,676,1315,37.501713,126.995476
서초구,2215, 반포종합운동장 입구,201905,983,990,1973,37.501713,126.995476
서초구,2215, 반포종합운동장 입구,201906,1153,1136,2289,37.501713,126.995476
서초구,2215, 반포종합운동장 입구,201907,1083,1076,2159,37.501713,126.995476
서초구,2215, 반포종합운동장 입구,201908,1151,1132,2283,37.501713,126.995476
서초구,2215, 반포종합운동장 입구,201909,1175,1105,2280,37.501713,126.995476
서초구,2215, 반포종합운동장 입구,201910,1144,1094,2238,37.501713,126.995476
서초구,2215, 반포종합운동장 입구,201911,555,588,1143,37.501713,126.995476
서초구,2215, 반포종합운동장 입구,201912,283,286,569,37.501713,126.995476
서초구,2215, 반포종합운동장 입구,202001,255,258,513,37.501713,126.995476
서초구,2215, 반포종합운동장 입구,202002,269,262,531,37.501713,126.995476
서초구,2215, 반포종합운동장 입구,202003,846,849,1695,37.501713,126.995476
서초구,2215, 반포종합운동장 입구,202004,1004,977,1981,37.501713,126.995476
서초구,2215, 반포종합운동장 입구,202005,1255,1259,2514,37.501713,126.995476
서초구,2215, 반포종합운동장 입구,202006,885,884,1769,37.501713,126.995476
서초구,2217,아크로리버뷰 부지 앞,201901,318,314,632,37.513046,127.005959
서초구,2217,아크로리버뷰 부지 앞,201902,369,356,725,37.513046,127.005959
서초구,2217,아크로리버뷰 부지 앞,201903,761,836,1597,37.513046,127.005959
서초구,2217,아크로리버뷰 부지 앞,201904,1506,1883,3389,37.513046,127.005959
서초구,2217,아크로리버뷰 부지 앞,201905,3170,3819,6989,37.513046,127.005959
서초구,2217,아크로리버뷰 부지 앞,201906,3150,3612,6762,37.513046,127.005959
서초구,2217,아크로리버뷰 부지 앞,201907,2715,3032,5747,37.513046,127.005959
서초구,2217,아크로리버뷰 부지 앞,201908,3074,3466,6540,37.513046,127.005959
서초구,2217,아크로리버뷰 부지 앞,201909,3378,3615,6993,37.513046,127.005959
서초구,2217,아크로리버뷰 부지 앞,201910,3154,3426,6580,37.513046,127.005959
서초구,2217,아크로리버뷰 부지 앞,201911,1411,1476,2887,37.513046,127.005959
서초구,2217,아크로리버뷰 부지 앞,201912,552,554,1106,37.513046,127.005959
서초구,2217,아크로리버뷰 부지 앞,202001,531,532,1063,37.513046,127.005959
서초구,2217,아크로리버뷰 부지 앞,202002,634,638,1272,37.513046,127.005959
서초구,2217,아크로리버뷰 부지 앞,202003,2981,3323,6304,37.513046,127.005959
서초구,2217,아크로리버뷰 부지 앞,202004,4060,4241,8301,37.513046,127.005959
서초구,2217,아크로리버뷰 부지 앞,202005,4814,4972,9786,37.513046,127.005959
서초구,2217,아크로리버뷰 부지 앞,202006,3820,3925,7745,37.513046,127.005959
서초구,2219," 고속터미널역 8-1번, 8-2번 출구 사이",201901,846,908,1754,37.506199,127.003944
서초구,2219," 고속터미널역 8-1번, 8-2번 출구 사이",201902,1034,1135,2169,37.506199,127.003944
서초구,2219," 고속터미널역 8-1번, 8-2번 출구 사이",201903,2615,2749,5364,37.506199,127.003944
서초구,2219," 고속터미널역 8-1번, 8-2번 출구 사이",201904,5436,5758,11194,37.506199,127.003944
서초구,2219," 고속터미널역 8-1번, 8-2번 출구 사이",201905,9977,10595,20572,37.506199,127.003944
서초구,2219," 고속터미널역 8-1번, 8-2번 출구 사이",201906,8880,9068,17948,37.506199,127.003944
서초구,2219," 고속터미널역 8-1번, 8-2번 출구 사이",201907,6768,6929,13697,37.506199,127.003944
서초구,2219," 고속터미널역 8-1번, 8-2번 출구 사이",201908,8268,8512,16780,37.506199,127.003944
서초구,2219," 고속터미널역 8-1번, 8-2번 출구 사이",201909,8969,9286,18255,37.506199,127.003944
서초구,2219," 고속터미널역 8-1번, 8-2번 출구 사이",201910,9279,9843,19122,37.506199,127.003944
서초구,2219," 고속터미널역 8-1번, 8-2번 출구 사이",201911,3930,4084,8014,37.506199,127.003944
서초구,2219," 고속터미널역 8-1번, 8-2번 출구 사이",201912,1668,1655,3323,37.506199,127.003944
서초구,2219," 고속터미널역 8-1번, 8-2번 출구 사이",202001,1587,1723,3310,37.506199,127.003944
서초구,2219," 고속터미널역 8-1번, 8-2번 출구 사이",202002,1770,1883,3653,37.506199,127.003944
서초구,2219," 고속터미널역 8-1번, 8-2번 출구 사이",202003,6962,7680,14642,37.506199,127.003944
서초구,2219," 고속터미널역 8-1번, 8-2번 출구 사이",202004,9652,10222,19874,37.506199,127.003944
서초구,2219," 고속터미널역 8-1번, 8-2번 출구 사이",202005,11480,11892,23372,37.506199,127.003944
서초구,2219," 고속터미널역 8-1번, 8-2번 출구 사이",202006,9103,9374,18477,37.506199,127.003944
서초구,2220, 반포본동 주민센터 앞,201901,423,450,873,37.500614,126.98616
서초구,2220, 반포본동 주민센터 앞,201902,492,528,1020,37.500614,126.98616
서초구,2220, 반포본동 주민센터 앞,201903,936,1083,2019,37.500614,126.98616
서초구,2220, 반포본동 주민센터 앞,201904,1648,1872,3520,37.500614,126.98616
서초구,2220, 반포본동 주민센터 앞,201905,2739,2986,5725,37.500614,126.98616
서초구,2220, 반포본동 주민센터 앞,201906,2897,3247,6144,37.500614,126.98616
서초구,2220, 반포본동 주민센터 앞,201907,2618,2927,5545,37.500614,126.98616
서초구,2220, 반포본동 주민센터 앞,201908,2842,3282,6124,37.500614,126.98616
서초구,2220, 반포본동 주민센터 앞,201909,2990,3275,6265,37.500614,126.98616
서초구,2220, 반포본동 주민센터 앞,201910,3470,3728,7198,37.500614,126.98616
서초구,2220, 반포본동 주민센터 앞,201911,1436,1627,3063,37.500614,126.98616
서초구,2220, 반포본동 주민센터 앞,201912,766,829,1595,37.500614,126.98616
서초구,2220, 반포본동 주민센터 앞,202001,724,753,1477,37.500614,126.98616
서초구,2220, 반포본동 주민센터 앞,202002,780,846,1626,37.500614,126.98616
서초구,2220, 반포본동 주민센터 앞,202003,2729,2949,5678,37.500614,126.98616
서초구,2220, 반포본동 주민센터 앞,202004,3714,3988,7702,37.500614,126.98616
서초구,2220, 반포본동 주민센터 앞,202005,4708,4980,9688,37.500614,126.98616
서초구,2220, 반포본동 주민센터 앞,202006,4341,4563,8904,37.500614,126.98616
서초구,2221,하나은행 방배동지점 앞,201901,238,247,485,37.485611,126.994682
서초구,2221,하나은행 방배동지점 앞,201902,270,304,574,37.485611,126.994682
서초구,2221,하나은행 방배동지점 앞,201903,511,655,1166,37.485611,126.994682
서초구,2221,하나은행 방배동지점 앞,201904,860,940,1800,37.485611,126.994682
서초구,2221,하나은행 방배동지점 앞,201905,720,783,1503,37.485611,126.994682
서초구,2221,하나은행 방배동지점 앞,201906,1439,1682,3121,37.485611,126.994682
서초구,2221,하나은행 방배동지점 앞,201907,1475,1617,3092,37.485611,126.994682
서초구,2221,하나은행 방배동지점 앞,201908,1526,1685,3211,37.485611,126.994682
서초구,2221,하나은행 방배동지점 앞,201909,1566,1638,3204,37.485611,126.994682
서초구,2221,하나은행 방배동지점 앞,201910,1709,1819,3528,37.485611,126.994682
서초구,2221,하나은행 방배동지점 앞,201911,914,1013,1927,37.485611,126.994682
서초구,2221,하나은행 방배동지점 앞,201912,412,465,877,37.485611,126.994682
서초구,2221,하나은행 방배동지점 앞,202001,343,437,780,37.485611,126.994682
서초구,2221,하나은행 방배동지점 앞,202002,500,564,1064,37.485611,126.994682
서초구,2221,하나은행 방배동지점 앞,202003,896,914,1810,37.485611,126.994682
서초구,2221,하나은행 방배동지점 앞,202004,1395,1455,2850,37.485611,126.994682
서초구,2221,하나은행 방배동지점 앞,202005,1670,1713,3383,37.485611,126.994682
서초구,2221,하나은행 방배동지점 앞,202006,1815,1894,3709,37.485611,126.994682
서초구,2222,사당역 12번출구 뒤,201901,474,596,1070,37.478069,126.982033
서초구,2222,사당역 12번출구 뒤,201902,410,488,898,37.478069,126.982033
서초구,2222,사당역 12번출구 뒤,201903,705,920,1625,37.478069,126.982033
서초구,2222,사당역 12번출구 뒤,201904,1111,1559,2670,37.478069,126.982033
서초구,2222,사당역 12번출구 뒤,201905,1978,2643,4621,37.478069,126.982033
서초구,2222,사당역 12번출구 뒤,201906,2330,2817,5147,37.478069,126.982033
서초구,2222,사당역 12번출구 뒤,201907,2246,2743,4989,37.478069,126.982033
서초구,2222,사당역 12번출구 뒤,201908,2242,2774,5016,37.478069,126.982033
서초구,2222,사당역 12번출구 뒤,201909,2142,2677,4819,37.478069,126.982033
서초구,2222,사당역 12번출구 뒤,201910,2501,3036,5537,37.478069,126.982033
서초구,2222,사당역 12번출구 뒤,201911,1411,1912,3323,37.478069,126.982033
서초구,2222,사당역 12번출구 뒤,201912,887,1101,1988,37.478069,126.982033
서초구,2222,사당역 12번출구 뒤,202001,709,1024,1733,37.478069,126.982033
서초구,2222,사당역 12번출구 뒤,202002,738,908,1646,37.478069,126.982033
서초구,2222,사당역 12번출구 뒤,202003,1333,1539,2872,37.478069,126.982033
서초구,2222,사당역 12번출구 뒤,202004,1956,2237,4193,37.478069,126.982033
서초구,2222,사당역 12번출구 뒤,202005,2390,2497,4887,37.478069,126.982033
서초구,2222,사당역 12번출구 뒤,202006,2588,2833,5421,37.478069,126.982033
서초구,2223, 방배래미안 정문 앞,201901,126,144,270,37.47261,126.983009
서초구,2223, 방배래미안 정문 앞,201902,91,109,200,37.47261,126.983009
서초구,2223, 방배래미안 정문 앞,201903,163,226,389,37.47261,126.983009
서초구,2223, 방배래미안 정문 앞,201904,280,372,652,37.47261,126.983009
서초구,2223, 방배래미안 정문 앞,201905,455,563,1018,37.47261,126.983009
서초구,2223, 방배래미안 정문 앞,201906,562,623,1185,37.47261,126.983009
서초구,2223, 방배래미안 정문 앞,201907,533,545,1078,37.47261,126.983009
서초구,2223, 방배래미안 정문 앞,201908,406,509,915,37.47261,126.983009
서초구,2223, 방배래미안 정문 앞,201909,439,558,997,37.47261,126.983009
서초구,2223, 방배래미안 정문 앞,201910,489,561,1050,37.47261,126.983009
서초구,2223, 방배래미안 정문 앞,201911,291,390,681,37.47261,126.983009
서초구,2223, 방배래미안 정문 앞,201912,146,158,304,37.47261,126.983009
서초구,2223, 방배래미안 정문 앞,202001,181,194,375,37.47261,126.983009
서초구,2223, 방배래미안 정문 앞,202002,152,153,305,37.47261,126.983009
서초구,2223, 방배래미안 정문 앞,202003,288,294,582,37.47261,126.983009
서초구,2223, 방배래미안 정문 앞,202004,305,301,606,37.47261,126.983009
서초구,2223, 방배래미안 정문 앞,202005,366,362,728,37.47261,126.983009
서초구,2223, 방배래미안 정문 앞,202006,480,480,960,37.47261,126.983009
서초구,2225,백석예술대학교 제3캠퍼스 앞,201901,67,36,103,37.473759,126.995247
서초구,2225,백석예술대학교 제3캠퍼스 앞,201902,83,36,119,37.473759,126.995247
서초구,2225,백석예술대학교 제3캠퍼스 앞,201903,154,75,229,37.473759,126.995247
서초구,2225,백석예술대학교 제3캠퍼스 앞,201904,165,118,283,37.473759,126.995247
서초구,2225,백석예술대학교 제3캠퍼스 앞,201905,293,179,472,37.473759,126.995247
서초구,2225,백석예술대학교 제3캠퍼스 앞,201906,363,253,616,37.473759,126.995247
서초구,2225,백석예술대학교 제3캠퍼스 앞,201907,321,161,482,37.473759,126.995247
서초구,2225,백석예술대학교 제3캠퍼스 앞,201908,302,161,463,37.473759,126.995247
서초구,2225,백석예술대학교 제3캠퍼스 앞,201909,316,136,452,37.473759,126.995247
서초구,2225,백석예술대학교 제3캠퍼스 앞,201910,327,191,518,37.473759,126.995247
서초구,2225,백석예술대학교 제3캠퍼스 앞,201911,243,146,389,37.473759,126.995247
서초구,2225,백석예술대학교 제3캠퍼스 앞,201912,104,55,159,37.473759,126.995247
서초구,2225,백석예술대학교 제3캠퍼스 앞,202001,92,60,152,37.473759,126.995247
서초구,2225,백석예술대학교 제3캠퍼스 앞,202002,83,43,126,37.473759,126.995247
서초구,2225,백석예술대학교 제3캠퍼스 앞,202003,165,73,238,37.473759,126.995247
서초구,2225,백석예술대학교 제3캠퍼스 앞,202004,126,106,232,37.473759,126.995247
서초구,2225,백석예술대학교 제3캠퍼스 앞,202005,135,70,205,37.473759,126.995247
서초구,2225,백석예술대학교 제3캠퍼스 앞,202006,155,114,269,37.473759,126.995247
서초구,2226, 신동아럭스빌아파트 앞,201901,74,13,87,37.475182,127.001389
서초구,2226, 신동아럭스빌아파트 앞,201902,67,15,82,37.475182,127.001389
서초구,2226, 신동아럭스빌아파트 앞,201903,147,24,171,37.475182,127.001389
서초구,2226, 신동아럭스빌아파트 앞,201904,278,71,349,37.475182,127.001389
서초구,2226, 신동아럭스빌아파트 앞,201905,388,111,499,37.475182,127.001389
서초구,2226, 신동아럭스빌아파트 앞,201906,375,104,479,37.475182,127.001389
서초구,2226, 신동아럭스빌아파트 앞,201907,276,97,373,37.475182,127.001389
서초구,2226, 신동아럭스빌아파트 앞,201908,322,58,380,37.475182,127.001389
서초구,2226, 신동아럭스빌아파트 앞,201909,314,87,401,37.475182,127.001389
서초구,2226, 신동아럭스빌아파트 앞,201910,359,117,476,37.475182,127.001389
서초구,2226, 신동아럭스빌아파트 앞,201911,213,51,264,37.475182,127.001389
서초구,2226, 신동아럭스빌아파트 앞,201912,104,33,137,37.475182,127.001389
서초구,2226, 신동아럭스빌아파트 앞,202001,104,21,125,37.475182,127.001389
서초구,2226, 신동아럭스빌아파트 앞,202002,69,23,92,37.475182,127.001389
서초구,2226, 신동아럭스빌아파트 앞,202003,138,34,172,37.475182,127.001389
서초구,2226, 신동아럭스빌아파트 앞,202004,174,71,245,37.475182,127.001389
서초구,2226, 신동아럭스빌아파트 앞,202005,142,72,214,37.475182,127.001389
서초구,2226, 신동아럭스빌아파트 앞,202006,219,72,291,37.475182,127.001389
서초구,2227,방배열린문화센터 앞,201901,208,200,408,37.489052,126.992523
서초구,2227,방배열린문화센터 앞,201902,226,257,483,37.489052,126.992523
서초구,2227,방배열린문화센터 앞,201903,495,601,1096,37.489052,126.992523
서초구,2227,방배열린문화센터 앞,201904,853,900,1753,37.489052,126.992523
서초구,2227,방배열린문화센터 앞,201905,1430,1496,2926,37.489052,126.992523
서초구,2227,방배열린문화센터 앞,201906,1338,1358,2696,37.489052,126.992523
서초구,2227,방배열린문화센터 앞,201907,1373,1428,2801,37.489052,126.992523
서초구,2227,방배열린문화센터 앞,201908,1353,1489,2842,37.489052,126.992523
서초구,2227,방배열린문화센터 앞,201909,1384,1447,2831,37.489052,126.992523
서초구,2227,방배열린문화센터 앞,201910,1622,1676,3298,37.489052,126.992523
서초구,2227,방배열린문화센터 앞,201911,841,889,1730,37.489052,126.992523
서초구,2227,방배열린문화센터 앞,201912,447,472,919,37.489052,126.992523
서초구,2227,방배열린문화센터 앞,202001,337,408,745,37.489052,126.992523
서초구,2227,방배열린문화센터 앞,202002,382,415,797,37.489052,126.992523
서초구,2227,방배열린문화센터 앞,202003,744,803,1547,37.489052,126.992523
서초구,2227,방배열린문화센터 앞,202004,1147,1175,2322,37.489052,126.992523
서초구,2227,방배열린문화센터 앞,202005,1393,1417,2810,37.489052,126.992523
서초구,2227,방배열린문화센터 앞,202006,1259,1281,2540,37.489052,126.992523
서초구,2228,뒷벌공원 옆,201901,476,578,1054,37.489586,126.986725
서초구,2228,뒷벌공원 옆,201902,405,456,861,37.489586,126.986725
서초구,2228,뒷벌공원 옆,201903,692,789,1481,37.489586,126.986725
서초구,2228,뒷벌공원 옆,201904,883,1052,1935,37.489586,126.986725
서초구,2228,뒷벌공원 옆,201905,1598,1837,3435,37.489586,126.986725
서초구,2228,뒷벌공원 옆,201906,1765,2100,3865,37.489586,126.986725
서초구,2228,뒷벌공원 옆,201907,1705,2185,3890,37.489586,126.986725
서초구,2228,뒷벌공원 옆,201908,1710,2056,3766,37.489586,126.986725
서초구,2228,뒷벌공원 옆,201909,1666,1846,3512,37.489586,126.986725
서초구,2228,뒷벌공원 옆,201910,2095,2353,4448,37.489586,126.986725
서초구,2228,뒷벌공원 옆,201911,1184,1352,2536,37.489586,126.986725
서초구,2228,뒷벌공원 옆,201912,744,779,1523,37.489586,126.986725
서초구,2228,뒷벌공원 옆,202001,686,705,1391,37.489586,126.986725
서초구,2228,뒷벌공원 옆,202002,623,635,1258,37.489586,126.986725
서초구,2228,뒷벌공원 옆,202003,1189,1213,2402,37.489586,126.986725
서초구,2228,뒷벌공원 옆,202004,1680,1756,3436,37.489586,126.986725
서초구,2228,뒷벌공원 옆,202005,1804,1826,3630,37.489586,126.986725
서초구,2228,뒷벌공원 옆,202006,2006,2093,4099,37.489586,126.986725
서초구,2229,로고스교회 맞은 편,201901,109,96,205,37.487011,126.984962
서초구,2229,로고스교회 맞은 편,201902,78,90,168,37.487011,126.984962
서초구,2229,로고스교회 맞은 편,201903,144,154,298,37.487011,126.984962
서초구,2229,로고스교회 맞은 편,201904,290,263,553,37.487011,126.984962
서초구,2229,로고스교회 맞은 편,201905,403,453,856,37.487011,126.984962
서초구,2229,로고스교회 맞은 편,201906,510,550,1060,37.487011,126.984962
서초구,2229,로고스교회 맞은 편,201907,503,521,1024,37.487011,126.984962
서초구,2229,로고스교회 맞은 편,201908,442,491,933,37.487011,126.984962
서초구,2229,로고스교회 맞은 편,201909,486,492,978,37.487011,126.984962
서초구,2229,로고스교회 맞은 편,201910,502,529,1031,37.487011,126.984962
서초구,2229,로고스교회 맞은 편,201911,320,349,669,37.487011,126.984962
서초구,2229,로고스교회 맞은 편,201912,197,230,427,37.487011,126.984962
서초구,2229,로고스교회 맞은 편,202001,153,192,345,37.487011,126.984962
서초구,2229,로고스교회 맞은 편,202002,121,121,242,37.487011,126.984962
서초구,2229,로고스교회 맞은 편,202003,216,195,411,37.487011,126.984962
서초구,2229,로고스교회 맞은 편,202004,334,310,644,37.487011,126.984962
서초구,2229,로고스교회 맞은 편,202005,330,301,631,37.487011,126.984962
서초구,2229,로고스교회 맞은 편,202006,412,396,808,37.487011,126.984962
서초구,2230,이수역 4번 출구,201901,584,577,1161,37.485828,126.982628
서초구,2230,이수역 4번 출구,201902,508,566,1074,37.485828,126.982628
서초구,2230,이수역 4번 출구,201903,855,960,1815,37.485828,126.982628
서초구,2230,이수역 4번 출구,201904,1273,1366,2639,37.485828,126.982628
서초구,2230,이수역 4번 출구,201905,2232,2434,4666,37.485828,126.982628
서초구,2230,이수역 4번 출구,201906,2338,2455,4793,37.485828,126.982628
서초구,2230,이수역 4번 출구,201907,2999,3142,6141,37.485828,126.982628
서초구,2230,이수역 4번 출구,201908,3576,3788,7364,37.485828,126.982628
서초구,2230,이수역 4번 출구,201909,2721,2707,5428,37.485828,126.982628
서초구,2230,이수역 4번 출구,201910,2569,2578,5147,37.485828,126.982628
서초구,2230,이수역 4번 출구,201911,1425,1356,2781,37.485828,126.982628
서초구,2230,이수역 4번 출구,201912,850,810,1660,37.485828,126.982628
서초구,2230,이수역 4번 출구,202001,704,641,1345,37.485828,126.982628
서초구,2230,이수역 4번 출구,202002,600,585,1185,37.485828,126.982628
서초구,2230,이수역 4번 출구,202003,1375,1396,2771,37.485828,126.982628
서초구,2230,이수역 4번 출구,202004,1923,1944,3867,37.485828,126.982628
서초구,2230,이수역 4번 출구,202005,2047,2051,4098,37.485828,126.982628
서초구,2230,이수역 4번 출구,202006,2403,2400,4803,37.485828,126.982628
서초구,2231, 삼성타운(삼성생명) A동 맞은편,201901,581,596,1177,37.496914,127.024963
서초구,2231, 삼성타운(삼성생명) A동 맞은편,201902,520,537,1057,37.496914,127.024963
서초구,2231, 삼성타운(삼성생명) A동 맞은편,201903,989,1132,2121,37.496914,127.024963
서초구,2231, 삼성타운(삼성생명) A동 맞은편,201904,1690,1709,3399,37.496914,127.024963
서초구,2231, 삼성타운(삼성생명) A동 맞은편,201905,2510,2504,5014,37.496914,127.024963
서초구,2231, 삼성타운(삼성생명) A동 맞은편,201906,2472,2452,4924,37.496914,127.024963
서초구,2231, 삼성타운(삼성생명) A동 맞은편,201907,2341,2334,4675,37.496914,127.024963
서초구,2231, 삼성타운(삼성생명) A동 맞은편,201908,2129,2194,4323,37.496914,127.024963
서초구,2231, 삼성타운(삼성생명) A동 맞은편,201909,2263,2356,4619,37.496914,127.024963
서초구,2231, 삼성타운(삼성생명) A동 맞은편,201910,2845,2950,5795,37.496914,127.024963
서초구,2231, 삼성타운(삼성생명) A동 맞은편,201911,1732,1947,3679,37.496914,127.024963
서초구,2231, 삼성타운(삼성생명) A동 맞은편,201912,932,997,1929,37.496914,127.024963
서초구,2231, 삼성타운(삼성생명) A동 맞은편,202001,910,1042,1952,37.496914,127.024963
서초구,2231, 삼성타운(삼성생명) A동 맞은편,202002,856,890,1746,37.496914,127.024963
서초구,2231, 삼성타운(삼성생명) A동 맞은편,202003,1372,1380,2752,37.496914,127.024963
서초구,2231, 삼성타운(삼성생명) A동 맞은편,202004,1771,1742,3513,37.496914,127.024963
서초구,2231, 삼성타운(삼성생명) A동 맞은편,202005,1891,1887,3778,37.496914,127.024963
서초구,2231, 삼성타운(삼성생명) A동 맞은편,202006,2069,2104,4173,37.496914,127.024963
서초구,2233, 서초신동아1차아파트 옆,201901,200,193,393,37.491112,127.022957
서초구,2233, 서초신동아1차아파트 옆,201902,194,165,359,37.491112,127.022957
서초구,2233, 서초신동아1차아파트 옆,201903,284,286,570,37.491112,127.022957
서초구,2233, 서초신동아1차아파트 옆,201904,490,480,970,37.491112,127.022957
서초구,2233, 서초신동아1차아파트 옆,201905,730,679,1409,37.491112,127.022957
서초구,2233, 서초신동아1차아파트 옆,201906,831,729,1560,37.491112,127.022957
서초구,2233, 서초신동아1차아파트 옆,201907,1093,905,1998,37.491112,127.022957
서초구,2233, 서초신동아1차아파트 옆,201908,1042,861,1903,37.491112,127.022957
서초구,2233, 서초신동아1차아파트 옆,201909,1024,819,1843,37.491112,127.022957
서초구,2233, 서초신동아1차아파트 옆,201910,702,675,1377,37.491112,127.022957
서초구,2233, 서초신동아1차아파트 옆,201911,713,670,1383,37.491112,127.022957
서초구,2233, 서초신동아1차아파트 옆,201912,470,409,879,37.491112,127.022957
서초구,2233, 서초신동아1차아파트 옆,202001,469,407,876,37.491112,127.022957
서초구,2233, 서초신동아1차아파트 옆,202002,403,375,778,37.491112,127.022957
서초구,2233, 서초신동아1차아파트 옆,202003,552,510,1062,37.491112,127.022957
서초구,2233, 서초신동아1차아파트 옆,202004,671,626,1297,37.491112,127.022957
서초구,2233, 서초신동아1차아파트 옆,202005,653,625,1278,37.491112,127.022957
서초구,2233, 서초신동아1차아파트 옆,202006,841,725,1566,37.491112,127.022957
서초구,2235,KT 서초지사 앞,201901,259,220,479,37.482159,127.002701
서초구,2235,KT 서초지사 앞,201902,175,170,345,37.482159,127.002701
서초구,2235,KT 서초지사 앞,201903,365,328,693,37.482159,127.002701
서초구,2235,KT 서초지사 앞,201904,532,427,959,37.482159,127.002701
서초구,2235,KT 서초지사 앞,201905,844,644,1488,37.482159,127.002701
서초구,2235,KT 서초지사 앞,201906,857,617,1474,37.482159,127.002701
서초구,2235,KT 서초지사 앞,201907,803,562,1365,37.482159,127.002701
서초구,2235,KT 서초지사 앞,201908,735,500,1235,37.482159,127.002701
서초구,2235,KT 서초지사 앞,201909,785,513,1298,37.482159,127.002701
서초구,2235,KT 서초지사 앞,201910,906,661,1567,37.482159,127.002701
서초구,2235,KT 서초지사 앞,201911,572,383,955,37.482159,127.002701
서초구,2235,KT 서초지사 앞,201912,324,275,599,37.482159,127.002701
서초구,2235,KT 서초지사 앞,202001,308,239,547,37.482159,127.002701
서초구,2235,KT 서초지사 앞,202002,261,183,444,37.482159,127.002701
서초구,2235,KT 서초지사 앞,202003,340,270,610,37.482159,127.002701
서초구,2235,KT 서초지사 앞,202004,625,488,1113,37.482159,127.002701
서초구,2235,KT 서초지사 앞,202005,566,497,1063,37.482159,127.002701
서초구,2235,KT 서초지사 앞,202006,664,502,1166,37.482159,127.002701
서초구,2237,서울남부터미널 대합실 입구,201901,281,186,467,37.484558,127.01487
서초구,2237,서울남부터미널 대합실 입구,201902,274,166,440,37.484558,127.01487
서초구,2237,서울남부터미널 대합실 입구,201903,560,356,916,37.484558,127.01487
서초구,2237,서울남부터미널 대합실 입구,201904,815,522,1337,37.484558,127.01487
서초구,2237,서울남부터미널 대합실 입구,201905,1303,771,2074,37.484558,127.01487
서초구,2237,서울남부터미널 대합실 입구,201906,1680,1168,2848,37.484558,127.01487
서초구,2237,서울남부터미널 대합실 입구,201907,1111,713,1824,37.484558,127.01487
서초구,2237,서울남부터미널 대합실 입구,201908,1120,658,1778,37.484558,127.01487
서초구,2237,서울남부터미널 대합실 입구,201909,1021,611,1632,37.484558,127.01487
서초구,2237,서울남부터미널 대합실 입구,201910,1304,832,2136,37.484558,127.01487
서초구,2237,서울남부터미널 대합실 입구,201911,781,481,1262,37.484558,127.01487
서초구,2237,서울남부터미널 대합실 입구,201912,482,281,763,37.484558,127.01487
서초구,2237,서울남부터미널 대합실 입구,202001,479,261,740,37.484558,127.01487
서초구,2237,서울남부터미널 대합실 입구,202002,393,211,604,37.484558,127.01487
서초구,2237,서울남부터미널 대합실 입구,202003,608,392,1000,37.484558,127.01487
서초구,2237,서울남부터미널 대합실 입구,202004,955,584,1539,37.484558,127.01487
서초구,2237,서울남부터미널 대합실 입구,202005,956,633,1589,37.484558,127.01487
서초구,2237,서울남부터미널 대합실 입구,202006,994,578,1572,37.484558,127.01487
서초구,2239,교대역 6번출구,201901,171,173,344,37.494217,127.013786
서초구,2239,교대역 6번출구,201902,185,183,368,37.494217,127.013786
서초구,2239,교대역 6번출구,201903,373,364,737,37.494217,127.013786
서초구,2239,교대역 6번출구,201904,544,555,1099,37.494217,127.013786
서초구,2239,교대역 6번출구,201905,888,856,1744,37.494217,127.013786
서초구,2239,교대역 6번출구,201906,851,798,1649,37.494217,127.013786
서초구,2239,교대역 6번출구,201907,858,844,1702,37.494217,127.013786
서초구,2239,교대역 6번출구,201908,876,814,1690,37.494217,127.013786
서초구,2239,교대역 6번출구,201909,852,828,1680,37.494217,127.013786
서초구,2239,교대역 6번출구,201910,1006,1021,2027,37.494217,127.013786
서초구,2239,교대역 6번출구,201911,551,500,1051,37.494217,127.013786
서초구,2239,교대역 6번출구,201912,283,270,553,37.494217,127.013786
서초구,2239,교대역 6번출구,202001,272,257,529,37.494217,127.013786
서초구,2239,교대역 6번출구,202002,215,202,417,37.494217,127.013786
서초구,2239,교대역 6번출구,202003,384,315,699,37.494217,127.013786
서초구,2239,교대역 6번출구,202004,459,415,874,37.494217,127.013786
서초구,2239,교대역 6번출구,202005,513,500,1013,37.494217,127.013786
서초구,2239,교대역 6번출구,202006,645,578,1223,37.494217,127.013786
서초구,2241,양재전화국 사거리,201901,129,108,237,37.485378,127.041702
서초구,2241,양재전화국 사거리,201902,114,107,221,37.485378,127.041702
서초구,2241,양재전화국 사거리,201903,312,250,562,37.485378,127.041702
서초구,2241,양재전화국 사거리,201904,449,366,815,37.485378,127.041702
서초구,2241,양재전화국 사거리,201905,459,419,878,37.485378,127.041702
서초구,2241,양재전화국 사거리,201906,554,492,1046,37.485378,127.041702
서초구,2241,양재전화국 사거리,201907,558,510,1068,37.485378,127.041702
서초구,2241,양재전화국 사거리,201908,524,479,1003,37.485378,127.041702
서초구,2241,양재전화국 사거리,201909,539,501,1040,37.485378,127.041702
서초구,2241,양재전화국 사거리,201910,582,574,1156,37.485378,127.041702
서초구,2241,양재전화국 사거리,201911,446,398,844,37.485378,127.041702
서초구,2241,양재전화국 사거리,201912,221,210,431,37.485378,127.041702
서초구,2241,양재전화국 사거리,202001,187,175,362,37.485378,127.041702
서초구,2241,양재전화국 사거리,202002,149,150,299,37.485378,127.041702
서초구,2241,양재전화국 사거리,202003,268,238,506,37.485378,127.041702
서초구,2241,양재전화국 사거리,202004,304,284,588,37.485378,127.041702
서초구,2241,양재전화국 사거리,202005,346,336,682,37.485378,127.041702
서초구,2241,양재전화국 사거리,202006,386,324,710,37.485378,127.041702
서초구,2242,양재역 11번 출구 앞,201901,299,296,595,37.48399,127.03418
서초구,2242,양재역 11번 출구 앞,201902,254,248,502,37.48399,127.03418
서초구,2242,양재역 11번 출구 앞,201903,398,402,800,37.48399,127.03418
서초구,2242,양재역 11번 출구 앞,201904,903,893,1796,37.48399,127.03418
서초구,2242,양재역 11번 출구 앞,201905,1320,1320,2640,37.48399,127.03418
서초구,2242,양재역 11번 출구 앞,201906,1410,1415,2825,37.48399,127.03418
서초구,2242,양재역 11번 출구 앞,201907,1342,1310,2652,37.48399,127.03418
서초구,2242,양재역 11번 출구 앞,201908,1095,1094,2189,37.48399,127.03418
서초구,2242,양재역 11번 출구 앞,201909,1293,1293,2586,37.48399,127.03418
서초구,2242,양재역 11번 출구 앞,201910,1476,1474,2950,37.48399,127.03418
서초구,2242,양재역 11번 출구 앞,201911,967,969,1936,37.48399,127.03418
서초구,2242,양재역 11번 출구 앞,201912,561,557,1118,37.48399,127.03418
서초구,2242,양재역 11번 출구 앞,202001,565,567,1132,37.48399,127.03418
서초구,2242,양재역 11번 출구 앞,202002,557,558,1115,37.48399,127.03418
서초구,2242,양재역 11번 출구 앞,202003,856,832,1688,37.48399,127.03418
서초구,2242,양재역 11번 출구 앞,202004,985,908,1893,37.48399,127.03418
서초구,2242,양재역 11번 출구 앞,202005,1137,957,2094,37.48399,127.03418
서초구,2242,양재역 11번 출구 앞,202006,1255,1047,2302,37.48399,127.03418
서초구,2243,서울가정법원,201901,272,227,499,37.481491,127.036728
서초구,2243,서울가정법원,201902,293,215,508,37.481491,127.036728
서초구,2243,서울가정법원,201903,592,403,995,37.481491,127.036728
서초구,2243,서울가정법원,201904,965,652,1617,37.481491,127.036728
서초구,2243,서울가정법원,201905,1050,826,1876,37.481491,127.036728
서초구,2243,서울가정법원,201906,1050,746,1796,37.481491,127.036728
서초구,2243,서울가정법원,201907,1163,916,2079,37.481491,127.036728
서초구,2243,서울가정법원,201908,954,748,1702,37.481491,127.036728
서초구,2243,서울가정법원,201909,1072,835,1907,37.481491,127.036728
서초구,2243,서울가정법원,201910,1270,1078,2348,37.481491,127.036728
서초구,2243,서울가정법원,201911,797,700,1497,37.481491,127.036728
서초구,2243,서울가정법원,201912,474,415,889,37.481491,127.036728
서초구,2243,서울가정법원,202001,425,359,784,37.481491,127.036728
서초구,2243,서울가정법원,202002,383,353,736,37.481491,127.036728
서초구,2243,서울가정법원,202003,595,494,1089,37.481491,127.036728
서초구,2243,서울가정법원,202004,639,553,1192,37.481491,127.036728
서초구,2243,서울가정법원,202005,579,529,1108,37.481491,127.036728
서초구,2243,서울가정법원,202006,832,697,1529,37.481491,127.036728
서초구,2244,교육개발원입구 교차로,201901,315,366,681,37.477852,127.03891
서초구,2244,교육개발원입구 교차로,201902,254,308,562,37.477852,127.03891
서초구,2244,교육개발원입구 교차로,201903,598,644,1242,37.477852,127.03891
서초구,2244,교육개발원입구 교차로,201904,1132,1113,2245,37.477852,127.03891
서초구,2244,교육개발원입구 교차로,201905,1759,1530,3289,37.477852,127.03891
서초구,2244,교육개발원입구 교차로,201906,1919,1728,3647,37.477852,127.03891
서초구,2244,교육개발원입구 교차로,201907,2249,2137,4386,37.477852,127.03891
서초구,2244,교육개발원입구 교차로,201908,1694,1567,3261,37.477852,127.03891
서초구,2244,교육개발원입구 교차로,201909,1637,1592,3229,37.477852,127.03891
서초구,2244,교육개발원입구 교차로,201910,1988,1857,3845,37.477852,127.03891
서초구,2244,교육개발원입구 교차로,201911,1167,1139,2306,37.477852,127.03891
서초구,2244,교육개발원입구 교차로,201912,647,634,1281,37.477852,127.03891
서초구,2244,교육개발원입구 교차로,202001,553,599,1152,37.477852,127.03891
서초구,2244,교육개발원입구 교차로,202002,573,579,1152,37.477852,127.03891
서초구,2244,교육개발원입구 교차로,202003,1019,1014,2033,37.477852,127.03891
서초구,2244,교육개발원입구 교차로,202004,1375,1317,2692,37.477852,127.03891
서초구,2244,교육개발원입구 교차로,202005,1407,1361,2768,37.477852,127.03891
서초구,2244,교육개발원입구 교차로,202006,1680,1613,3293,37.477852,127.03891
서초구,2245,양재초등학교 맞은편,201901,125,121,246,37.473614,127.03051
서초구,2245,양재초등학교 맞은편,201902,129,121,250,37.473614,127.03051
서초구,2245,양재초등학교 맞은편,201903,344,366,710,37.473614,127.03051
서초구,2245,양재초등학교 맞은편,201904,537,556,1093,37.473614,127.03051
서초구,2245,양재초등학교 맞은편,201905,799,797,1596,37.473614,127.03051
서초구,2245,양재초등학교 맞은편,201906,839,894,1733,37.473614,127.03051
서초구,2245,양재초등학교 맞은편,201907,784,808,1592,37.473614,127.03051
서초구,2245,양재초등학교 맞은편,201908,779,802,1581,37.473614,127.03051
서초구,2245,양재초등학교 맞은편,201909,755,773,1528,37.473614,127.03051
서초구,2245,양재초등학교 맞은편,201910,884,890,1774,37.473614,127.03051
서초구,2245,양재초등학교 맞은편,201911,595,601,1196,37.473614,127.03051
서초구,2245,양재초등학교 맞은편,201912,369,367,736,37.473614,127.03051
서초구,2245,양재초등학교 맞은편,202001,342,357,699,37.473614,127.03051
서초구,2245,양재초등학교 맞은편,202002,303,303,606,37.473614,127.03051
서초구,2245,양재초등학교 맞은편,202003,445,430,875,37.473614,127.03051
서초구,2245,양재초등학교 맞은편,202004,545,541,1086,37.473614,127.03051
서초구,2245,양재초등학교 맞은편,202005,269,264,533,37.473614,127.03051
서초구,2245,양재초등학교 맞은편,202006,378,380,758,37.473614,127.03051
서초구,2246, 서울시 품질시험소 앞,201901,264,267,531,37.4692,127.029007
서초구,2246, 서울시 품질시험소 앞,201902,211,192,403,37.4692,127.029007
서초구,2246, 서울시 품질시험소 앞,201903,335,386,721,37.4692,127.029007
서초구,2246, 서울시 품질시험소 앞,201904,565,620,1185,37.4692,127.029007
서초구,2246, 서울시 품질시험소 앞,201905,717,720,1437,37.4692,127.029007
서초구,2246, 서울시 품질시험소 앞,201906,745,766,1511,37.4692,127.029007
서초구,2246, 서울시 품질시험소 앞,201907,734,789,1523,37.4692,127.029007
서초구,2246, 서울시 품질시험소 앞,201908,692,823,1515,37.4692,127.029007
서초구,2246, 서울시 품질시험소 앞,201909,752,782,1534,37.4692,127.029007
서초구,2246, 서울시 품질시험소 앞,201910,938,967,1905,37.4692,127.029007
서초구,2246, 서울시 품질시험소 앞,201911,665,702,1367,37.4692,127.029007
서초구,2246, 서울시 품질시험소 앞,201912,422,431,853,37.4692,127.029007
서초구,2246, 서울시 품질시험소 앞,202001,350,358,708,37.4692,127.029007
서초구,2246, 서울시 품질시험소 앞,202002,323,352,675,37.4692,127.029007
서초구,2246, 서울시 품질시험소 앞,202003,566,566,1132,37.4692,127.029007
서초구,2246, 서울시 품질시험소 앞,202004,604,600,1204,37.4692,127.029007
서초구,2246, 서울시 품질시험소 앞,202005,677,684,1361,37.4692,127.029007
서초구,2246, 서울시 품질시험소 앞,202006,741,732,1473,37.4692,127.029007
서초구,2247,섬들근린공원,201901,386,374,760,37.462639,127.026619
서초구,2247,섬들근린공원,201902,402,389,791,37.462639,127.026619
서초구,2247,섬들근린공원,201903,837,840,1677,37.462639,127.026619
서초구,2247,섬들근린공원,201904,1246,1226,2472,37.462639,127.026619
서초구,2247,섬들근린공원,201905,1688,1727,3415,37.462639,127.026619
서초구,2247,섬들근린공원,201906,1776,1863,3639,37.462639,127.026619
서초구,2247,섬들근린공원,201907,1733,1781,3514,37.462639,127.026619
서초구,2247,섬들근린공원,201908,1491,1591,3082,37.462639,127.026619
서초구,2247,섬들근린공원,201909,1594,1597,3191,37.462639,127.026619
서초구,2247,섬들근린공원,201910,1909,1913,3822,37.462639,127.026619
서초구,2247,섬들근린공원,201911,1311,1288,2599,37.462639,127.026619
서초구,2247,섬들근린공원,201912,803,801,1604,37.462639,127.026619
서초구,2247,섬들근린공원,202001,657,679,1336,37.462639,127.026619
서초구,2247,섬들근린공원,202002,703,770,1473,37.462639,127.026619
서초구,2247,섬들근린공원,202003,1274,1272,2546,37.462639,127.026619
서초구,2247,섬들근린공원,202004,1503,1470,2973,37.462639,127.026619
서초구,2247,섬들근린공원,202005,1721,1701,3422,37.462639,127.026619
서초구,2247,섬들근린공원,202006,1915,1900,3815,37.462639,127.026619
서초구,2248, 서초리슈빌S 글로벌 앞,201901,162,120,282,37.459953,127.024742
서초구,2248, 서초리슈빌S 글로벌 앞,201902,144,108,252,37.459953,127.024742
서초구,2248, 서초리슈빌S 글로벌 앞,201903,348,226,574,37.459953,127.024742
서초구,2248, 서초리슈빌S 글로벌 앞,201904,539,436,975,37.459953,127.024742
서초구,2248, 서초리슈빌S 글로벌 앞,201905,710,628,1338,37.459953,127.024742
서초구,2248, 서초리슈빌S 글로벌 앞,201906,690,644,1334,37.459953,127.024742
서초구,2248, 서초리슈빌S 글로벌 앞,201907,674,646,1320,37.459953,127.024742
서초구,2248, 서초리슈빌S 글로벌 앞,201908,563,541,1104,37.459953,127.024742
서초구,2248, 서초리슈빌S 글로벌 앞,201909,605,551,1156,37.459953,127.024742
서초구,2248, 서초리슈빌S 글로벌 앞,201910,711,654,1365,37.459953,127.024742
서초구,2248, 서초리슈빌S 글로벌 앞,201911,477,404,881,37.459953,127.024742
서초구,2248, 서초리슈빌S 글로벌 앞,201912,289,241,530,37.459953,127.024742
서초구,2248, 서초리슈빌S 글로벌 앞,202001,270,237,507,37.459953,127.024742
서초구,2248, 서초리슈빌S 글로벌 앞,202002,262,222,484,37.459953,127.024742
서초구,2248, 서초리슈빌S 글로벌 앞,202003,367,323,690,37.459953,127.024742
서초구,2248, 서초리슈빌S 글로벌 앞,202004,414,369,783,37.459953,127.024742
서초구,2248, 서초리슈빌S 글로벌 앞,202005,440,408,848,37.459953,127.024742
서초구,2248, 서초리슈빌S 글로벌 앞,202006,558,515,1073,37.459953,127.024742
서초구,2249, 우솔초등학교 맞은편,201901,85,63,148,37.456234,127.019348
서초구,2249, 우솔초등학교 맞은편,201902,91,70,161,37.456234,127.019348
서초구,2249, 우솔초등학교 맞은편,201903,197,145,342,37.456234,127.019348
서초구,2249, 우솔초등학교 맞은편,201904,324,229,553,37.456234,127.019348
서초구,2249, 우솔초등학교 맞은편,201905,397,324,721,37.456234,127.019348
서초구,2249, 우솔초등학교 맞은편,201906,385,323,708,37.456234,127.019348
서초구,2249, 우솔초등학교 맞은편,201907,374,340,714,37.456234,127.019348
서초구,2249, 우솔초등학교 맞은편,201908,325,263,588,37.456234,127.019348
서초구,2249, 우솔초등학교 맞은편,201909,299,239,538,37.456234,127.019348
서초구,2249, 우솔초등학교 맞은편,201910,325,274,599,37.456234,127.019348
서초구,2249, 우솔초등학교 맞은편,201911,228,183,411,37.456234,127.019348
서초구,2249, 우솔초등학교 맞은편,201912,140,110,250,37.456234,127.019348
서초구,2249, 우솔초등학교 맞은편,202001,99,86,185,37.456234,127.019348
서초구,2249, 우솔초등학교 맞은편,202002,101,100,201,37.456234,127.019348
서초구,2249, 우솔초등학교 맞은편,202003,288,269,557,37.456234,127.019348
서초구,2249, 우솔초등학교 맞은편,202004,372,308,680,37.456234,127.019348
서초구,2249, 우솔초등학교 맞은편,202005,394,337,731,37.456234,127.019348
서초구,2249, 우솔초등학교 맞은편,202006,400,332,732,37.456234,127.019348
서초구,2250, 서초유치원 맞은편,201901,161,130,291,37.455799,127.016289
서초구,2250, 서초유치원 맞은편,201902,182,125,307,37.455799,127.016289
서초구,2250, 서초유치원 맞은편,201903,374,272,646,37.455799,127.016289
서초구,2250, 서초유치원 맞은편,201904,713,570,1283,37.455799,127.016289
서초구,2250, 서초유치원 맞은편,201905,833,779,1612,37.455799,127.016289
서초구,2250, 서초유치원 맞은편,201906,881,837,1718,37.455799,127.016289
서초구,2250, 서초유치원 맞은편,201907,783,721,1504,37.455799,127.016289
서초구,2250, 서초유치원 맞은편,201908,604,612,1216,37.455799,127.016289
서초구,2250, 서초유치원 맞은편,201909,647,654,1301,37.455799,127.016289
서초구,2250, 서초유치원 맞은편,201910,754,692,1446,37.455799,127.016289
서초구,2250, 서초유치원 맞은편,201911,455,398,853,37.455799,127.016289
서초구,2250, 서초유치원 맞은편,201912,270,205,475,37.455799,127.016289
서초구,2250, 서초유치원 맞은편,202001,238,219,457,37.455799,127.016289
서초구,2250, 서초유치원 맞은편,202002,281,258,539,37.455799,127.016289
서초구,2250, 서초유치원 맞은편,202003,631,616,1247,37.455799,127.016289
서초구,2250, 서초유치원 맞은편,202004,801,738,1539,37.455799,127.016289
서초구,2250, 서초유치원 맞은편,202005,886,836,1722,37.455799,127.016289
서초구,2250, 서초유치원 맞은편,202006,925,865,1790,37.455799,127.016289
서초구,2251, 더케이호텔 입구(양재2),201901,281,264,545,37.467506,127.034477
서초구,2251, 더케이호텔 입구(양재2),201902,195,210,405,37.467506,127.034477
서초구,2251, 더케이호텔 입구(양재2),201903,461,497,958,37.467506,127.034477
서초구,2251, 더케이호텔 입구(양재2),201904,688,713,1401,37.467506,127.034477
서초구,2251, 더케이호텔 입구(양재2),201905,903,894,1797,37.467506,127.034477
서초구,2251, 더케이호텔 입구(양재2),201906,872,898,1770,37.467506,127.034477
서초구,2251, 더케이호텔 입구(양재2),201907,1030,1106,2136,37.467506,127.034477
서초구,2251, 더케이호텔 입구(양재2),201908,1007,1045,2052,37.467506,127.034477
서초구,2251, 더케이호텔 입구(양재2),201909,962,1000,1962,37.467506,127.034477
서초구,2251, 더케이호텔 입구(양재2),201910,1219,1236,2455,37.467506,127.034477
서초구,2251, 더케이호텔 입구(양재2),201911,800,866,1666,37.467506,127.034477
서초구,2251, 더케이호텔 입구(양재2),201912,525,528,1053,37.467506,127.034477
서초구,2251, 더케이호텔 입구(양재2),202001,485,526,1011,37.467506,127.034477
서초구,2251, 더케이호텔 입구(양재2),202002,470,480,950,37.467506,127.034477
서초구,2251, 더케이호텔 입구(양재2),202003,740,740,1480,37.467506,127.034477
서초구,2251, 더케이호텔 입구(양재2),202004,872,884,1756,37.467506,127.034477
서초구,2251, 더케이호텔 입구(양재2),202005,967,973,1940,37.467506,127.034477
서초구,2251, 더케이호텔 입구(양재2),202006,1216,1254,2470,37.467506,127.034477
서초구,2252, 하이브랜드 앞,201901,503,406,909,37.463322,127.036041
서초구,2252, 하이브랜드 앞,201902,453,336,789,37.463322,127.036041
서초구,2252, 하이브랜드 앞,201903,852,683,1535,37.463322,127.036041
서초구,2252, 하이브랜드 앞,201904,1426,1323,2749,37.463322,127.036041
서초구,2252, 하이브랜드 앞,201905,1785,1664,3449,37.463322,127.036041
서초구,2252, 하이브랜드 앞,201906,1932,1768,3700,37.463322,127.036041
서초구,2252, 하이브랜드 앞,201907,2009,1913,3922,37.463322,127.036041
서초구,2252, 하이브랜드 앞,201908,1791,1664,3455,37.463322,127.036041
서초구,2252, 하이브랜드 앞,201909,1773,1784,3557,37.463322,127.036041
서초구,2252, 하이브랜드 앞,201910,2029,2059,4088,37.463322,127.036041
서초구,2252, 하이브랜드 앞,201911,1515,1482,2997,37.463322,127.036041
서초구,2252, 하이브랜드 앞,201912,944,881,1825,37.463322,127.036041
서초구,2252, 하이브랜드 앞,202001,824,795,1619,37.463322,127.036041
서초구,2252, 하이브랜드 앞,202002,713,702,1415,37.463322,127.036041
서초구,2252, 하이브랜드 앞,202003,1114,1100,2214,37.463322,127.036041
서초구,2252, 하이브랜드 앞,202004,1278,1249,2527,37.463322,127.036041
서초구,2252, 하이브랜드 앞,202005,1234,1235,2469,37.463322,127.036041
서초구,2252, 하이브랜드 앞,202006,1672,1561,3233,37.463322,127.036041
서초구,2255,시민의숲역 1번출구 옆,201901,580,614,1194,37.47044,127.038857
서초구,2255,시민의숲역 1번출구 옆,201902,495,568,1063,37.47044,127.038857
서초구,2255,시민의숲역 1번출구 옆,201903,983,1160,2143,37.47044,127.038857
서초구,2255,시민의숲역 1번출구 옆,201904,2010,2249,4259,37.47044,127.038857
서초구,2255,시민의숲역 1번출구 옆,201905,3077,3051,6128,37.47044,127.038857
서초구,2255,시민의숲역 1번출구 옆,201906,2817,2808,5625,37.47044,127.038857
서초구,2255,시민의숲역 1번출구 옆,201907,2742,2616,5358,37.47044,127.038857
서초구,2255,시민의숲역 1번출구 옆,201908,2613,2576,5189,37.47044,127.038857
서초구,2255,시민의숲역 1번출구 옆,201909,2321,2289,4610,37.47044,127.038857
서초구,2255,시민의숲역 1번출구 옆,201910,3077,3020,6097,37.47044,127.038857
서초구,2255,시민의숲역 1번출구 옆,201911,1961,1959,3920,37.47044,127.038857
서초구,2255,시민의숲역 1번출구 옆,201912,1065,1210,2275,37.47044,127.038857
서초구,2255,시민의숲역 1번출구 옆,202001,961,953,1914,37.47044,127.038857
서초구,2255,시민의숲역 1번출구 옆,202002,822,826,1648,37.47044,127.038857
서초구,2255,시민의숲역 1번출구 옆,202003,1624,1618,3242,37.47044,127.038857
서초구,2255,시민의숲역 1번출구 옆,202004,1936,1876,3812,37.47044,127.038857
서초구,2255,시민의숲역 1번출구 옆,202005,2008,1997,4005,37.47044,127.038857
서초구,2255,시민의숲역 1번출구 옆,202006,2239,2129,4368,37.47044,127.038857
서초구,2256,양재동 꽃시장 입구,201901,146,158,304,37.46769,127.040359
서초구,2256,양재동 꽃시장 입구,201902,112,141,253,37.46769,127.040359
서초구,2256,양재동 꽃시장 입구,201903,269,325,594,37.46769,127.040359
서초구,2256,양재동 꽃시장 입구,201904,428,480,908,37.46769,127.040359
서초구,2256,양재동 꽃시장 입구,201905,732,746,1478,37.46769,127.040359
서초구,2256,양재동 꽃시장 입구,201906,635,682,1317,37.46769,127.040359
서초구,2256,양재동 꽃시장 입구,201907,648,667,1315,37.46769,127.040359
서초구,2256,양재동 꽃시장 입구,201908,568,574,1142,37.46769,127.040359
서초구,2256,양재동 꽃시장 입구,201909,525,556,1081,37.46769,127.040359
서초구,2256,양재동 꽃시장 입구,201910,627,678,1305,37.46769,127.040359
서초구,2256,양재동 꽃시장 입구,201911,394,488,882,37.46769,127.040359
서초구,2256,양재동 꽃시장 입구,201912,239,309,548,37.46769,127.040359
서초구,2256,양재동 꽃시장 입구,202001,261,313,574,37.46769,127.040359
서초구,2256,양재동 꽃시장 입구,202002,292,331,623,37.46769,127.040359
서초구,2256,양재동 꽃시장 입구,202003,542,534,1076,37.46769,127.040359
서초구,2256,양재동 꽃시장 입구,202004,694,694,1388,37.46769,127.040359
서초구,2256,양재동 꽃시장 입구,202005,669,672,1341,37.46769,127.040359
서초구,2256,양재동 꽃시장 입구,202006,687,686,1373,37.46769,127.040359
서초구,2257, 하나로클럽 양재점 맞은편,201901,62,66,128,37.462688,127.046112
서초구,2257, 하나로클럽 양재점 맞은편,201902,69,88,157,37.462688,127.046112
서초구,2257, 하나로클럽 양재점 맞은편,201903,112,140,252,37.462688,127.046112
서초구,2257, 하나로클럽 양재점 맞은편,201904,193,198,391,37.462688,127.046112
서초구,2257, 하나로클럽 양재점 맞은편,201905,315,329,644,37.462688,127.046112
서초구,2257, 하나로클럽 양재점 맞은편,201906,296,273,569,37.462688,127.046112
서초구,2257, 하나로클럽 양재점 맞은편,201907,264,258,522,37.462688,127.046112
서초구,2257, 하나로클럽 양재점 맞은편,201908,222,219,441,37.462688,127.046112
서초구,2257, 하나로클럽 양재점 맞은편,201909,242,241,483,37.462688,127.046112
서초구,2257, 하나로클럽 양재점 맞은편,201910,252,274,526,37.462688,127.046112
서초구,2257, 하나로클럽 양재점 맞은편,201911,162,174,336,37.462688,127.046112
서초구,2257, 하나로클럽 양재점 맞은편,201912,93,95,188,37.462688,127.046112
서초구,2257, 하나로클럽 양재점 맞은편,202001,91,108,199,37.462688,127.046112
서초구,2257, 하나로클럽 양재점 맞은편,202002,109,116,225,37.462688,127.046112
서초구,2257, 하나로클럽 양재점 맞은편,202003,184,188,372,37.462688,127.046112
서초구,2257, 하나로클럽 양재점 맞은편,202004,320,315,635,37.462688,127.046112
서초구,2257, 하나로클럽 양재점 맞은편,202005,228,226,454,37.462688,127.046112
서초구,2257, 하나로클럽 양재점 맞은편,202006,292,288,580,37.462688,127.046112
서초구,2258,구룡사 삼거리,201901,127,119,246,37.471539,127.050591
서초구,2258,구룡사 삼거리,201902,119,102,221,37.471539,127.050591
서초구,2258,구룡사 삼거리,201903,260,234,494,37.471539,127.050591
서초구,2258,구룡사 삼거리,201904,369,291,660,37.471539,127.050591
서초구,2258,구룡사 삼거리,201905,543,434,977,37.471539,127.050591
서초구,2258,구룡사 삼거리,201906,497,405,902,37.471539,127.050591
서초구,2258,구룡사 삼거리,201907,445,410,855,37.471539,127.050591
서초구,2258,구룡사 삼거리,201908,420,322,742,37.471539,127.050591
서초구,2258,구룡사 삼거리,201909,349,266,615,37.471539,127.050591
서초구,2258,구룡사 삼거리,201910,401,319,720,37.471539,127.050591
서초구,2258,구룡사 삼거리,201911,293,222,515,37.471539,127.050591
서초구,2258,구룡사 삼거리,201912,210,186,396,37.471539,127.050591
서초구,2258,구룡사 삼거리,202001,203,155,358,37.471539,127.050591
서초구,2258,구룡사 삼거리,202002,153,98,251,37.471539,127.050591
서초구,2258,구룡사 삼거리,202003,232,193,425,37.471539,127.050591
서초구,2258,구룡사 삼거리,202004,220,197,417,37.471539,127.050591
서초구,2258,구룡사 삼거리,202005,257,204,461,37.471539,127.050591
서초구,2258,구룡사 삼거리,202006,301,248,549,37.471539,127.050591
서초구,2259, 잠원역 3번-4번 출구사이,201901,283,280,563,37.512989,127.011177
서초구,2259, 잠원역 3번-4번 출구사이,201902,248,261,509,37.512989,127.011177
서초구,2259, 잠원역 3번-4번 출구사이,201903,533,505,1038,37.512989,127.011177
서초구,2259, 잠원역 3번-4번 출구사이,201904,751,699,1450,37.512989,127.011177
서초구,2259, 잠원역 3번-4번 출구사이,201905,1199,1103,2302,37.512989,127.011177
서초구,2259, 잠원역 3번-4번 출구사이,201906,1274,1209,2483,37.512989,127.011177
서초구,2259, 잠원역 3번-4번 출구사이,201907,1248,1182,2430,37.512989,127.011177
서초구,2259, 잠원역 3번-4번 출구사이,201908,1290,1257,2547,37.512989,127.011177
서초구,2259, 잠원역 3번-4번 출구사이,201909,1220,1141,2361,37.512989,127.011177
서초구,2259, 잠원역 3번-4번 출구사이,201910,1422,1344,2766,37.512989,127.011177
서초구,2259, 잠원역 3번-4번 출구사이,201911,717,738,1455,37.512989,127.011177
서초구,2259, 잠원역 3번-4번 출구사이,201912,328,356,684,37.512989,127.011177
서초구,2259, 잠원역 3번-4번 출구사이,202001,402,396,798,37.512989,127.011177
서초구,2259, 잠원역 3번-4번 출구사이,202002,374,389,763,37.512989,127.011177
서초구,2259, 잠원역 3번-4번 출구사이,202003,845,848,1693,37.512989,127.011177
서초구,2259, 잠원역 3번-4번 출구사이,202004,1102,1112,2214,37.512989,127.011177
서초구,2259, 잠원역 3번-4번 출구사이,202005,1338,1365,2703,37.512989,127.011177
서초구,2259, 잠원역 3번-4번 출구사이,202006,1209,1221,2430,37.512989,127.011177
서초구,2262, 한신16차아파트 119동 앞,201901,342,397,739,37.516598,127.00959
서초구,2262, 한신16차아파트 119동 앞,201902,395,448,843,37.516598,127.00959
서초구,2262, 한신16차아파트 119동 앞,201903,822,1014,1836,37.516598,127.00959
서초구,2262, 한신16차아파트 119동 앞,201904,1909,2428,4337,37.516598,127.00959
서초구,2262, 한신16차아파트 119동 앞,201905,3818,4402,8220,37.516598,127.00959
서초구,2262, 한신16차아파트 119동 앞,201906,3591,4203,7794,37.516598,127.00959
서초구,2262, 한신16차아파트 119동 앞,201907,3091,3473,6564,37.516598,127.00959
서초구,2262, 한신16차아파트 119동 앞,201908,3835,4264,8099,37.516598,127.00959
서초구,2262, 한신16차아파트 119동 앞,201909,3854,4277,8131,37.516598,127.00959
서초구,2262, 한신16차아파트 119동 앞,201910,4320,4919,9239,37.516598,127.00959
서초구,2262, 한신16차아파트 119동 앞,201911,1392,1642,3034,37.516598,127.00959
서초구,2262, 한신16차아파트 119동 앞,201912,483,569,1052,37.516598,127.00959
서초구,2262, 한신16차아파트 119동 앞,202001,566,630,1196,37.516598,127.00959
서초구,2262, 한신16차아파트 119동 앞,202002,815,932,1747,37.516598,127.00959
서초구,2262, 한신16차아파트 119동 앞,202003,4185,4630,8815,37.516598,127.00959
서초구,2262, 한신16차아파트 119동 앞,202004,5712,6046,11758,37.516598,127.00959
서초구,2262, 한신16차아파트 119동 앞,202005,6602,6805,13407,37.516598,127.00959
서초구,2262, 한신16차아파트 119동 앞,202006,5040,5235,10275,37.516598,127.00959
서초구,2263, 바우뫼문화복지회관,201901,323,307,630,37.471928,127.02684
서초구,2263, 바우뫼문화복지회관,201902,288,252,540,37.471928,127.02684
서초구,2263, 바우뫼문화복지회관,201903,502,446,948,37.471928,127.02684
서초구,2263, 바우뫼문화복지회관,201904,779,708,1487,37.471928,127.02684
서초구,2263, 바우뫼문화복지회관,201905,1021,972,1993,37.471928,127.02684
서초구,2263, 바우뫼문화복지회관,201906,1052,1013,2065,37.471928,127.02684
서초구,2263, 바우뫼문화복지회관,201907,1122,1082,2204,37.471928,127.02684
서초구,2263, 바우뫼문화복지회관,201908,1015,993,2008,37.471928,127.02684
서초구,2263, 바우뫼문화복지회관,201909,1019,974,1993,37.471928,127.02684
서초구,2263, 바우뫼문화복지회관,201910,1093,1035,2128,37.471928,127.02684
서초구,2263, 바우뫼문화복지회관,201911,768,751,1519,37.471928,127.02684
서초구,2263, 바우뫼문화복지회관,201912,443,412,855,37.471928,127.02684
서초구,2263, 바우뫼문화복지회관,202001,387,409,796,37.471928,127.02684
서초구,2263, 바우뫼문화복지회관,202002,346,338,684,37.471928,127.02684
서초구,2263, 바우뫼문화복지회관,202003,522,504,1026,37.471928,127.02684
서초구,2263, 바우뫼문화복지회관,202004,584,581,1165,37.471928,127.02684
서초구,2263, 바우뫼문화복지회관,202005,777,768,1545,37.471928,127.02684
서초구,2263, 바우뫼문화복지회관,202006,898,877,1775,37.471928,127.02684
서초구,2264, 이수역 1번출구,201901,361,406,767,37.488556,126.982574
서초구,2264, 이수역 1번출구,201902,385,489,874,37.488556,126.982574
서초구,2264, 이수역 1번출구,201903,789,934,1723,37.488556,126.982574
서초구,2264, 이수역 1번출구,201904,1151,1463,2614,37.488556,126.982574
서초구,2264, 이수역 1번출구,201905,1968,2428,4396,37.488556,126.982574
서초구,2264, 이수역 1번출구,201906,2568,2812,5380,37.488556,126.982574
서초구,2264, 이수역 1번출구,201907,2519,2740,5259,37.488556,126.982574
서초구,2264, 이수역 1번출구,201908,2701,2892,5593,37.488556,126.982574
서초구,2264, 이수역 1번출구,201909,2668,2821,5489,37.488556,126.982574
서초구,2264, 이수역 1번출구,201910,3062,3331,6393,37.488556,126.982574
서초구,2264, 이수역 1번출구,201911,1621,1755,3376,37.488556,126.982574
서초구,2264, 이수역 1번출구,201912,965,1036,2001,37.488556,126.982574
서초구,2264, 이수역 1번출구,202001,924,941,1865,37.488556,126.982574
서초구,2264, 이수역 1번출구,202002,803,872,1675,37.488556,126.982574
서초구,2264, 이수역 1번출구,202003,1490,1638,3128,37.488556,126.982574
서초구,2264, 이수역 1번출구,202004,2395,2527,4922,37.488556,126.982574
서초구,2264, 이수역 1번출구,202005,3242,3295,6537,37.488556,126.982574
서초구,2264, 이수역 1번출구,202006,3232,3330,6562,37.488556,126.982574
서초구,2265, 이수고가차도 남단,201901,386,424,810,37.494743,126.983063
서초구,2265, 이수고가차도 남단,201902,423,417,840,37.494743,126.983063
서초구,2265, 이수고가차도 남단,201903,814,829,1643,37.494743,126.983063
서초구,2265, 이수고가차도 남단,201904,1447,1554,3001,37.494743,126.983063
서초구,2265, 이수고가차도 남단,201905,2403,2485,4888,37.494743,126.983063
서초구,2265, 이수고가차도 남단,201906,2618,2737,5355,37.494743,126.983063
서초구,2265, 이수고가차도 남단,201907,2522,2640,5162,37.494743,126.983063
서초구,2265, 이수고가차도 남단,201908,2458,2571,5029,37.494743,126.983063
서초구,2265, 이수고가차도 남단,201909,2518,2820,5338,37.494743,126.983063
서초구,2265, 이수고가차도 남단,201910,16,29,45,37.494743,126.983063
서초구,2265, 이수고가차도 남단,201911,622,669,1291,37.494743,126.983063
서초구,2265, 이수고가차도 남단,201912,527,609,1136,37.494743,126.983063
서초구,2265, 이수고가차도 남단,202001,536,601,1137,37.494743,126.983063
서초구,2265, 이수고가차도 남단,202002,503,541,1044,37.494743,126.983063
서초구,2265, 이수고가차도 남단,202003,1444,1490,2934,37.494743,126.983063
서초구,2265, 이수고가차도 남단,202004,1904,2001,3905,37.494743,126.983063
서초구,2265, 이수고가차도 남단,202005,2582,2624,5206,37.494743,126.983063
서초구,2265, 이수고가차도 남단,202006,2625,2817,5442,37.494743,126.983063
서초구,2266, 서초역 3번출구,201901,274,256,530,37.49054,127.008163
서초구,2266, 서초역 3번출구,201902,241,229,470,37.49054,127.008163
서초구,2266, 서초역 3번출구,201903,393,391,784,37.49054,127.008163
서초구,2266, 서초역 3번출구,201904,661,628,1289,37.49054,127.008163
서초구,2266, 서초역 3번출구,201905,1086,953,2039,37.49054,127.008163
서초구,2266, 서초역 3번출구,201906,1213,1085,2298,37.49054,127.008163
서초구,2266, 서초역 3번출구,201907,1056,940,1996,37.49054,127.008163
서초구,2266, 서초역 3번출구,201908,1097,913,2010,37.49054,127.008163
서초구,2266, 서초역 3번출구,201909,1258,1062,2320,37.49054,127.008163
서초구,2266, 서초역 3번출구,201910,1495,1293,2788,37.49054,127.008163
서초구,2266, 서초역 3번출구,201911,918,859,1777,37.49054,127.008163
서초구,2266, 서초역 3번출구,201912,538,527,1065,37.49054,127.008163
서초구,2266, 서초역 3번출구,202001,501,483,984,37.49054,127.008163
서초구,2266, 서초역 3번출구,202002,379,380,759,37.49054,127.008163
서초구,2266, 서초역 3번출구,202003,668,593,1261,37.49054,127.008163
서초구,2266, 서초역 3번출구,202004,771,718,1489,37.49054,127.008163
서초구,2266, 서초역 3번출구,202005,754,718,1472,37.49054,127.008163
서초구,2266, 서초역 3번출구,202006,990,860,1850,37.49054,127.008163
서초구,2268, 서초4동주민센터,201901,219,218,437,37.502319,127.02227
서초구,2268, 서초4동주민센터,201902,204,193,397,37.502319,127.02227
서초구,2268, 서초4동주민센터,201903,420,434,854,37.502319,127.02227
서초구,2268, 서초4동주민센터,201904,671,633,1304,37.502319,127.02227
서초구,2268, 서초4동주민센터,201905,942,925,1867,37.502319,127.02227
서초구,2268, 서초4동주민센터,201906,1098,1082,2180,37.502319,127.02227
서초구,2268, 서초4동주민센터,201907,1025,981,2006,37.502319,127.02227
서초구,2268, 서초4동주민센터,201908,824,726,1550,37.502319,127.02227
서초구,2268, 서초4동주민센터,201909,952,876,1828,37.502319,127.02227
서초구,2268, 서초4동주민센터,201910,1056,1006,2062,37.502319,127.02227
서초구,2268, 서초4동주민센터,201911,678,638,1316,37.502319,127.02227
서초구,2268, 서초4동주민센터,201912,339,346,685,37.502319,127.02227
서초구,2268, 서초4동주민센터,202001,308,285,593,37.502319,127.02227
서초구,2268, 서초4동주민센터,202002,270,260,530,37.502319,127.02227
서초구,2268, 서초4동주민센터,202003,510,483,993,37.502319,127.02227
서초구,2268, 서초4동주민센터,202004,692,623,1315,37.502319,127.02227
서초구,2268, 서초4동주민센터,202005,824,729,1553,37.502319,127.02227
서초구,2268, 서초4동주민센터,202006,857,794,1651,37.502319,127.02227
서초구,2269, 주홍교 하부,201901,102,94,196,37.510349,127.016052
서초구,2269, 주홍교 하부,201902,116,95,211,37.510349,127.016052
서초구,2269, 주홍교 하부,201903,251,183,434,37.510349,127.016052
서초구,2269, 주홍교 하부,201904,381,271,652,37.510349,127.016052
서초구,2269, 주홍교 하부,201905,589,417,1006,37.510349,127.016052
서초구,2269, 주홍교 하부,201906,515,375,890,37.510349,127.016052
서초구,2269, 주홍교 하부,201907,499,353,852,37.510349,127.016052
서초구,2269, 주홍교 하부,201908,445,349,794,37.510349,127.016052
서초구,2269, 주홍교 하부,201909,451,350,801,37.510349,127.016052
서초구,2269, 주홍교 하부,201910,541,383,924,37.510349,127.016052
서초구,2269, 주홍교 하부,201911,234,191,425,37.510349,127.016052
서초구,2269, 주홍교 하부,201912,138,105,243,37.510349,127.016052
서초구,2269, 주홍교 하부,202001,158,122,280,37.510349,127.016052
서초구,2269, 주홍교 하부,202002,158,139,297,37.510349,127.016052
서초구,2269, 주홍교 하부,202003,286,197,483,37.510349,127.016052
서초구,2269, 주홍교 하부,202004,345,305,650,37.510349,127.016052
서초구,2269, 주홍교 하부,202005,440,397,837,37.510349,127.016052
서초구,2269, 주홍교 하부,202006,350,331,681,37.510349,127.016052
서초구,2270, 서초포레스타 7단지,201901,73,101,174,37.448967,127.057739
서초구,2270, 서초포레스타 7단지,201902,102,139,241,37.448967,127.057739
서초구,2270, 서초포레스타 7단지,201903,136,216,352,37.448967,127.057739
서초구,2270, 서초포레스타 7단지,201904,214,254,468,37.448967,127.057739
서초구,2270, 서초포레스타 7단지,201905,353,347,700,37.448967,127.057739
서초구,2270, 서초포레스타 7단지,201906,403,423,826,37.448967,127.057739
서초구,2270, 서초포레스타 7단지,201907,441,460,901,37.448967,127.057739
서초구,2270, 서초포레스타 7단지,201908,416,417,833,37.448967,127.057739
서초구,2270, 서초포레스타 7단지,201909,371,364,735,37.448967,127.057739
서초구,2270, 서초포레스타 7단지,201910,414,389,803,37.448967,127.057739
서초구,2270, 서초포레스타 7단지,201911,310,299,609,37.448967,127.057739
서초구,2270, 서초포레스타 7단지,201912,133,132,265,37.448967,127.057739
서초구,2270, 서초포레스타 7단지,202001,124,143,267,37.448967,127.057739
서초구,2270, 서초포레스타 7단지,202002,166,174,340,37.448967,127.057739
서초구,2270, 서초포레스타 7단지,202003,356,332,688,37.448967,127.057739
서초구,2270, 서초포레스타 7단지,202004,466,423,889,37.448967,127.057739
서초구,2270, 서초포레스타 7단지,202005,448,427,875,37.448967,127.057739
서초구,2270, 서초포레스타 7단지,202006,519,494,1013,37.448967,127.057739
서초구,2271, 내방역 8번출구 앞,201901,110,138,248,37.487865,126.994293
서초구,2271, 내방역 8번출구 앞,201902,55,77,132,37.487865,126.994293
서초구,2271, 내방역 8번출구 앞,201904,176,177,353,37.487865,126.994293
서초구,2271, 내방역 8번출구 앞,201905,1116,1254,2370,37.487865,126.994293
서초구,2271, 내방역 8번출구 앞,201906,1006,1111,2117,37.487865,126.994293
서초구,2271, 내방역 8번출구 앞,201907,986,1072,2058,37.487865,126.994293
서초구,2271, 내방역 8번출구 앞,201908,971,986,1957,37.487865,126.994293
서초구,2271, 내방역 8번출구 앞,201909,903,947,1850,37.487865,126.994293
서초구,2271, 내방역 8번출구 앞,201910,1123,1137,2260,37.487865,126.994293
서초구,2271, 내방역 8번출구 앞,201911,634,665,1299,37.487865,126.994293
서초구,2271, 내방역 8번출구 앞,201912,378,451,829,37.487865,126.994293
서초구,2271, 내방역 8번출구 앞,202001,293,333,626,37.487865,126.994293
서초구,2271, 내방역 8번출구 앞,202002,294,321,615,37.487865,126.994293
서초구,2271, 내방역 8번출구 앞,202003,628,657,1285,37.487865,126.994293
서초구,2271, 내방역 8번출구 앞,202004,753,743,1496,37.487865,126.994293
서초구,2271, 내방역 8번출구 앞,202005,882,893,1775,37.487865,126.994293
서초구,2271, 내방역 8번출구 앞,202006,972,991,1963,37.487865,126.994293
서초구,2272, 교대입구 교차로,201901,102,101,203,37.487309,127.010582
서초구,2272, 교대입구 교차로,201902,116,112,228,37.487309,127.010582
서초구,2272, 교대입구 교차로,201903,175,161,336,37.487309,127.010582
서초구,2272, 교대입구 교차로,201904,319,312,631,37.487309,127.010582
서초구,2272, 교대입구 교차로,201905,441,411,852,37.487309,127.010582
서초구,2272, 교대입구 교차로,201906,518,490,1008,37.487309,127.010582
서초구,2272, 교대입구 교차로,201907,421,418,839,37.487309,127.010582
서초구,2272, 교대입구 교차로,201908,408,340,748,37.487309,127.010582
서초구,2272, 교대입구 교차로,201909,450,365,815,37.487309,127.010582
서초구,2272, 교대입구 교차로,201910,534,470,1004,37.487309,127.010582
서초구,2272, 교대입구 교차로,201911,294,247,541,37.487309,127.010582
서초구,2272, 교대입구 교차로,201912,141,131,272,37.487309,127.010582
서초구,2272, 교대입구 교차로,202001,158,130,288,37.487309,127.010582
서초구,2272, 교대입구 교차로,202002,123,112,235,37.487309,127.010582
서초구,2272, 교대입구 교차로,202003,186,163,349,37.487309,127.010582
서초구,2272, 교대입구 교차로,202004,221,214,435,37.487309,127.010582
서초구,2272, 교대입구 교차로,202005,242,231,473,37.487309,127.010582
서초구,2272, 교대입구 교차로,202006,301,282,583,37.487309,127.010582
서초구,2273, 일동제약 사거리,201901,201,265,466,37.477829,127.038269
서초구,2273, 일동제약 사거리,201902,176,256,432,37.477829,127.038269
서초구,2273, 일동제약 사거리,201903,412,487,899,37.477829,127.038269
서초구,2273, 일동제약 사거리,201904,734,796,1530,37.477829,127.038269
서초구,2273, 일동제약 사거리,201905,1113,1110,2223,37.477829,127.038269
서초구,2273, 일동제약 사거리,201906,1036,1043,2079,37.477829,127.038269
서초구,2273, 일동제약 사거리,201907,702,703,1405,37.477829,127.038269
서초구,2273, 일동제약 사거리,201908,939,945,1884,37.477829,127.038269
서초구,2273, 일동제약 사거리,201909,891,900,1791,37.477829,127.038269
서초구,2273, 일동제약 사거리,201910,1065,1092,2157,37.477829,127.038269
서초구,2273, 일동제약 사거리,201911,617,688,1305,37.477829,127.038269
서초구,2273, 일동제약 사거리,201912,359,375,734,37.477829,127.038269
서초구,2273, 일동제약 사거리,202001,283,373,656,37.477829,127.038269
서초구,2273, 일동제약 사거리,202002,326,347,673,37.477829,127.038269
서초구,2273, 일동제약 사거리,202003,719,719,1438,37.477829,127.038269
서초구,2273, 일동제약 사거리,202004,801,797,1598,37.477829,127.038269
서초구,2273, 일동제약 사거리,202005,843,837,1680,37.477829,127.038269
서초구,2273, 일동제약 사거리,202006,1084,1096,2180,37.477829,127.038269
서초구,2274, 양재시민의숲역 3번출구,201901,432,459,891,37.46965,127.039612
서초구,2274, 양재시민의숲역 3번출구,201902,366,415,781,37.46965,127.039612
서초구,2274, 양재시민의숲역 3번출구,201903,678,693,1371,37.46965,127.039612
서초구,2274, 양재시민의숲역 3번출구,201904,1130,1187,2317,37.46965,127.039612
서초구,2274, 양재시민의숲역 3번출구,201905,946,961,1907,37.46965,127.039612
서초구,2274, 양재시민의숲역 3번출구,201906,1739,1758,3497,37.46965,127.039612
서초구,2274, 양재시민의숲역 3번출구,201907,1923,1918,3841,37.46965,127.039612
서초구,2274, 양재시민의숲역 3번출구,201908,1945,1979,3924,37.46965,127.039612
서초구,2274, 양재시민의숲역 3번출구,201909,1696,1719,3415,37.46965,127.039612
서초구,2274, 양재시민의숲역 3번출구,201910,1836,1852,3688,37.46965,127.039612
서초구,2274, 양재시민의숲역 3번출구,201911,1451,1443,2894,37.46965,127.039612
서초구,2274, 양재시민의숲역 3번출구,201912,827,840,1667,37.46965,127.039612
서초구,2274, 양재시민의숲역 3번출구,202001,692,721,1413,37.46965,127.039612
서초구,2274, 양재시민의숲역 3번출구,202002,715,744,1459,37.46965,127.039612
서초구,2274, 양재시민의숲역 3번출구,202003,1196,1216,2412,37.46965,127.039612
서초구,2274, 양재시민의숲역 3번출구,202004,1283,1265,2548,37.46965,127.039612
서초구,2274, 양재시민의숲역 3번출구,202005,1383,1368,2751,37.46965,127.039612
서초구,2274, 양재시민의숲역 3번출구,202006,1709,1701,3410,37.46965,127.039612
서초구,2275, 염곡치안센터 건너편,201901,13,10,23,37.461578,127.048798
서초구,2275, 염곡치안센터 건너편,201902,30,22,52,37.461578,127.048798
서초구,2275, 염곡치안센터 건너편,201903,33,21,54,37.461578,127.048798
서초구,2275, 염곡치안센터 건너편,201904,55,49,104,37.461578,127.048798
서초구,2275, 염곡치안센터 건너편,201905,112,94,206,37.461578,127.048798
서초구,2275, 염곡치안센터 건너편,201906,90,72,162,37.461578,127.048798
서초구,2275, 염곡치안센터 건너편,201907,77,65,142,37.461578,127.048798
서초구,2275, 염곡치안센터 건너편,201908,85,65,150,37.461578,127.048798
서초구,2275, 염곡치안센터 건너편,201909,82,70,152,37.461578,127.048798
서초구,2275, 염곡치안센터 건너편,201910,95,87,182,37.461578,127.048798
서초구,2275, 염곡치안센터 건너편,201911,70,50,120,37.461578,127.048798
서초구,2275, 염곡치안센터 건너편,201912,48,36,84,37.461578,127.048798
서초구,2275, 염곡치안센터 건너편,202001,25,19,44,37.461578,127.048798
서초구,2275, 염곡치안센터 건너편,202002,38,25,63,37.461578,127.048798
서초구,2275, 염곡치안센터 건너편,202003,61,47,108,37.461578,127.048798
서초구,2275, 염곡치안센터 건너편,202004,61,64,125,37.461578,127.048798
서초구,2275, 염곡치안센터 건너편,202005,62,60,122,37.461578,127.048798
서초구,2275, 염곡치안센터 건너편,202006,107,63,170,37.461578,127.048798
서초구,2276, 영동1교 (양재천근린공원),201901,199,188,387,37.474388,127.038902
서초구,2276, 영동1교 (양재천근린공원),201902,186,190,376,37.474388,127.038902
서초구,2276, 영동1교 (양재천근린공원),201903,397,403,800,37.474388,127.038902
서초구,2276, 영동1교 (양재천근린공원),201904,892,895,1787,37.474388,127.038902
서초구,2276, 영동1교 (양재천근린공원),201905,1180,1136,2316,37.474388,127.038902
서초구,2276, 영동1교 (양재천근린공원),201906,1252,1235,2487,37.474388,127.038902
서초구,2276, 영동1교 (양재천근린공원),201907,1126,1082,2208,37.474388,127.038902
서초구,2276, 영동1교 (양재천근린공원),201908,986,970,1956,37.474388,127.038902
서초구,2276, 영동1교 (양재천근린공원),201909,1107,1080,2187,37.474388,127.038902
서초구,2276, 영동1교 (양재천근린공원),201910,1174,1128,2302,37.474388,127.038902
서초구,2276, 영동1교 (양재천근린공원),201911,641,673,1314,37.474388,127.038902
서초구,2276, 영동1교 (양재천근린공원),201912,381,389,770,37.474388,127.038902
서초구,2276, 영동1교 (양재천근린공원),202001,362,367,729,37.474388,127.038902
서초구,2276, 영동1교 (양재천근린공원),202002,413,414,827,37.474388,127.038902
서초구,2276, 영동1교 (양재천근린공원),202003,996,951,1947,37.474388,127.038902
서초구,2276, 영동1교 (양재천근린공원),202004,1013,978,1991,37.474388,127.038902
서초구,2276, 영동1교 (양재천근린공원),202005,1116,1069,2185,37.474388,127.038902
서초구,2276, 영동1교 (양재천근린공원),202006,1143,1109,2252,37.474388,127.038902
서초구,2277, 길마중4교 하부,201901,210,222,432,37.51487,127.015282
서초구,2277, 길마중4교 하부,201902,176,227,403,37.51487,127.015282
서초구,2277, 길마중4교 하부,201903,223,281,504,37.51487,127.015282
서초구,2277, 길마중4교 하부,201904,393,406,799,37.51487,127.015282
서초구,2277, 길마중4교 하부,201905,1174,1161,2335,37.51487,127.015282
서초구,2277, 길마중4교 하부,201906,1252,1233,2485,37.51487,127.015282
서초구,2277, 길마중4교 하부,201907,1196,1138,2334,37.51487,127.015282
서초구,2277, 길마중4교 하부,201908,1170,1139,2309,37.51487,127.015282
서초구,2277, 길마중4교 하부,201909,1199,1182,2381,37.51487,127.015282
서초구,2277, 길마중4교 하부,201910,1351,1344,2695,37.51487,127.015282
서초구,2277, 길마중4교 하부,201911,799,858,1657,37.51487,127.015282
서초구,2277, 길마중4교 하부,201912,396,464,860,37.51487,127.015282
서초구,2277, 길마중4교 하부,202001,364,423,787,37.51487,127.015282
서초구,2277, 길마중4교 하부,202002,383,418,801,37.51487,127.015282
서초구,2277, 길마중4교 하부,202003,853,855,1708,37.51487,127.015282
서초구,2277, 길마중4교 하부,202004,1219,1193,2412,37.51487,127.015282
서초구,2277, 길마중4교 하부,202005,1283,1289,2572,37.51487,127.015282
서초구,2277, 길마중4교 하부,202006,1373,1328,2701,37.51487,127.015282
서초구,2279, 교대역 5번출구뒤,201901,395,403,798,37.493618,127.014183
서초구,2279, 교대역 5번출구뒤,201902,344,372,716,37.493618,127.014183
서초구,2279, 교대역 5번출구뒤,201903,666,704,1370,37.493618,127.014183
서초구,2279, 교대역 5번출구뒤,201904,1037,1112,2149,37.493618,127.014183
서초구,2279, 교대역 5번출구뒤,201905,1620,1567,3187,37.493618,127.014183
서초구,2279, 교대역 5번출구뒤,201906,1704,1656,3360,37.493618,127.014183
서초구,2279, 교대역 5번출구뒤,201907,1801,1789,3590,37.493618,127.014183
서초구,2279, 교대역 5번출구뒤,201908,1668,1612,3280,37.493618,127.014183
서초구,2279, 교대역 5번출구뒤,201909,1619,1590,3209,37.493618,127.014183
서초구,2279, 교대역 5번출구뒤,201910,1987,2003,3990,37.493618,127.014183
서초구,2279, 교대역 5번출구뒤,201911,1255,1306,2561,37.493618,127.014183
서초구,2279, 교대역 5번출구뒤,201912,748,743,1491,37.493618,127.014183
서초구,2279, 교대역 5번출구뒤,202001,619,647,1266,37.493618,127.014183
서초구,2279, 교대역 5번출구뒤,202002,591,586,1177,37.493618,127.014183
서초구,2279, 교대역 5번출구뒤,202003,932,884,1816,37.493618,127.014183
서초구,2279, 교대역 5번출구뒤,202004,1065,1009,2074,37.493618,127.014183
서초구,2279, 교대역 5번출구뒤,202005,1146,1099,2245,37.493618,127.014183
서초구,2279, 교대역 5번출구뒤,202006,1387,1369,2756,37.493618,127.014183
서초구,2280, 서울서초고용센터앞,201901,187,170,357,37.484161,127.010971
서초구,2280, 서울서초고용센터앞,201902,196,161,357,37.484161,127.010971
서초구,2280, 서울서초고용센터앞,201903,385,337,722,37.484161,127.010971
서초구,2280, 서울서초고용센터앞,201904,591,504,1095,37.484161,127.010971
서초구,2280, 서울서초고용센터앞,201905,879,767,1646,37.484161,127.010971
서초구,2280, 서울서초고용센터앞,201906,1011,924,1935,37.484161,127.010971
서초구,2280, 서울서초고용센터앞,201907,823,775,1598,37.484161,127.010971
서초구,2280, 서울서초고용센터앞,201908,940,792,1732,37.484161,127.010971
서초구,2280, 서울서초고용센터앞,201909,930,788,1718,37.484161,127.010971
서초구,2280, 서울서초고용센터앞,201910,1089,960,2049,37.484161,127.010971
서초구,2280, 서울서초고용센터앞,201911,624,583,1207,37.484161,127.010971
서초구,2280, 서울서초고용센터앞,201912,378,357,735,37.484161,127.010971
서초구,2280, 서울서초고용센터앞,202001,317,257,574,37.484161,127.010971
서초구,2280, 서울서초고용센터앞,202002,229,208,437,37.484161,127.010971
서초구,2280, 서울서초고용센터앞,202003,379,341,720,37.484161,127.010971
서초구,2280, 서울서초고용센터앞,202004,565,530,1095,37.484161,127.010971
서초구,2280, 서울서초고용센터앞,202005,598,573,1171,37.484161,127.010971
서초구,2280, 서울서초고용센터앞,202006,604,563,1167,37.484161,127.010971
서초구,2281, 연세사랑병원신관앞,201901,123,109,232,37.475979,126.986282
서초구,2281, 연세사랑병원신관앞,201902,102,109,211,37.475979,126.986282
서초구,2281, 연세사랑병원신관앞,201903,202,231,433,37.475979,126.986282
서초구,2281, 연세사랑병원신관앞,201904,374,378,752,37.475979,126.986282
서초구,2281, 연세사랑병원신관앞,201905,490,529,1019,37.475979,126.986282
서초구,2281, 연세사랑병원신관앞,201906,524,565,1089,37.475979,126.986282
서초구,2281, 연세사랑병원신관앞,201907,448,434,882,37.475979,126.986282
서초구,2281, 연세사랑병원신관앞,201908,456,478,934,37.475979,126.986282
서초구,2281, 연세사랑병원신관앞,201909,475,495,970,37.475979,126.986282
서초구,2281, 연세사랑병원신관앞,201910,598,613,1211,37.475979,126.986282
서초구,2281, 연세사랑병원신관앞,201911,339,323,662,37.475979,126.986282
서초구,2281, 연세사랑병원신관앞,201912,169,164,333,37.475979,126.986282
서초구,2281, 연세사랑병원신관앞,202001,158,158,316,37.475979,126.986282
서초구,2281, 연세사랑병원신관앞,202002,145,147,292,37.475979,126.986282
서초구,2281, 연세사랑병원신관앞,202003,248,239,487,37.475979,126.986282
서초구,2281, 연세사랑병원신관앞,202004,364,369,733,37.475979,126.986282
서초구,2281, 연세사랑병원신관앞,202005,423,425,848,37.475979,126.986282
서초구,2281, 연세사랑병원신관앞,202006,513,513,1026,37.475979,126.986282
서초구,2282, 방배래미안아트힐 101동앞,201901,98,26,124,37.477203,127.005836
서초구,2282, 방배래미안아트힐 101동앞,201902,95,18,113,37.477203,127.005836
서초구,2282, 방배래미안아트힐 101동앞,201903,182,55,237,37.477203,127.005836
서초구,2282, 방배래미안아트힐 101동앞,201904,283,88,371,37.477203,127.005836
서초구,2282, 방배래미안아트힐 101동앞,201905,389,150,539,37.477203,127.005836
서초구,2282, 방배래미안아트힐 101동앞,201906,459,135,594,37.477203,127.005836
서초구,2282, 방배래미안아트힐 101동앞,201907,425,119,544,37.477203,127.005836
서초구,2282, 방배래미안아트힐 101동앞,201908,419,118,537,37.477203,127.005836
서초구,2282, 방배래미안아트힐 101동앞,201909,357,87,444,37.477203,127.005836
서초구,2282, 방배래미안아트힐 101동앞,201910,408,81,489,37.477203,127.005836
서초구,2282, 방배래미안아트힐 101동앞,201911,262,59,321,37.477203,127.005836
서초구,2282, 방배래미안아트힐 101동앞,201912,111,48,159,37.477203,127.005836
서초구,2282, 방배래미안아트힐 101동앞,202001,161,37,198,37.477203,127.005836
서초구,2282, 방배래미안아트힐 101동앞,202002,127,32,159,37.477203,127.005836
서초구,2282, 방배래미안아트힐 101동앞,202003,183,61,244,37.477203,127.005836
서초구,2282, 방배래미안아트힐 101동앞,202004,191,76,267,37.477203,127.005836
서초구,2282, 방배래미안아트힐 101동앞,202005,174,84,258,37.477203,127.005836
서초구,2282, 방배래미안아트힐 101동앞,202006,209,77,286,37.477203,127.005836
서초구,2283, 그룹한빌딩옆,201901,72,55,127,37.486526,126.989166
서초구,2283, 그룹한빌딩옆,201902,109,55,164,37.486526,126.989166
서초구,2283, 그룹한빌딩옆,201903,229,69,298,37.486526,126.989166
서초구,2283, 그룹한빌딩옆,201904,331,119,450,37.486526,126.989166
서초구,2283, 그룹한빌딩옆,201905,434,183,617,37.486526,126.989166
서초구,2283, 그룹한빌딩옆,201906,431,161,592,37.486526,126.989166
서초구,2283, 그룹한빌딩옆,201907,364,117,481,37.486526,126.989166
서초구,2283, 그룹한빌딩옆,201908,423,123,546,37.486526,126.989166
서초구,2283, 그룹한빌딩옆,201909,405,126,531,37.486526,126.989166
서초구,2283, 그룹한빌딩옆,201910,419,146,565,37.486526,126.989166
서초구,2283, 그룹한빌딩옆,201911,318,97,415,37.486526,126.989166
서초구,2283, 그룹한빌딩옆,201912,140,32,172,37.486526,126.989166
서초구,2283, 그룹한빌딩옆,202001,142,31,173,37.486526,126.989166
서초구,2283, 그룹한빌딩옆,202002,111,30,141,37.486526,126.989166
서초구,2283, 그룹한빌딩옆,202003,190,52,242,37.486526,126.989166
서초구,2283, 그룹한빌딩옆,202004,238,84,322,37.486526,126.989166
서초구,2283, 그룹한빌딩옆,202005,208,96,304,37.486526,126.989166
서초구,2283, 그룹한빌딩옆,202006,271,81,352,37.486526,126.989166
서초구,2284, CJ오쇼핑앞,201901,94,64,158,37.468102,126.986801
서초구,2284, CJ오쇼핑앞,201902,133,43,176,37.468102,126.986801
서초구,2284, CJ오쇼핑앞,201903,252,126,378,37.468102,126.986801
서초구,2284, CJ오쇼핑앞,201904,342,185,527,37.468102,126.986801
서초구,2284, CJ오쇼핑앞,201905,381,202,583,37.468102,126.986801
서초구,2284, CJ오쇼핑앞,201906,334,198,532,37.468102,126.986801
서초구,2284, CJ오쇼핑앞,201907,345,196,541,37.468102,126.986801
서초구,2284, CJ오쇼핑앞,201908,337,151,488,37.468102,126.986801
서초구,2284, CJ오쇼핑앞,201909,322,191,513,37.468102,126.986801
서초구,2284, CJ오쇼핑앞,201910,373,252,625,37.468102,126.986801
서초구,2284, CJ오쇼핑앞,201911,332,173,505,37.468102,126.986801
서초구,2284, CJ오쇼핑앞,201912,152,88,240,37.468102,126.986801
서초구,2284, CJ오쇼핑앞,202001,166,70,236,37.468102,126.986801
서초구,2284, CJ오쇼핑앞,202002,95,49,144,37.468102,126.986801
서초구,2284, CJ오쇼핑앞,202003,122,65,187,37.468102,126.986801
서초구,2284, CJ오쇼핑앞,202004,167,92,259,37.468102,126.986801
서초구,2284, CJ오쇼핑앞,202005,127,97,224,37.468102,126.986801
서초구,2284, CJ오쇼핑앞,202006,220,130,350,37.468102,126.986801
서초구,2285, LH서초3단지 301동 맞은편,201901,233,171,404,37.457424,127.022652
서초구,2285, LH서초3단지 301동 맞은편,201902,213,170,383,37.457424,127.022652
서초구,2285, LH서초3단지 301동 맞은편,201903,376,296,672,37.457424,127.022652
서초구,2285, LH서초3단지 301동 맞은편,201904,564,454,1018,37.457424,127.022652
서초구,2285, LH서초3단지 301동 맞은편,201905,678,564,1242,37.457424,127.022652
서초구,2285, LH서초3단지 301동 맞은편,201906,719,591,1310,37.457424,127.022652
서초구,2285, LH서초3단지 301동 맞은편,201907,616,542,1158,37.457424,127.022652
서초구,2285, LH서초3단지 301동 맞은편,201908,590,504,1094,37.457424,127.022652
서초구,2285, LH서초3단지 301동 맞은편,201909,593,443,1036,37.457424,127.022652
서초구,2285, LH서초3단지 301동 맞은편,201910,678,502,1180,37.457424,127.022652
서초구,2285, LH서초3단지 301동 맞은편,201911,482,336,818,37.457424,127.022652
서초구,2285, LH서초3단지 301동 맞은편,201912,298,218,516,37.457424,127.022652
서초구,2285, LH서초3단지 301동 맞은편,202001,307,258,565,37.457424,127.022652
서초구,2285, LH서초3단지 301동 맞은편,202002,305,261,566,37.457424,127.022652
서초구,2285, LH서초3단지 301동 맞은편,202003,581,532,1113,37.457424,127.022652
서초구,2285, LH서초3단지 301동 맞은편,202004,626,522,1148,37.457424,127.022652
서초구,2285, LH서초3단지 301동 맞은편,202005,637,542,1179,37.457424,127.022652
서초구,2285, LH서초3단지 301동 맞은편,202006,788,679,1467,37.457424,127.022652
서초구,2286, 탑성마을입구,201901,23,3,26,37.458549,127.055885
서초구,2286, 탑성마을입구,201902,35,7,42,37.458549,127.055885
서초구,2286, 탑성마을입구,201903,41,10,51,37.458549,127.055885
서초구,2286, 탑성마을입구,201904,75,10,85,37.458549,127.055885
서초구,2286, 탑성마을입구,201905,65,12,77,37.458549,127.055885
서초구,2286, 탑성마을입구,201906,93,30,123,37.458549,127.055885
서초구,2286, 탑성마을입구,201907,109,23,132,37.458549,127.055885
서초구,2286, 탑성마을입구,201908,90,9,99,37.458549,127.055885
서초구,2286, 탑성마을입구,201909,93,15,108,37.458549,127.055885
서초구,2286, 탑성마을입구,201910,97,35,132,37.458549,127.055885
서초구,2286, 탑성마을입구,201911,82,9,91,37.458549,127.055885
서초구,2286, 탑성마을입구,201912,38,10,48,37.458549,127.055885
서초구,2286, 탑성마을입구,202001,41,8,49,37.458549,127.055885
서초구,2286, 탑성마을입구,202002,57,5,62,37.458549,127.055885
서초구,2286, 탑성마을입구,202003,58,23,81,37.458549,127.055885
서초구,2286, 탑성마을입구,202004,46,11,57,37.458549,127.055885
서초구,2286, 탑성마을입구,202005,54,20,74,37.458549,127.055885
서초구,2286, 탑성마을입구,202006,74,35,109,37.458549,127.055885
서초구,2287, 능안마을입구,201901,6,4,10,37.45562,127.067101
서초구,2287, 능안마을입구,201902,12,6,18,37.45562,127.067101
서초구,2287, 능안마을입구,201903,28,3,31,37.45562,127.067101
서초구,2287, 능안마을입구,201904,46,17,63,37.45562,127.067101
서초구,2287, 능안마을입구,201905,59,28,87,37.45562,127.067101
서초구,2287, 능안마을입구,201906,54,34,88,37.45562,127.067101
서초구,2287, 능안마을입구,201907,60,34,94,37.45562,127.067101
서초구,2287, 능안마을입구,201908,59,31,90,37.45562,127.067101
서초구,2287, 능안마을입구,201909,39,23,62,37.45562,127.067101
서초구,2287, 능안마을입구,201910,41,13,54,37.45562,127.067101
서초구,2287, 능안마을입구,201911,26,5,31,37.45562,127.067101
서초구,2287, 능안마을입구,201912,10,2,12,37.45562,127.067101
서초구,2287, 능안마을입구,202001,7,6,13,37.45562,127.067101
서초구,2287, 능안마을입구,202002,7,1,8,37.45562,127.067101
서초구,2287, 능안마을입구,202003,20,16,36,37.45562,127.067101
서초구,2287, 능안마을입구,202004,29,11,40,37.45562,127.067101
서초구,2287, 능안마을입구,202005,17,6,23,37.45562,127.067101
서초구,2287, 능안마을입구,202006,35,9,44,37.45562,127.067101
서초구,2288, 안골마을입구,201901,39,35,74,37.455608,127.064453
서초구,2288, 안골마을입구,201902,20,14,34,37.455608,127.064453
서초구,2288, 안골마을입구,201903,31,21,52,37.455608,127.064453
서초구,2288, 안골마을입구,201904,47,23,70,37.455608,127.064453
서초구,2288, 안골마을입구,201905,63,53,116,37.455608,127.064453
서초구,2288, 안골마을입구,201906,73,42,115,37.455608,127.064453
서초구,2288, 안골마을입구,201907,80,39,119,37.455608,127.064453
서초구,2288, 안골마을입구,201908,52,27,79,37.455608,127.064453
서초구,2288, 안골마을입구,201909,44,35,79,37.455608,127.064453
서초구,2288, 안골마을입구,201910,53,26,79,37.455608,127.064453
서초구,2288, 안골마을입구,201911,56,37,93,37.455608,127.064453
서초구,2288, 안골마을입구,201912,38,30,68,37.455608,127.064453
서초구,2288, 안골마을입구,202001,37,33,70,37.455608,127.064453
서초구,2288, 안골마을입구,202002,46,27,73,37.455608,127.064453
서초구,2288, 안골마을입구,202003,27,12,39,37.455608,127.064453
서초구,2288, 안골마을입구,202004,22,10,32,37.455608,127.064453
서초구,2288, 안골마을입구,202005,32,12,44,37.455608,127.064453
서초구,2288, 안골마을입구,202006,42,15,57,37.455608,127.064453
서초구,2289, 남태령역 2번출구,201901,63,17,80,37.464298,126.988525
서초구,2289, 남태령역 2번출구,201902,52,25,77,37.464298,126.988525
서초구,2289, 남태령역 2번출구,201903,124,36,160,37.464298,126.988525
서초구,2289, 남태령역 2번출구,201904,157,51,208,37.464298,126.988525
서초구,2289, 남태령역 2번출구,201905,207,89,296,37.464298,126.988525
서초구,2289, 남태령역 2번출구,201906,179,57,236,37.464298,126.988525
서초구,2289, 남태령역 2번출구,201907,199,66,265,37.464298,126.988525
서초구,2289, 남태령역 2번출구,201908,222,60,282,37.464298,126.988525
서초구,2289, 남태령역 2번출구,201909,166,35,201,37.464298,126.988525
서초구,2289, 남태령역 2번출구,201910,193,61,254,37.464298,126.988525
서초구,2289, 남태령역 2번출구,201911,171,27,198,37.464298,126.988525
서초구,2289, 남태령역 2번출구,201912,67,20,87,37.464298,126.988525
서초구,2289, 남태령역 2번출구,202001,90,21,111,37.464298,126.988525
서초구,2289, 남태령역 2번출구,202002,68,23,91,37.464298,126.988525
서초구,2289, 남태령역 2번출구,202003,119,71,190,37.464298,126.988525
서초구,2289, 남태령역 2번출구,202004,148,84,232,37.464298,126.988525
서초구,2289, 남태령역 2번출구,202005,115,78,193,37.464298,126.988525
서초구,2289, 남태령역 2번출구,202006,145,60,205,37.464298,126.988525
서초구,2290, 서래마을파리15구공원앞,201901,215,215,430,#N/A,#N/A
서초구,2290, 서래마을파리15구공원앞,201902,215,241,456,#N/A,#N/A
서초구,2290, 서래마을파리15구공원앞,201903,364,407,771,#N/A,#N/A
서초구,2290, 서래마을파리15구공원앞,201904,612,684,1296,#N/A,#N/A
서초구,2290, 서래마을파리15구공원앞,201905,1141,1239,2380,#N/A,#N/A
서초구,2290, 서래마을파리15구공원앞,201906,1239,1295,2534,#N/A,#N/A
서초구,2290, 서래마을파리15구공원앞,201907,1278,1358,2636,#N/A,#N/A
서초구,2290, 서래마을파리15구공원앞,201908,1156,1389,2545,#N/A,#N/A
서초구,2290, 서래마을파리15구공원앞,201909,1162,1344,2506,#N/A,#N/A
서초구,2290, 서래마을파리15구공원앞,201910,1346,1495,2841,#N/A,#N/A
서초구,2290, 서래마을파리15구공원앞,201911,840,986,1826,#N/A,#N/A
서초구,2290, 서래마을파리15구공원앞,201912,456,568,1024,#N/A,#N/A
서초구,2290, 서래마을파리15구공원앞,202001,362,571,933,#N/A,#N/A
서초구,2290, 서래마을파리15구공원앞,202002,389,458,847,#N/A,#N/A
서초구,2290, 서래마을파리15구공원앞,202003,805,844,1649,#N/A,#N/A
서초구,2290, 서래마을파리15구공원앞,202004,1157,1192,2349,#N/A,#N/A
서초구,2290, 서래마을파리15구공원앞,202005,1298,1331,2629,#N/A,#N/A
서초구,2290, 서래마을파리15구공원앞,202006,1301,1342,2643,#N/A,#N/A
서초구,2292, 무지개아파트 앞,201901,113,126,239,37.488243,127.027016
서초구,2292, 무지개아파트 앞,201902,81,97,178,37.488243,127.027016
서초구,2292, 무지개아파트 앞,201903,197,200,397,37.488243,127.027016
서초구,2292, 무지개아파트 앞,201904,332,282,614,37.488243,127.027016
서초구,2292, 무지개아파트 앞,201905,494,397,891,37.488243,127.027016
서초구,2292, 무지개아파트 앞,201906,549,411,960,37.488243,127.027016
서초구,2292, 무지개아파트 앞,201907,559,461,1020,37.488243,127.027016
서초구,2292, 무지개아파트 앞,201908,606,442,1048,37.488243,127.027016
서초구,2292, 무지개아파트 앞,201909,524,405,929,37.488243,127.027016
서초구,2292, 무지개아파트 앞,201910,687,533,1220,37.488243,127.027016
서초구,2292, 무지개아파트 앞,201911,486,435,921,37.488243,127.027016
서초구,2292, 무지개아파트 앞,201912,309,291,600,37.488243,127.027016
서초구,2292, 무지개아파트 앞,202001,267,265,532,37.488243,127.027016
서초구,2292, 무지개아파트 앞,202002,209,200,409,37.488243,127.027016
서초구,2292, 무지개아파트 앞,202003,308,291,599,37.488243,127.027016
서초구,2292, 무지개아파트 앞,202004,322,295,617,37.488243,127.027016
서초구,2292, 무지개아파트 앞,202005,326,299,625,37.488243,127.027016
서초구,2292, 무지개아파트 앞,202006,404,321,725,37.488243,127.027016
서초구,2293, SPC 앞,201901,230,184,414,37.484798,127.036995
서초구,2293, SPC 앞,201902,212,174,386,37.484798,127.036995
서초구,2293, SPC 앞,201903,405,315,720,37.484798,127.036995
서초구,2293, SPC 앞,201904,778,639,1417,37.484798,127.036995
서초구,2293, SPC 앞,201905,998,906,1904,37.484798,127.036995
서초구,2293, SPC 앞,201906,1076,962,2038,37.484798,127.036995
서초구,2293, SPC 앞,201907,1069,930,1999,37.484798,127.036995
서초구,2293, SPC 앞,201908,922,823,1745,37.484798,127.036995
서초구,2293, SPC 앞,201909,802,752,1554,37.484798,127.036995
서초구,2293, SPC 앞,201910,1130,1019,2149,37.484798,127.036995
서초구,2293, SPC 앞,201911,696,636,1332,37.484798,127.036995
서초구,2293, SPC 앞,201912,405,347,752,37.484798,127.036995
서초구,2293, SPC 앞,202001,360,341,701,37.484798,127.036995
서초구,2293, SPC 앞,202002,278,258,536,37.484798,127.036995
서초구,2293, SPC 앞,202003,484,450,934,37.484798,127.036995
서초구,2293, SPC 앞,202004,659,624,1283,37.484798,127.036995
서초구,2293, SPC 앞,202005,782,758,1540,37.484798,127.036995
서초구,2293, SPC 앞,202006,853,815,1668,37.484798,127.036995
서초구,2294, 두상빌딩 앞,201901,206,277,483,37.475906,127.046242
서초구,2294, 두상빌딩 앞,201902,178,272,450,37.475906,127.046242
서초구,2294, 두상빌딩 앞,201903,421,544,965,37.475906,127.046242
서초구,2294, 두상빌딩 앞,201904,653,920,1573,37.475906,127.046242
서초구,2294, 두상빌딩 앞,201905,1200,1330,2530,37.475906,127.046242
서초구,2294, 두상빌딩 앞,201906,1059,1295,2354,37.475906,127.046242
서초구,2294, 두상빌딩 앞,201907,1168,1365,2533,37.475906,127.046242
서초구,2294, 두상빌딩 앞,201908,1274,1453,2727,37.475906,127.046242
서초구,2294, 두상빌딩 앞,201909,1268,1333,2601,37.475906,127.046242
서초구,2294, 두상빌딩 앞,201910,1531,1719,3250,37.475906,127.046242
서초구,2294, 두상빌딩 앞,201911,1090,1270,2360,37.475906,127.046242
서초구,2294, 두상빌딩 앞,201912,564,642,1206,37.475906,127.046242
서초구,2294, 두상빌딩 앞,202001,475,536,1011,37.475906,127.046242
서초구,2294, 두상빌딩 앞,202002,617,691,1308,37.475906,127.046242
서초구,2294, 두상빌딩 앞,202003,991,1005,1996,37.475906,127.046242
서초구,2294, 두상빌딩 앞,202004,1117,1101,2218,37.475906,127.046242
서초구,2294, 두상빌딩 앞,202005,1322,1311,2633,37.475906,127.046242
서초구,2294, 두상빌딩 앞,202006,1431,1427,2858,37.475906,127.046242
서초구,2297, 남부터미널역 1번출구,201901,219,188,407,37.485672,127.015923
서초구,2297, 남부터미널역 1번출구,201902,242,182,424,37.485672,127.015923
서초구,2297, 남부터미널역 1번출구,201903,390,315,705,37.485672,127.015923
서초구,2297, 남부터미널역 1번출구,201904,622,524,1146,37.485672,127.015923
서초구,2297, 남부터미널역 1번출구,201905,905,787,1692,37.485672,127.015923
서초구,2297, 남부터미널역 1번출구,201906,314,272,586,37.485672,127.015923
서초구,2297, 남부터미널역 1번출구,201907,858,776,1634,37.485672,127.015923
서초구,2297, 남부터미널역 1번출구,201908,880,668,1548,37.485672,127.015923
서초구,2297, 남부터미널역 1번출구,201909,906,730,1636,37.485672,127.015923
서초구,2297, 남부터미널역 1번출구,201910,1011,857,1868,37.485672,127.015923
서초구,2297, 남부터미널역 1번출구,201911,698,527,1225,37.485672,127.015923
서초구,2297, 남부터미널역 1번출구,201912,370,345,715,37.485672,127.015923
서초구,2297, 남부터미널역 1번출구,202001,350,321,671,37.485672,127.015923
서초구,2297, 남부터미널역 1번출구,202002,309,277,586,37.485672,127.015923
서초구,2297, 남부터미널역 1번출구,202003,536,441,977,37.485672,127.015923
서초구,2297, 남부터미널역 1번출구,202004,646,579,1225,37.485672,127.015923
서초구,2297, 남부터미널역 1번출구,202005,677,612,1289,37.485672,127.015923
서초구,2297, 남부터미널역 1번출구,202006,794,634,1428,37.485672,127.015923
서초구,2298, 래미안서초스위트앞,201901,150,139,289,37.502411,127.021606
서초구,2298, 래미안서초스위트앞,201902,142,136,278,37.502411,127.021606
서초구,2298, 래미안서초스위트앞,201903,298,270,568,37.502411,127.021606
서초구,2298, 래미안서초스위트앞,201904,419,351,770,37.502411,127.021606
서초구,2298, 래미안서초스위트앞,201905,526,515,1041,37.502411,127.021606
서초구,2298, 래미안서초스위트앞,201906,548,511,1059,37.502411,127.021606
서초구,2298, 래미안서초스위트앞,201907,600,513,1113,37.502411,127.021606
서초구,2298, 래미안서초스위트앞,201908,591,465,1056,37.502411,127.021606
서초구,2298, 래미안서초스위트앞,201909,488,375,863,37.502411,127.021606
서초구,2298, 래미안서초스위트앞,201910,559,455,1014,37.502411,127.021606
서초구,2298, 래미안서초스위트앞,201911,353,227,580,37.502411,127.021606
서초구,2298, 래미안서초스위트앞,201912,124,112,236,37.502411,127.021606
서초구,2298, 래미안서초스위트앞,202001,188,131,319,37.502411,127.021606
서초구,2298, 래미안서초스위트앞,202002,135,108,243,37.502411,127.021606
서초구,2298, 래미안서초스위트앞,202003,247,214,461,37.502411,127.021606
서초구,2298, 래미안서초스위트앞,202004,414,314,728,37.502411,127.021606
서초구,2298, 래미안서초스위트앞,202005,495,407,902,37.502411,127.021606
서초구,2298, 래미안서초스위트앞,202006,462,385,847,37.502411,127.021606
서초구,2299, 한전아트센터 앞,201901,237,223,460,37.486469,127.028061
서초구,2299, 한전아트센터 앞,201902,200,203,403,37.486469,127.028061
서초구,2299, 한전아트센터 앞,201903,412,362,774,37.486469,127.028061
서초구,2299, 한전아트센터 앞,201904,642,548,1190,37.486469,127.028061
서초구,2299, 한전아트센터 앞,201905,970,813,1783,37.486469,127.028061
서초구,2299, 한전아트센터 앞,201906,1058,818,1876,37.486469,127.028061
서초구,2299, 한전아트센터 앞,201907,1055,807,1862,37.486469,127.028061
서초구,2299, 한전아트센터 앞,201908,1034,812,1846,37.486469,127.028061
서초구,2299, 한전아트센터 앞,201909,886,702,1588,37.486469,127.028061
서초구,2299, 한전아트센터 앞,201910,1025,814,1839,37.486469,127.028061
서초구,2299, 한전아트센터 앞,201911,646,576,1222,37.486469,127.028061
서초구,2299, 한전아트센터 앞,201912,437,401,838,37.486469,127.028061
서초구,2299, 한전아트센터 앞,202001,468,469,937,37.486469,127.028061
서초구,2299, 한전아트센터 앞,202002,387,322,709,37.486469,127.028061
서초구,2299, 한전아트센터 앞,202003,538,471,1009,37.486469,127.028061
서초구,2299, 한전아트센터 앞,202004,646,565,1211,37.486469,127.028061
서초구,2299, 한전아트센터 앞,202005,755,699,1454,37.486469,127.028061
서초구,2299, 한전아트센터 앞,202006,909,780,1689,37.486469,127.028061
강남구,2301, 현대고등학교 건너편,201901,309,402,711,37.524071,127.02179
강남구,2301, 현대고등학교 건너편,201902,442,537,979,37.524071,127.02179
강남구,2301, 현대고등학교 건너편,201903,958,1219,2177,37.524071,127.02179
강남구,2301, 현대고등학교 건너편,201904,2260,2680,4940,37.524071,127.02179
강남구,2301, 현대고등학교 건너편,201905,4264,4513,8777,37.524071,127.02179
강남구,2301, 현대고등학교 건너편,201906,3909,4072,7981,37.524071,127.02179
강남구,2301, 현대고등학교 건너편,201907,3004,3121,6125,37.524071,127.02179
강남구,2301, 현대고등학교 건너편,201908,3400,3551,6951,37.524071,127.02179
강남구,2301, 현대고등학교 건너편,201909,3766,4067,7833,37.524071,127.02179
강남구,2301, 현대고등학교 건너편,201910,2005,2200,4205,37.524071,127.02179
강남구,2301, 현대고등학교 건너편,201911,1320,1656,2976,37.524071,127.02179
강남구,2301, 현대고등학교 건너편,201912,501,662,1163,37.524071,127.02179
강남구,2301, 현대고등학교 건너편,202001,577,818,1395,37.524071,127.02179
강남구,2301, 현대고등학교 건너편,202002,740,900,1640,37.524071,127.02179
강남구,2301, 현대고등학교 건너편,202003,3518,4140,7658,37.524071,127.02179
강남구,2301, 현대고등학교 건너편,202004,4754,5158,9912,37.524071,127.02179
강남구,2301, 현대고등학교 건너편,202005,5916,6127,12043,37.524071,127.02179
강남구,2301, 현대고등학교 건너편,202006,4512,4714,9226,37.524071,127.02179
강남구,2302, 교보타워 버스정류장(신논현역 3번출구 후면),201901,441,515,956,37.505581,127.024277
강남구,2302, 교보타워 버스정류장(신논현역 3번출구 후면),201902,439,528,967,37.505581,127.024277
강남구,2302, 교보타워 버스정류장(신논현역 3번출구 후면),201903,1020,1089,2109,37.505581,127.024277
강남구,2302, 교보타워 버스정류장(신논현역 3번출구 후면),201904,1477,1542,3019,37.505581,127.024277
강남구,2302, 교보타워 버스정류장(신논현역 3번출구 후면),201905,2375,2358,4733,37.505581,127.024277
강남구,2302, 교보타워 버스정류장(신논현역 3번출구 후면),201906,2432,2382,4814,37.505581,127.024277
강남구,2302, 교보타워 버스정류장(신논현역 3번출구 후면),201907,2171,2164,4335,37.505581,127.024277
강남구,2302, 교보타워 버스정류장(신논현역 3번출구 후면),201908,2026,1998,4024,37.505581,127.024277
강남구,2302, 교보타워 버스정류장(신논현역 3번출구 후면),201909,1900,1879,3779,37.505581,127.024277
강남구,2302, 교보타워 버스정류장(신논현역 3번출구 후면),201910,2393,2370,4763,37.505581,127.024277
강남구,2302, 교보타워 버스정류장(신논현역 3번출구 후면),201911,1507,1606,3113,37.505581,127.024277
강남구,2302, 교보타워 버스정류장(신논현역 3번출구 후면),201912,737,736,1473,37.505581,127.024277
강남구,2302, 교보타워 버스정류장(신논현역 3번출구 후면),202001,690,679,1369,37.505581,127.024277
강남구,2302, 교보타워 버스정류장(신논현역 3번출구 후면),202002,620,629,1249,37.505581,127.024277
강남구,2302, 교보타워 버스정류장(신논현역 3번출구 후면),202003,1210,1177,2387,37.505581,127.024277
강남구,2302, 교보타워 버스정류장(신논현역 3번출구 후면),202004,1723,1682,3405,37.505581,127.024277
강남구,2302, 교보타워 버스정류장(신논현역 3번출구 후면),202005,1704,1671,3375,37.505581,127.024277
강남구,2302, 교보타워 버스정류장(신논현역 3번출구 후면),202006,1650,1628,3278,37.505581,127.024277
강남구,2303, 논현역 7번출구,201901,315,313,628,37.511517,127.021477
강남구,2303, 논현역 7번출구,201902,329,273,602,37.511517,127.021477
강남구,2303, 논현역 7번출구,201903,760,700,1460,37.511517,127.021477
강남구,2303, 논현역 7번출구,201904,1130,971,2101,37.511517,127.021477
강남구,2303, 논현역 7번출구,201905,1541,1356,2897,37.511517,127.021477
강남구,2303, 논현역 7번출구,201906,1567,1402,2969,37.511517,127.021477
강남구,2303, 논현역 7번출구,201907,1505,1389,2894,37.511517,127.021477
강남구,2303, 논현역 7번출구,201908,1469,1339,2808,37.511517,127.021477
강남구,2303, 논현역 7번출구,201909,1296,1192,2488,37.511517,127.021477
강남구,2303, 논현역 7번출구,201910,1492,1434,2926,37.511517,127.021477
강남구,2303, 논현역 7번출구,201911,998,915,1913,37.511517,127.021477
강남구,2303, 논현역 7번출구,201912,460,438,898,37.511517,127.021477
강남구,2303, 논현역 7번출구,202001,297,313,610,37.511517,127.021477
강남구,2303, 논현역 7번출구,202002,95,100,195,37.511517,127.021477
강남구,2303, 논현역 7번출구,202003,621,558,1179,37.511517,127.021477
강남구,2303, 논현역 7번출구,202004,930,876,1806,37.511517,127.021477
강남구,2303, 논현역 7번출구,202005,994,969,1963,37.511517,127.021477
강남구,2303, 논현역 7번출구,202006,1134,1072,2206,37.511517,127.021477
강남구,2304, 신영 ROYAL PALACE 앞,201901,201,70,271,37.512527,127.035835
강남구,2304, 신영 ROYAL PALACE 앞,201902,87,41,128,37.512527,127.035835
강남구,2304, 신영 ROYAL PALACE 앞,201903,204,83,287,37.512527,127.035835
강남구,2304, 신영 ROYAL PALACE 앞,201904,357,155,512,37.512527,127.035835
강남구,2304, 신영 ROYAL PALACE 앞,201905,630,241,871,37.512527,127.035835
강남구,2304, 신영 ROYAL PALACE 앞,201906,559,207,766,37.512527,127.035835
강남구,2304, 신영 ROYAL PALACE 앞,201907,504,187,691,37.512527,127.035835
강남구,2304, 신영 ROYAL PALACE 앞,201908,410,139,549,37.512527,127.035835
강남구,2304, 신영 ROYAL PALACE 앞,201909,360,114,474,37.512527,127.035835
강남구,2304, 신영 ROYAL PALACE 앞,201910,496,154,650,37.512527,127.035835
강남구,2304, 신영 ROYAL PALACE 앞,201911,310,120,430,37.512527,127.035835
강남구,2304, 신영 ROYAL PALACE 앞,201912,150,62,212,37.512527,127.035835
강남구,2304, 신영 ROYAL PALACE 앞,202001,136,62,198,37.512527,127.035835
강남구,2304, 신영 ROYAL PALACE 앞,202002,105,48,153,37.512527,127.035835
강남구,2304, 신영 ROYAL PALACE 앞,202003,188,88,276,37.512527,127.035835
강남구,2304, 신영 ROYAL PALACE 앞,202004,368,118,486,37.512527,127.035835
강남구,2304, 신영 ROYAL PALACE 앞,202005,292,119,411,37.512527,127.035835
강남구,2304, 신영 ROYAL PALACE 앞,202006,399,130,529,37.512527,127.035835
강남구,2305, MCM 본사 직영점 앞,201901,146,228,374,37.520641,127.034508
강남구,2305, MCM 본사 직영점 앞,201902,141,182,323,37.520641,127.034508
강남구,2305, MCM 본사 직영점 앞,201903,266,391,657,37.520641,127.034508
강남구,2305, MCM 본사 직영점 앞,201904,436,612,1048,37.520641,127.034508
강남구,2305, MCM 본사 직영점 앞,201905,529,632,1161,37.520641,127.034508
강남구,2305, MCM 본사 직영점 앞,201906,730,905,1635,37.520641,127.034508
강남구,2305, MCM 본사 직영점 앞,201907,555,674,1229,37.520641,127.034508
강남구,2305, MCM 본사 직영점 앞,201908,474,578,1052,37.520641,127.034508
강남구,2305, MCM 본사 직영점 앞,201909,437,553,990,37.520641,127.034508
강남구,2305, MCM 본사 직영점 앞,201910,531,699,1230,37.520641,127.034508
강남구,2305, MCM 본사 직영점 앞,201911,361,507,868,37.520641,127.034508
강남구,2305, MCM 본사 직영점 앞,201912,257,342,599,37.520641,127.034508
강남구,2305, MCM 본사 직영점 앞,202001,212,304,516,37.520641,127.034508
강남구,2305, MCM 본사 직영점 앞,202002,196,213,409,37.520641,127.034508
강남구,2305, MCM 본사 직영점 앞,202003,364,411,775,37.520641,127.034508
강남구,2305, MCM 본사 직영점 앞,202004,528,482,1010,37.520641,127.034508
강남구,2305, MCM 본사 직영점 앞,202005,466,442,908,37.520641,127.034508
강남구,2305, MCM 본사 직영점 앞,202006,490,475,965,37.520641,127.034508
강남구,2306, 압구정역 2번 출구 옆,201901,479,426,905,37.527122,127.028717
강남구,2306, 압구정역 2번 출구 옆,201902,417,386,803,37.527122,127.028717
강남구,2306, 압구정역 2번 출구 옆,201903,841,702,1543,37.527122,127.028717
강남구,2306, 압구정역 2번 출구 옆,201904,1317,1087,2404,37.527122,127.028717
강남구,2306, 압구정역 2번 출구 옆,201905,1877,1552,3429,37.527122,127.028717
강남구,2306, 압구정역 2번 출구 옆,201906,1926,1529,3455,37.527122,127.028717
강남구,2306, 압구정역 2번 출구 옆,201907,2018,1480,3498,37.527122,127.028717
강남구,2306, 압구정역 2번 출구 옆,201908,1778,1278,3056,37.527122,127.028717
강남구,2306, 압구정역 2번 출구 옆,201909,1686,1282,2968,37.527122,127.028717
강남구,2306, 압구정역 2번 출구 옆,201910,2111,1600,3711,37.527122,127.028717
강남구,2306, 압구정역 2번 출구 옆,201911,1363,1072,2435,37.527122,127.028717
강남구,2306, 압구정역 2번 출구 옆,201912,779,595,1374,37.527122,127.028717
강남구,2306, 압구정역 2번 출구 옆,202001,794,625,1419,37.527122,127.028717
강남구,2306, 압구정역 2번 출구 옆,202002,739,576,1315,37.527122,127.028717
강남구,2306, 압구정역 2번 출구 옆,202003,1267,966,2233,37.527122,127.028717
강남구,2306, 압구정역 2번 출구 옆,202004,1229,1113,2342,37.527122,127.028717
강남구,2306, 압구정역 2번 출구 옆,202005,1180,1157,2337,37.527122,127.028717
강남구,2306, 압구정역 2번 출구 옆,202006,1310,1305,2615,37.527122,127.028717
강남구,2307, 압구정 한양 3차 아파트,201901,243,319,562,37.528614,127.038559
강남구,2307, 압구정 한양 3차 아파트,201902,281,346,627,37.528614,127.038559
강남구,2307, 압구정 한양 3차 아파트,201903,660,787,1447,37.528614,127.038559
강남구,2307, 압구정 한양 3차 아파트,201904,1360,1504,2864,37.528614,127.038559
강남구,2307, 압구정 한양 3차 아파트,201905,2231,2216,4447,37.528614,127.038559
강남구,2307, 압구정 한양 3차 아파트,201906,2326,2333,4659,37.528614,127.038559
강남구,2307, 압구정 한양 3차 아파트,201907,1789,1825,3614,37.528614,127.038559
강남구,2307, 압구정 한양 3차 아파트,201908,1867,1890,3757,37.528614,127.038559
강남구,2307, 압구정 한양 3차 아파트,201909,1837,1839,3676,37.528614,127.038559
강남구,2307, 압구정 한양 3차 아파트,201910,2161,2276,4437,37.528614,127.038559
강남구,2307, 압구정 한양 3차 아파트,201911,1032,1155,2187,37.528614,127.038559
강남구,2307, 압구정 한양 3차 아파트,201912,503,556,1059,37.528614,127.038559
강남구,2307, 압구정 한양 3차 아파트,202001,478,575,1053,37.528614,127.038559
강남구,2307, 압구정 한양 3차 아파트,202002,481,554,1035,37.528614,127.038559
강남구,2307, 압구정 한양 3차 아파트,202003,1597,1683,3280,37.528614,127.038559
강남구,2307, 압구정 한양 3차 아파트,202004,2277,2319,4596,37.528614,127.038559
강남구,2307, 압구정 한양 3차 아파트,202005,2586,2540,5126,37.528614,127.038559
강남구,2307, 압구정 한양 3차 아파트,202006,1935,1920,3855,37.528614,127.038559
강남구,2308, 압구정파출소 앞,201901,253,345,598,37.529301,127.035599
강남구,2308, 압구정파출소 앞,201902,257,271,528,37.529301,127.035599
강남구,2308, 압구정파출소 앞,201903,450,513,963,37.529301,127.035599
강남구,2308, 압구정파출소 앞,201904,745,784,1529,37.529301,127.035599
강남구,2308, 압구정파출소 앞,201905,1109,1106,2215,37.529301,127.035599
강남구,2308, 압구정파출소 앞,201906,1154,1142,2296,37.529301,127.035599
강남구,2308, 압구정파출소 앞,201907,1017,1011,2028,37.529301,127.035599
강남구,2308, 압구정파출소 앞,201908,965,972,1937,37.529301,127.035599
강남구,2308, 압구정파출소 앞,201909,947,907,1854,37.529301,127.035599
강남구,2308, 압구정파출소 앞,201910,1124,1152,2276,37.529301,127.035599
강남구,2308, 압구정파출소 앞,201911,618,714,1332,37.529301,127.035599
강남구,2308, 압구정파출소 앞,201912,341,396,737,37.529301,127.035599
강남구,2308, 압구정파출소 앞,202001,310,394,704,37.529301,127.035599
강남구,2308, 압구정파출소 앞,202002,334,353,687,37.529301,127.035599
강남구,2308, 압구정파출소 앞,202003,856,869,1725,37.529301,127.035599
강남구,2308, 압구정파출소 앞,202004,1043,1035,2078,37.529301,127.035599
강남구,2308, 압구정파출소 앞,202005,1053,1055,2108,37.529301,127.035599
강남구,2308, 압구정파출소 앞,202006,1054,1044,2098,37.529301,127.035599
강남구,2309, 청담역(우리들병원 앞),201901,154,117,271,37.518902,127.049385
강남구,2309, 청담역(우리들병원 앞),201902,148,96,244,37.518902,127.049385
강남구,2309, 청담역(우리들병원 앞),201903,234,182,416,37.518902,127.049385
강남구,2309, 청담역(우리들병원 앞),201904,388,295,683,37.518902,127.049385
강남구,2309, 청담역(우리들병원 앞),201905,609,322,931,37.518902,127.049385
강남구,2309, 청담역(우리들병원 앞),201906,584,298,882,37.518902,127.049385
강남구,2309, 청담역(우리들병원 앞),201907,603,282,885,37.518902,127.049385
강남구,2309, 청담역(우리들병원 앞),201908,663,302,965,37.518902,127.049385
강남구,2309, 청담역(우리들병원 앞),201909,473,272,745,37.518902,127.049385
강남구,2309, 청담역(우리들병원 앞),201910,461,301,762,37.518902,127.049385
강남구,2309, 청담역(우리들병원 앞),201911,247,213,460,37.518902,127.049385
강남구,2309, 청담역(우리들병원 앞),201912,128,109,237,37.518902,127.049385
강남구,2309, 청담역(우리들병원 앞),202001,136,80,216,37.518902,127.049385
강남구,2309, 청담역(우리들병원 앞),202002,115,50,165,37.518902,127.049385
강남구,2309, 청담역(우리들병원 앞),202003,231,141,372,37.518902,127.049385
강남구,2309, 청담역(우리들병원 앞),202004,520,258,778,37.518902,127.049385
강남구,2309, 청담역(우리들병원 앞),202005,519,275,794,37.518902,127.049385
강남구,2309, 청담역(우리들병원 앞),202006,663,329,992,37.518902,127.049385
강남구,2310, 청담동 맥도날드 옆(위치),201901,157,269,426,37.523613,127.040176
강남구,2310, 청담동 맥도날드 옆(위치),201902,194,261,455,37.523613,127.040176
강남구,2310, 청담동 맥도날드 옆(위치),201903,386,470,856,37.523613,127.040176
강남구,2310, 청담동 맥도날드 옆(위치),201904,555,648,1203,37.523613,127.040176
강남구,2310, 청담동 맥도날드 옆(위치),201905,901,894,1795,37.523613,127.040176
강남구,2310, 청담동 맥도날드 옆(위치),201906,917,891,1808,37.523613,127.040176
강남구,2310, 청담동 맥도날드 옆(위치),201907,750,760,1510,37.523613,127.040176
강남구,2310, 청담동 맥도날드 옆(위치),201908,791,802,1593,37.523613,127.040176
강남구,2310, 청담동 맥도날드 옆(위치),201909,826,789,1615,37.523613,127.040176
강남구,2310, 청담동 맥도날드 옆(위치),201910,1080,1115,2195,37.523613,127.040176
강남구,2310, 청담동 맥도날드 옆(위치),201911,603,645,1248,37.523613,127.040176
강남구,2310, 청담동 맥도날드 옆(위치),201912,358,359,717,37.523613,127.040176
강남구,2310, 청담동 맥도날드 옆(위치),202001,254,256,510,37.523613,127.040176
강남구,2310, 청담동 맥도날드 옆(위치),202002,269,257,526,37.523613,127.040176
강남구,2310, 청담동 맥도날드 옆(위치),202003,558,547,1105,37.523613,127.040176
강남구,2310, 청담동 맥도날드 옆(위치),202004,757,741,1498,37.523613,127.040176
강남구,2310, 청담동 맥도날드 옆(위치),202005,824,814,1638,37.523613,127.040176
강남구,2310, 청담동 맥도날드 옆(위치),202006,728,700,1428,37.523613,127.040176
강남구,2311, 학동로 래미안 아파트 앞,201901,128,54,182,37.517773,127.043022
강남구,2311, 학동로 래미안 아파트 앞,201902,155,43,198,37.517773,127.043022
강남구,2311, 학동로 래미안 아파트 앞,201903,228,80,308,37.517773,127.043022
강남구,2311, 학동로 래미안 아파트 앞,201904,434,145,579,37.517773,127.043022
강남구,2311, 학동로 래미안 아파트 앞,201905,572,166,738,37.517773,127.043022
강남구,2311, 학동로 래미안 아파트 앞,201906,592,184,776,37.517773,127.043022
강남구,2311, 학동로 래미안 아파트 앞,201907,455,129,584,37.517773,127.043022
강남구,2311, 학동로 래미안 아파트 앞,201908,502,163,665,37.517773,127.043022
강남구,2311, 학동로 래미안 아파트 앞,201909,394,164,558,37.517773,127.043022
강남구,2311, 학동로 래미안 아파트 앞,201910,406,215,621,37.517773,127.043022
강남구,2311, 학동로 래미안 아파트 앞,201911,346,130,476,37.517773,127.043022
강남구,2311, 학동로 래미안 아파트 앞,201912,83,43,126,37.517773,127.043022
강남구,2311, 학동로 래미안 아파트 앞,202001,124,44,168,37.517773,127.043022
강남구,2311, 학동로 래미안 아파트 앞,202002,49,37,86,37.517773,127.043022
강남구,2311, 학동로 래미안 아파트 앞,202003,230,64,294,37.517773,127.043022
강남구,2311, 학동로 래미안 아파트 앞,202004,476,132,608,37.517773,127.043022
강남구,2311, 학동로 래미안 아파트 앞,202005,329,117,446,37.517773,127.043022
강남구,2311, 학동로 래미안 아파트 앞,202006,522,152,674,37.517773,127.043022
강남구,2312, 청담역 13번 출구 앞,201901,128,106,234,37.52058,127.056328
강남구,2312, 청담역 13번 출구 앞,201902,108,97,205,37.52058,127.056328
강남구,2312, 청담역 13번 출구 앞,201903,232,205,437,37.52058,127.056328
강남구,2312, 청담역 13번 출구 앞,201904,476,403,879,37.52058,127.056328
강남구,2312, 청담역 13번 출구 앞,201905,693,660,1353,37.52058,127.056328
강남구,2312, 청담역 13번 출구 앞,201906,641,565,1206,37.52058,127.056328
강남구,2312, 청담역 13번 출구 앞,201907,522,473,995,37.52058,127.056328
강남구,2312, 청담역 13번 출구 앞,201908,537,506,1043,37.52058,127.056328
강남구,2312, 청담역 13번 출구 앞,201909,522,499,1021,37.52058,127.056328
강남구,2312, 청담역 13번 출구 앞,201910,574,553,1127,37.52058,127.056328
강남구,2312, 청담역 13번 출구 앞,201911,353,322,675,37.52058,127.056328
강남구,2312, 청담역 13번 출구 앞,201912,161,152,313,37.52058,127.056328
강남구,2312, 청담역 13번 출구 앞,202001,166,155,321,37.52058,127.056328
강남구,2312, 청담역 13번 출구 앞,202002,149,135,284,37.52058,127.056328
강남구,2312, 청담역 13번 출구 앞,202003,451,380,831,37.52058,127.056328
강남구,2312, 청담역 13번 출구 앞,202004,525,510,1035,37.52058,127.056328
강남구,2312, 청담역 13번 출구 앞,202005,540,524,1064,37.52058,127.056328
강남구,2312, 청담역 13번 출구 앞,202006,673,588,1261,37.52058,127.056328
강남구,2313, 금원빌딩 앞,201901,240,237,477,37.525116,127.052467
강남구,2313, 금원빌딩 앞,201902,251,243,494,37.525116,127.052467
강남구,2313, 금원빌딩 앞,201903,484,529,1013,37.525116,127.052467
강남구,2313, 금원빌딩 앞,201904,865,894,1759,37.525116,127.052467
강남구,2313, 금원빌딩 앞,201905,1433,1428,2861,37.525116,127.052467
강남구,2313, 금원빌딩 앞,201906,1415,1458,2873,37.525116,127.052467
강남구,2313, 금원빌딩 앞,201907,1260,1272,2532,37.525116,127.052467
강남구,2313, 금원빌딩 앞,201908,1312,1329,2641,37.525116,127.052467
강남구,2313, 금원빌딩 앞,201909,1206,1368,2574,37.525116,127.052467
강남구,2313, 금원빌딩 앞,201910,1540,1673,3213,37.525116,127.052467
강남구,2313, 금원빌딩 앞,201911,941,996,1937,37.525116,127.052467
강남구,2313, 금원빌딩 앞,201912,541,568,1109,37.525116,127.052467
강남구,2313, 금원빌딩 앞,202001,471,533,1004,37.525116,127.052467
강남구,2313, 금원빌딩 앞,202002,421,504,925,37.525116,127.052467
강남구,2313, 금원빌딩 앞,202003,1198,1262,2460,37.525116,127.052467
강남구,2313, 금원빌딩 앞,202004,1636,1700,3336,37.525116,127.052467
강남구,2313, 금원빌딩 앞,202005,1755,1770,3525,37.525116,127.052467
강남구,2313, 금원빌딩 앞,202006,1542,1565,3107,37.525116,127.052467
강남구,2314, 청담나들목입구,201901,171,179,350,37.521275,127.061035
강남구,2314, 청담나들목입구,201902,153,161,314,37.521275,127.061035
강남구,2314, 청담나들목입구,201903,317,313,630,37.521275,127.061035
강남구,2314, 청담나들목입구,201904,719,713,1432,37.521275,127.061035
강남구,2314, 청담나들목입구,201905,1172,1206,2378,37.521275,127.061035
강남구,2314, 청담나들목입구,201906,1017,1029,2046,37.521275,127.061035
강남구,2314, 청담나들목입구,201907,839,860,1699,37.521275,127.061035
강남구,2314, 청담나들목입구,201908,947,981,1928,37.521275,127.061035
강남구,2314, 청담나들목입구,201909,893,910,1803,37.521275,127.061035
강남구,2314, 청담나들목입구,201910,995,1031,2026,37.521275,127.061035
강남구,2314, 청담나들목입구,201911,407,409,816,37.521275,127.061035
강남구,2314, 청담나들목입구,201912,204,207,411,37.521275,127.061035
강남구,2314, 청담나들목입구,202001,200,199,399,37.521275,127.061035
강남구,2314, 청담나들목입구,202002,286,289,575,37.521275,127.061035
강남구,2314, 청담나들목입구,202003,1198,1222,2420,37.521275,127.061035
강남구,2314, 청담나들목입구,202004,1319,1353,2672,37.521275,127.061035
강남구,2314, 청담나들목입구,202005,1381,1402,2783,37.521275,127.061035
강남구,2314, 청담나들목입구,202006,1153,1151,2304,37.521275,127.061035
강남구,2315, 봉은사역 5번출구 옆,201901,394,416,810,37.514248,127.061119
강남구,2315, 봉은사역 5번출구 옆,201902,407,423,830,37.514248,127.061119
강남구,2315, 봉은사역 5번출구 옆,201903,800,777,1577,37.514248,127.061119
강남구,2315, 봉은사역 5번출구 옆,201904,1479,1362,2841,37.514248,127.061119
강남구,2315, 봉은사역 5번출구 옆,201905,2071,2046,4117,37.514248,127.061119
강남구,2315, 봉은사역 5번출구 옆,201906,2148,1919,4067,37.514248,127.061119
강남구,2315, 봉은사역 5번출구 옆,201907,1742,1697,3439,37.514248,127.061119
강남구,2315, 봉은사역 5번출구 옆,201908,1536,1479,3015,37.514248,127.061119
강남구,2315, 봉은사역 5번출구 옆,201909,1750,1726,3476,37.514248,127.061119
강남구,2315, 봉은사역 5번출구 옆,201910,2131,2133,4264,37.514248,127.061119
강남구,2315, 봉은사역 5번출구 옆,201911,1385,1362,2747,37.514248,127.061119
강남구,2315, 봉은사역 5번출구 옆,201912,725,685,1410,37.514248,127.061119
강남구,2315, 봉은사역 5번출구 옆,202001,699,668,1367,37.514248,127.061119
강남구,2315, 봉은사역 5번출구 옆,202002,594,578,1172,37.514248,127.061119
강남구,2315, 봉은사역 5번출구 옆,202003,1185,1114,2299,37.514248,127.061119
강남구,2315, 봉은사역 5번출구 옆,202004,1429,1362,2791,37.514248,127.061119
강남구,2315, 봉은사역 5번출구 옆,202005,1575,1556,3131,37.514248,127.061119
강남구,2315, 봉은사역 5번출구 옆,202006,1427,1391,2818,37.514248,127.061119
강남구,2316, 삼성역 8번출구,201901,181,183,364,37.509575,127.063408
강남구,2316, 삼성역 8번출구,201902,278,352,630,37.509575,127.063408
강남구,2316, 삼성역 8번출구,201903,738,767,1505,37.509575,127.063408
강남구,2316, 삼성역 8번출구,201904,1390,1436,2826,37.509575,127.063408
강남구,2316, 삼성역 8번출구,201905,1984,1954,3938,37.509575,127.063408
강남구,2316, 삼성역 8번출구,201906,1848,1779,3627,37.509575,127.063408
강남구,2316, 삼성역 8번출구,201907,1524,1502,3026,37.509575,127.063408
강남구,2316, 삼성역 8번출구,201908,1253,1233,2486,37.509575,127.063408
강남구,2316, 삼성역 8번출구,201909,1417,1381,2798,37.509575,127.063408
강남구,2316, 삼성역 8번출구,201910,2108,2061,4169,37.509575,127.063408
강남구,2316, 삼성역 8번출구,201911,1216,1233,2449,37.509575,127.063408
강남구,2316, 삼성역 8번출구,201912,592,593,1185,37.509575,127.063408
강남구,2316, 삼성역 8번출구,202001,521,520,1041,37.509575,127.063408
강남구,2316, 삼성역 8번출구,202002,452,449,901,37.509575,127.063408
강남구,2316, 삼성역 8번출구,202003,1035,1030,2065,37.509575,127.063408
강남구,2316, 삼성역 8번출구,202004,1529,1523,3052,37.509575,127.063408
강남구,2316, 삼성역 8번출구,202005,1709,1710,3419,37.509575,127.063408
강남구,2316, 삼성역 8번출구,202006,1769,1766,3535,37.509575,127.063408
강남구,2317, 삼성도로공원,201901,142,162,304,37.515888,127.0662
강남구,2317, 삼성도로공원,201902,130,129,259,37.515888,127.0662
강남구,2317, 삼성도로공원,201903,349,360,709,37.515888,127.0662
강남구,2317, 삼성도로공원,201904,751,798,1549,37.515888,127.0662
강남구,2317, 삼성도로공원,201905,1182,1202,2384,37.515888,127.0662
강남구,2317, 삼성도로공원,201906,1209,1231,2440,37.515888,127.0662
강남구,2317, 삼성도로공원,201907,1064,1050,2114,37.515888,127.0662
강남구,2317, 삼성도로공원,201908,1090,1117,2207,37.515888,127.0662
강남구,2317, 삼성도로공원,201909,1155,1173,2328,37.515888,127.0662
강남구,2317, 삼성도로공원,201910,1223,1295,2518,37.515888,127.0662
강남구,2317, 삼성도로공원,201911,672,693,1365,37.515888,127.0662
강남구,2317, 삼성도로공원,201912,293,296,589,37.515888,127.0662
강남구,2317, 삼성도로공원,202001,252,247,499,37.515888,127.0662
강남구,2317, 삼성도로공원,202002,283,289,572,37.515888,127.0662
강남구,2317, 삼성도로공원,202003,1178,1195,2373,37.515888,127.0662
강남구,2317, 삼성도로공원,202004,1431,1478,2909,37.515888,127.0662
강남구,2317, 삼성도로공원,202005,1698,1692,3390,37.515888,127.0662
강남구,2317, 삼성도로공원,202006,1329,1364,2693,37.515888,127.0662
강남구,2318, 삼성중앙역4번출구(문화센터더 리빌),201901,172,210,382,37.513577,127.055031
강남구,2318, 삼성중앙역4번출구(문화센터더 리빌),201902,138,174,312,37.513577,127.055031
강남구,2318, 삼성중앙역4번출구(문화센터더 리빌),201903,403,364,767,37.513577,127.055031
강남구,2318, 삼성중앙역4번출구(문화센터더 리빌),201904,699,620,1319,37.513577,127.055031
강남구,2318, 삼성중앙역4번출구(문화센터더 리빌),201905,1258,924,2182,37.513577,127.055031
강남구,2318, 삼성중앙역4번출구(문화센터더 리빌),201906,1220,982,2202,37.513577,127.055031
강남구,2318, 삼성중앙역4번출구(문화센터더 리빌),201907,876,633,1509,37.513577,127.055031
강남구,2318, 삼성중앙역4번출구(문화센터더 리빌),201908,1022,703,1725,37.513577,127.055031
강남구,2318, 삼성중앙역4번출구(문화센터더 리빌),201909,838,673,1511,37.513577,127.055031
강남구,2318, 삼성중앙역4번출구(문화센터더 리빌),201910,983,782,1765,37.513577,127.055031
강남구,2318, 삼성중앙역4번출구(문화센터더 리빌),201911,539,498,1037,37.513577,127.055031
강남구,2318, 삼성중앙역4번출구(문화센터더 리빌),201912,265,239,504,37.513577,127.055031
강남구,2318, 삼성중앙역4번출구(문화센터더 리빌),202001,233,214,447,37.513577,127.055031
강남구,2318, 삼성중앙역4번출구(문화센터더 리빌),202002,182,137,319,37.513577,127.055031
강남구,2318, 삼성중앙역4번출구(문화센터더 리빌),202003,471,407,878,37.513577,127.055031
강남구,2318, 삼성중앙역4번출구(문화센터더 리빌),202004,756,633,1389,37.513577,127.055031
강남구,2318, 삼성중앙역4번출구(문화센터더 리빌),202005,730,647,1377,37.513577,127.055031
강남구,2318, 삼성중앙역4번출구(문화센터더 리빌),202006,654,567,1221,37.513577,127.055031
강남구,2319, 포스코4거리 서측(수협 삼성동 지점),201901,201,259,460,37.506607,127.05468
강남구,2319, 포스코4거리 서측(수협 삼성동 지점),201902,193,194,387,37.506607,127.05468
강남구,2319, 포스코4거리 서측(수협 삼성동 지점),201903,430,483,913,37.506607,127.05468
강남구,2319, 포스코4거리 서측(수협 삼성동 지점),201904,603,618,1221,37.506607,127.05468
강남구,2319, 포스코4거리 서측(수협 삼성동 지점),201905,781,780,1561,37.506607,127.05468
강남구,2319, 포스코4거리 서측(수협 삼성동 지점),201906,763,749,1512,37.506607,127.05468
강남구,2319, 포스코4거리 서측(수협 삼성동 지점),201907,737,730,1467,37.506607,127.05468
강남구,2319, 포스코4거리 서측(수협 삼성동 지점),201908,714,707,1421,37.506607,127.05468
강남구,2319, 포스코4거리 서측(수협 삼성동 지점),201909,643,622,1265,37.506607,127.05468
강남구,2319, 포스코4거리 서측(수협 삼성동 지점),201910,803,799,1602,37.506607,127.05468
강남구,2319, 포스코4거리 서측(수협 삼성동 지점),201911,537,582,1119,37.506607,127.05468
강남구,2319, 포스코4거리 서측(수협 삼성동 지점),201912,295,314,609,37.506607,127.05468
강남구,2319, 포스코4거리 서측(수협 삼성동 지점),202001,273,307,580,37.506607,127.05468
강남구,2319, 포스코4거리 서측(수협 삼성동 지점),202002,289,293,582,37.506607,127.05468
강남구,2319, 포스코4거리 서측(수협 삼성동 지점),202003,409,409,818,37.506607,127.05468
강남구,2319, 포스코4거리 서측(수협 삼성동 지점),202004,548,544,1092,37.506607,127.05468
강남구,2319, 포스코4거리 서측(수협 삼성동 지점),202005,565,559,1124,37.506607,127.05468
강남구,2319, 포스코4거리 서측(수협 삼성동 지점),202006,649,651,1300,37.506607,127.05468
강남구,2320, 도곡역 대치지구대 방향,201901,247,259,506,37.491928,127.056969
강남구,2320, 도곡역 대치지구대 방향,201902,243,265,508,37.491928,127.056969
강남구,2320, 도곡역 대치지구대 방향,201903,420,461,881,37.491928,127.056969
강남구,2320, 도곡역 대치지구대 방향,201904,857,888,1745,37.491928,127.056969
강남구,2320, 도곡역 대치지구대 방향,201905,1243,1230,2473,37.491928,127.056969
강남구,2320, 도곡역 대치지구대 방향,201906,1345,1335,2680,37.491928,127.056969
강남구,2320, 도곡역 대치지구대 방향,201907,1196,1206,2402,37.491928,127.056969
강남구,2320, 도곡역 대치지구대 방향,201908,1135,1169,2304,37.491928,127.056969
강남구,2320, 도곡역 대치지구대 방향,201909,1177,1189,2366,37.491928,127.056969
강남구,2320, 도곡역 대치지구대 방향,201910,1389,1423,2812,37.491928,127.056969
강남구,2320, 도곡역 대치지구대 방향,201911,857,886,1743,37.491928,127.056969
강남구,2320, 도곡역 대치지구대 방향,201912,426,508,934,37.491928,127.056969
강남구,2320, 도곡역 대치지구대 방향,202001,433,478,911,37.491928,127.056969
강남구,2320, 도곡역 대치지구대 방향,202002,387,425,812,37.491928,127.056969
강남구,2320, 도곡역 대치지구대 방향,202003,1017,1052,2069,37.491928,127.056969
강남구,2320, 도곡역 대치지구대 방향,202004,1196,1176,2372,37.491928,127.056969
강남구,2320, 도곡역 대치지구대 방향,202005,1307,1295,2602,37.491928,127.056969
강남구,2320, 도곡역 대치지구대 방향,202006,941,924,1865,37.491928,127.056969
강남구,2321, 학여울역 사거리,201901,248,235,483,37.496117,127.069443
강남구,2321, 학여울역 사거리,201902,243,227,470,37.496117,127.069443
강남구,2321, 학여울역 사거리,201903,485,461,946,37.496117,127.069443
강남구,2321, 학여울역 사거리,201904,753,730,1483,37.496117,127.069443
강남구,2321, 학여울역 사거리,201905,1071,1069,2140,37.496117,127.069443
강남구,2321, 학여울역 사거리,201906,1174,1172,2346,37.496117,127.069443
강남구,2321, 학여울역 사거리,201907,1124,1102,2226,37.496117,127.069443
강남구,2321, 학여울역 사거리,201908,1039,982,2021,37.496117,127.069443
강남구,2321, 학여울역 사거리,201909,1137,935,2072,37.496117,127.069443
강남구,2321, 학여울역 사거리,201910,1166,1083,2249,37.496117,127.069443
강남구,2321, 학여울역 사거리,201911,793,685,1478,37.496117,127.069443
강남구,2321, 학여울역 사거리,201912,460,410,870,37.496117,127.069443
강남구,2321, 학여울역 사거리,202001,424,353,777,37.496117,127.069443
강남구,2321, 학여울역 사거리,202002,386,379,765,37.496117,127.069443
강남구,2321, 학여울역 사거리,202003,976,938,1914,37.496117,127.069443
강남구,2321, 학여울역 사거리,202004,1294,1209,2503,37.496117,127.069443
강남구,2321, 학여울역 사거리,202005,1261,1211,2472,37.496117,127.069443
강남구,2321, 학여울역 사거리,202006,1112,1026,2138,37.496117,127.069443
강남구,2322, 삼성역 3번 출구,201901,341,332,673,37.508091,127.063103
강남구,2322, 삼성역 3번 출구,201902,248,218,466,37.508091,127.063103
강남구,2322, 삼성역 3번 출구,201903,506,471,977,37.508091,127.063103
강남구,2322, 삼성역 3번 출구,201904,830,779,1609,37.508091,127.063103
강남구,2322, 삼성역 3번 출구,201905,1240,1216,2456,37.508091,127.063103
강남구,2322, 삼성역 3번 출구,201906,1118,1108,2226,37.508091,127.063103
강남구,2322, 삼성역 3번 출구,201907,1020,1006,2026,37.508091,127.063103
강남구,2322, 삼성역 3번 출구,201908,819,794,1613,37.508091,127.063103
강남구,2322, 삼성역 3번 출구,201909,886,859,1745,37.508091,127.063103
강남구,2322, 삼성역 3번 출구,201910,1166,1140,2306,37.508091,127.063103
강남구,2322, 삼성역 3번 출구,201911,695,682,1377,37.508091,127.063103
강남구,2322, 삼성역 3번 출구,201912,387,384,771,37.508091,127.063103
강남구,2322, 삼성역 3번 출구,202001,309,298,607,37.508091,127.063103
강남구,2322, 삼성역 3번 출구,202002,331,322,653,37.508091,127.063103
강남구,2322, 삼성역 3번 출구,202003,578,566,1144,37.508091,127.063103
강남구,2322, 삼성역 3번 출구,202004,814,800,1614,37.508091,127.063103
강남구,2322, 삼성역 3번 출구,202005,911,914,1825,37.508091,127.063103
강남구,2322, 삼성역 3번 출구,202006,1083,1060,2143,37.508091,127.063103
강남구,2323, 주식회사 오뚜기 정문 앞,201901,113,75,188,37.502213,127.067207
강남구,2323, 주식회사 오뚜기 정문 앞,201902,81,78,159,37.502213,127.067207
강남구,2323, 주식회사 오뚜기 정문 앞,201903,228,214,442,37.502213,127.067207
강남구,2323, 주식회사 오뚜기 정문 앞,201904,367,328,695,37.502213,127.067207
강남구,2323, 주식회사 오뚜기 정문 앞,201905,488,471,959,37.502213,127.067207
강남구,2323, 주식회사 오뚜기 정문 앞,201906,493,448,941,37.502213,127.067207
강남구,2323, 주식회사 오뚜기 정문 앞,201907,512,402,914,37.502213,127.067207
강남구,2323, 주식회사 오뚜기 정문 앞,201908,346,311,657,37.502213,127.067207
강남구,2323, 주식회사 오뚜기 정문 앞,201909,449,430,879,37.502213,127.067207
강남구,2323, 주식회사 오뚜기 정문 앞,201910,449,448,897,37.502213,127.067207
강남구,2323, 주식회사 오뚜기 정문 앞,201911,271,273,544,37.502213,127.067207
강남구,2323, 주식회사 오뚜기 정문 앞,201912,141,131,272,37.502213,127.067207
강남구,2323, 주식회사 오뚜기 정문 앞,202001,184,142,326,37.502213,127.067207
강남구,2323, 주식회사 오뚜기 정문 앞,202002,157,135,292,37.502213,127.067207
강남구,2323, 주식회사 오뚜기 정문 앞,202003,431,349,780,37.502213,127.067207
강남구,2323, 주식회사 오뚜기 정문 앞,202004,563,549,1112,37.502213,127.067207
강남구,2323, 주식회사 오뚜기 정문 앞,202005,532,521,1053,37.502213,127.067207
강남구,2323, 주식회사 오뚜기 정문 앞,202006,574,570,1144,37.502213,127.067207
강남구,2324, 천주교 대치 2동 교회 옆,201901,332,344,676,37.500439,127.066223
강남구,2324, 천주교 대치 2동 교회 옆,201902,240,269,509,37.500439,127.066223
강남구,2324, 천주교 대치 2동 교회 옆,201903,415,443,858,37.500439,127.066223
강남구,2324, 천주교 대치 2동 교회 옆,201904,795,811,1606,37.500439,127.066223
강남구,2324, 천주교 대치 2동 교회 옆,201905,1239,1244,2483,37.500439,127.066223
강남구,2324, 천주교 대치 2동 교회 옆,201906,1294,1299,2593,37.500439,127.066223
강남구,2324, 천주교 대치 2동 교회 옆,201907,1226,1232,2458,37.500439,127.066223
강남구,2324, 천주교 대치 2동 교회 옆,201908,1182,1176,2358,37.500439,127.066223
강남구,2324, 천주교 대치 2동 교회 옆,201909,1261,1277,2538,37.500439,127.066223
강남구,2324, 천주교 대치 2동 교회 옆,201910,1428,1441,2869,37.500439,127.066223
강남구,2324, 천주교 대치 2동 교회 옆,201911,822,858,1680,37.500439,127.066223
강남구,2324, 천주교 대치 2동 교회 옆,201912,501,532,1033,37.500439,127.066223
강남구,2324, 천주교 대치 2동 교회 옆,202001,521,516,1037,37.500439,127.066223
강남구,2324, 천주교 대치 2동 교회 옆,202002,447,444,891,37.500439,127.066223
강남구,2324, 천주교 대치 2동 교회 옆,202003,994,973,1967,37.500439,127.066223
강남구,2324, 천주교 대치 2동 교회 옆,202004,1212,1211,2423,37.500439,127.066223
강남구,2324, 천주교 대치 2동 교회 옆,202005,1369,1365,2734,37.500439,127.066223
강남구,2324, 천주교 대치 2동 교회 옆,202006,1492,1493,2985,37.500439,127.066223
강남구,2325, 대치동 버거킹대치점,201901,313,331,644,37.49865,127.059319
강남구,2325, 대치동 버거킹대치점,201902,284,279,563,37.49865,127.059319
강남구,2325, 대치동 버거킹대치점,201903,557,526,1083,37.49865,127.059319
강남구,2325, 대치동 버거킹대치점,201904,895,889,1784,37.49865,127.059319
강남구,2325, 대치동 버거킹대치점,201905,1351,1336,2687,37.49865,127.059319
강남구,2325, 대치동 버거킹대치점,201906,1437,1436,2873,37.49865,127.059319
강남구,2325, 대치동 버거킹대치점,201907,1301,1270,2571,37.49865,127.059319
강남구,2325, 대치동 버거킹대치점,201908,1247,1254,2501,37.49865,127.059319
강남구,2325, 대치동 버거킹대치점,201909,1239,1240,2479,37.49865,127.059319
강남구,2325, 대치동 버거킹대치점,201910,1404,1369,2773,37.49865,127.059319
강남구,2325, 대치동 버거킹대치점,201911,911,913,1824,37.49865,127.059319
강남구,2325, 대치동 버거킹대치점,201912,541,567,1108,37.49865,127.059319
강남구,2325, 대치동 버거킹대치점,202001,551,600,1151,37.49865,127.059319
강남구,2325, 대치동 버거킹대치점,202002,437,431,868,37.49865,127.059319
강남구,2325, 대치동 버거킹대치점,202003,883,852,1735,37.49865,127.059319
강남구,2325, 대치동 버거킹대치점,202004,1142,1092,2234,37.49865,127.059319
강남구,2325, 대치동 버거킹대치점,202005,1142,1128,2270,37.49865,127.059319
강남구,2325, 대치동 버거킹대치점,202006,1246,1225,2471,37.49865,127.059319
강남구,2326, 대치동 삼성로,201901,223,134,357,37.502396,127.0588
강남구,2326, 대치동 삼성로,201902,164,119,283,37.502396,127.0588
강남구,2326, 대치동 삼성로,201903,329,240,569,37.502396,127.0588
강남구,2326, 대치동 삼성로,201904,389,267,656,37.502396,127.0588
강남구,2326, 대치동 삼성로,201905,381,372,753,37.502396,127.0588
강남구,2326, 대치동 삼성로,201906,415,394,809,37.502396,127.0588
강남구,2326, 대치동 삼성로,201907,384,359,743,37.502396,127.0588
강남구,2326, 대치동 삼성로,201908,272,275,547,37.502396,127.0588
강남구,2326, 대치동 삼성로,201909,380,375,755,37.502396,127.0588
강남구,2326, 대치동 삼성로,201910,450,427,877,37.502396,127.0588
강남구,2326, 대치동 삼성로,201911,409,360,769,37.502396,127.0588
강남구,2326, 대치동 삼성로,201912,252,214,466,37.502396,127.0588
강남구,2326, 대치동 삼성로,202001,279,203,482,37.502396,127.0588
강남구,2326, 대치동 삼성로,202002,209,156,365,37.502396,127.0588
강남구,2326, 대치동 삼성로,202003,327,195,522,37.502396,127.0588
강남구,2326, 대치동 삼성로,202004,377,312,689,37.502396,127.0588
강남구,2326, 대치동 삼성로,202005,410,362,772,37.502396,127.0588
강남구,2326, 대치동 삼성로,202006,372,338,710,37.502396,127.0588
강남구,2327, 뱅뱅사거리 랜드마크타워 앞,201901,461,529,990,37.490551,127.031464
강남구,2327, 뱅뱅사거리 랜드마크타워 앞,201902,353,529,882,37.490551,127.031464
강남구,2327, 뱅뱅사거리 랜드마크타워 앞,201903,781,929,1710,37.490551,127.031464
강남구,2327, 뱅뱅사거리 랜드마크타워 앞,201904,1124,1261,2385,37.490551,127.031464
강남구,2327, 뱅뱅사거리 랜드마크타워 앞,201905,1505,1629,3134,37.490551,127.031464
강남구,2327, 뱅뱅사거리 랜드마크타워 앞,201906,1598,1614,3212,37.490551,127.031464
강남구,2327, 뱅뱅사거리 랜드마크타워 앞,201907,1473,1541,3014,37.490551,127.031464
강남구,2327, 뱅뱅사거리 랜드마크타워 앞,201908,1252,1342,2594,37.490551,127.031464
강남구,2327, 뱅뱅사거리 랜드마크타워 앞,201909,1165,1239,2404,37.490551,127.031464
강남구,2327, 뱅뱅사거리 랜드마크타워 앞,201910,1560,1588,3148,37.490551,127.031464
강남구,2327, 뱅뱅사거리 랜드마크타워 앞,201911,1106,1168,2274,37.490551,127.031464
강남구,2327, 뱅뱅사거리 랜드마크타워 앞,201912,628,637,1265,37.490551,127.031464
강남구,2327, 뱅뱅사거리 랜드마크타워 앞,202001,466,603,1069,37.490551,127.031464
강남구,2327, 뱅뱅사거리 랜드마크타워 앞,202002,446,484,930,37.490551,127.031464
강남구,2327, 뱅뱅사거리 랜드마크타워 앞,202003,803,814,1617,37.490551,127.031464
강남구,2327, 뱅뱅사거리 랜드마크타워 앞,202004,997,1016,2013,37.490551,127.031464
강남구,2327, 뱅뱅사거리 랜드마크타워 앞,202005,1049,1054,2103,37.490551,127.031464
강남구,2327, 뱅뱅사거리 랜드마크타워 앞,202006,1137,1200,2337,37.490551,127.031464
강남구,2328, 르네상스 호텔 사거리 역삼지하보도 7번출구 앞,201901,264,147,411,37.503586,127.042641
강남구,2328, 르네상스 호텔 사거리 역삼지하보도 7번출구 앞,201902,190,141,331,37.503586,127.042641
강남구,2328, 르네상스 호텔 사거리 역삼지하보도 7번출구 앞,201903,425,311,736,37.503586,127.042641
강남구,2328, 르네상스 호텔 사거리 역삼지하보도 7번출구 앞,201904,826,625,1451,37.503586,127.042641
강남구,2328, 르네상스 호텔 사거리 역삼지하보도 7번출구 앞,201905,1092,783,1875,37.503586,127.042641
강남구,2328, 르네상스 호텔 사거리 역삼지하보도 7번출구 앞,201906,986,715,1701,37.503586,127.042641
강남구,2328, 르네상스 호텔 사거리 역삼지하보도 7번출구 앞,201907,1076,838,1914,37.503586,127.042641
강남구,2328, 르네상스 호텔 사거리 역삼지하보도 7번출구 앞,201908,819,592,1411,37.503586,127.042641
강남구,2328, 르네상스 호텔 사거리 역삼지하보도 7번출구 앞,201909,724,651,1375,37.503586,127.042641
강남구,2328, 르네상스 호텔 사거리 역삼지하보도 7번출구 앞,201910,920,747,1667,37.503586,127.042641
강남구,2328, 르네상스 호텔 사거리 역삼지하보도 7번출구 앞,201911,589,474,1063,37.503586,127.042641
강남구,2328, 르네상스 호텔 사거리 역삼지하보도 7번출구 앞,201912,322,233,555,37.503586,127.042641
강남구,2328, 르네상스 호텔 사거리 역삼지하보도 7번출구 앞,202001,262,237,499,37.503586,127.042641
강남구,2328, 르네상스 호텔 사거리 역삼지하보도 7번출구 앞,202002,295,255,550,37.503586,127.042641
강남구,2328, 르네상스 호텔 사거리 역삼지하보도 7번출구 앞,202003,423,361,784,37.503586,127.042641
강남구,2328, 르네상스 호텔 사거리 역삼지하보도 7번출구 앞,202004,524,486,1010,37.503586,127.042641
강남구,2328, 르네상스 호텔 사거리 역삼지하보도 7번출구 앞,202005,536,517,1053,37.503586,127.042641
강남구,2328, 르네상스 호텔 사거리 역삼지하보도 7번출구 앞,202006,581,562,1143,37.503586,127.042641
강남구,2329, 르네상스호텔사거리 역삼지하보도 2번출구,201901,179,160,339,37.502357,127.04319
강남구,2329, 르네상스호텔사거리 역삼지하보도 2번출구,201902,163,145,308,37.502357,127.04319
강남구,2329, 르네상스호텔사거리 역삼지하보도 2번출구,201903,383,298,681,37.502357,127.04319
강남구,2329, 르네상스호텔사거리 역삼지하보도 2번출구,201904,105,115,220,37.502357,127.04319
강남구,2329, 르네상스호텔사거리 역삼지하보도 2번출구,201905,464,331,795,37.502357,127.04319
강남구,2329, 르네상스호텔사거리 역삼지하보도 2번출구,201906,505,472,977,37.502357,127.04319
강남구,2329, 르네상스호텔사거리 역삼지하보도 2번출구,201908,405,274,679,37.502357,127.04319
강남구,2329, 르네상스호텔사거리 역삼지하보도 2번출구,201909,440,342,782,37.502357,127.04319
강남구,2329, 르네상스호텔사거리 역삼지하보도 2번출구,201910,669,533,1202,37.502357,127.04319
강남구,2329, 르네상스호텔사거리 역삼지하보도 2번출구,201911,452,332,784,37.502357,127.04319
강남구,2329, 르네상스호텔사거리 역삼지하보도 2번출구,201912,165,133,298,37.502357,127.04319
강남구,2329, 르네상스호텔사거리 역삼지하보도 2번출구,202001,165,152,317,37.502357,127.04319
강남구,2329, 르네상스호텔사거리 역삼지하보도 2번출구,202002,130,129,259,37.502357,127.04319
강남구,2329, 르네상스호텔사거리 역삼지하보도 2번출구,202003,269,243,512,37.502357,127.04319
강남구,2329, 르네상스호텔사거리 역삼지하보도 2번출구,202004,268,273,541,37.502357,127.04319
강남구,2329, 르네상스호텔사거리 역삼지하보도 2번출구,202005,82,84,166,37.502357,127.04319
강남구,2329, 르네상스호텔사거리 역삼지하보도 2번출구,202006,393,385,778,37.502357,127.04319
강남구,2330, 스타벅스 앞,201901,279,279,558,37.492199,127.039459
강남구,2330, 스타벅스 앞,201902,255,266,521,37.492199,127.039459
강남구,2330, 스타벅스 앞,201903,474,434,908,37.492199,127.039459
강남구,2330, 스타벅스 앞,201904,636,562,1198,37.492199,127.039459
강남구,2330, 스타벅스 앞,201905,1038,925,1963,37.492199,127.039459
강남구,2330, 스타벅스 앞,201906,1107,958,2065,37.492199,127.039459
강남구,2330, 스타벅스 앞,201907,947,830,1777,37.492199,127.039459
강남구,2330, 스타벅스 앞,201908,885,782,1667,37.492199,127.039459
강남구,2330, 스타벅스 앞,201909,835,703,1538,37.492199,127.039459
강남구,2330, 스타벅스 앞,201910,1033,931,1964,37.492199,127.039459
강남구,2330, 스타벅스 앞,201911,741,702,1443,37.492199,127.039459
강남구,2330, 스타벅스 앞,201912,350,327,677,37.492199,127.039459
강남구,2330, 스타벅스 앞,202001,401,347,748,37.492199,127.039459
강남구,2330, 스타벅스 앞,202002,361,317,678,37.492199,127.039459
강남구,2330, 스타벅스 앞,202003,616,567,1183,37.492199,127.039459
강남구,2330, 스타벅스 앞,202004,711,690,1401,37.492199,127.039459
강남구,2330, 스타벅스 앞,202005,657,655,1312,37.492199,127.039459
강남구,2330, 스타벅스 앞,202006,668,667,1335,37.492199,127.039459
강남구,2331, 동영문화센터앞,201901,237,191,428,37.498051,127.044601
강남구,2331, 동영문화센터앞,201902,197,178,375,37.498051,127.044601
강남구,2331, 동영문화센터앞,201903,556,433,989,37.498051,127.044601
강남구,2331, 동영문화센터앞,201904,848,560,1408,37.498051,127.044601
강남구,2331, 동영문화센터앞,201905,416,297,713,37.498051,127.044601
강남구,2331, 동영문화센터앞,201906,1008,719,1727,37.498051,127.044601
강남구,2331, 동영문화센터앞,201907,923,703,1626,37.498051,127.044601
강남구,2331, 동영문화센터앞,201908,908,633,1541,37.498051,127.044601
강남구,2331, 동영문화센터앞,201909,876,600,1476,37.498051,127.044601
강남구,2331, 동영문화센터앞,201910,1058,796,1854,37.498051,127.044601
강남구,2331, 동영문화센터앞,201911,832,586,1418,37.498051,127.044601
강남구,2331, 동영문화센터앞,201912,317,246,563,37.498051,127.044601
강남구,2331, 동영문화센터앞,202001,322,206,528,37.498051,127.044601
강남구,2331, 동영문화센터앞,202002,270,201,471,37.498051,127.044601
강남구,2331, 동영문화센터앞,202003,540,378,918,37.498051,127.044601
강남구,2331, 동영문화센터앞,202004,441,438,879,37.498051,127.044601
강남구,2331, 동영문화센터앞,202005,551,491,1042,37.498051,127.044601
강남구,2331, 동영문화센터앞,202006,736,571,1307,37.498051,127.044601
강남구,2332, 선릉역3번출구,201901,419,444,863,37.504208,127.048965
강남구,2332, 선릉역3번출구,201902,354,369,723,37.504208,127.048965
강남구,2332, 선릉역3번출구,201903,742,810,1552,37.504208,127.048965
강남구,2332, 선릉역3번출구,201904,1147,1210,2357,37.504208,127.048965
강남구,2332, 선릉역3번출구,201905,1757,1776,3533,37.504208,127.048965
강남구,2332, 선릉역3번출구,201906,1688,1701,3389,37.504208,127.048965
강남구,2332, 선릉역3번출구,201907,1665,1653,3318,37.504208,127.048965
강남구,2332, 선릉역3번출구,201908,1402,1406,2808,37.504208,127.048965
강남구,2332, 선릉역3번출구,201909,1355,1346,2701,37.504208,127.048965
강남구,2332, 선릉역3번출구,201910,1787,1798,3585,37.504208,127.048965
강남구,2332, 선릉역3번출구,201911,1287,1320,2607,37.504208,127.048965
강남구,2332, 선릉역3번출구,201912,717,728,1445,37.504208,127.048965
강남구,2332, 선릉역3번출구,202001,661,701,1362,37.504208,127.048965
강남구,2332, 선릉역3번출구,202002,479,494,973,37.504208,127.048965
강남구,2332, 선릉역3번출구,202003,999,1014,2013,37.504208,127.048965
강남구,2332, 선릉역3번출구,202004,1150,1147,2297,37.504208,127.048965
강남구,2332, 선릉역3번출구,202005,1286,1282,2568,37.504208,127.048965
강남구,2332, 선릉역3번출구,202006,1346,1341,2687,37.504208,127.048965
강남구,2333, 양재역 3번출구 주변,201901,364,232,596,37.485157,127.034073
강남구,2333, 양재역 3번출구 주변,201902,488,215,703,37.485157,127.034073
강남구,2333, 양재역 3번출구 주변,201903,950,451,1401,37.485157,127.034073
강남구,2333, 양재역 3번출구 주변,201904,1439,699,2138,37.485157,127.034073
강남구,2333, 양재역 3번출구 주변,201905,1785,1055,2840,37.485157,127.034073
강남구,2333, 양재역 3번출구 주변,201906,1723,1081,2804,37.485157,127.034073
강남구,2333, 양재역 3번출구 주변,201907,1647,1013,2660,37.485157,127.034073
강남구,2333, 양재역 3번출구 주변,201908,1366,814,2180,37.485157,127.034073
강남구,2333, 양재역 3번출구 주변,201909,1209,772,1981,37.485157,127.034073
강남구,2333, 양재역 3번출구 주변,201910,1103,770,1873,37.485157,127.034073
강남구,2333, 양재역 3번출구 주변,201911,1145,713,1858,37.485157,127.034073
강남구,2333, 양재역 3번출구 주변,201912,578,339,917,37.485157,127.034073
강남구,2333, 양재역 3번출구 주변,202001,737,353,1090,37.485157,127.034073
강남구,2333, 양재역 3번출구 주변,202002,662,358,1020,37.485157,127.034073
강남구,2333, 양재역 3번출구 주변,202003,939,558,1497,37.485157,127.034073
강남구,2333, 양재역 3번출구 주변,202004,1113,699,1812,37.485157,127.034073
강남구,2333, 양재역 3번출구 주변,202005,1022,707,1729,37.485157,127.034073
강남구,2333, 양재역 3번출구 주변,202006,1317,797,2114,37.485157,127.034073
강남구,2334,8,201901,87,70,157,37.493759,127.045898
강남구,2334,8,201902,90,75,165,37.493759,127.045898
강남구,2334,8,201903,201,175,376,37.493759,127.045898
강남구,2334,8,201904,248,209,457,37.493759,127.045898
강남구,2334,8,201905,476,356,832,37.493759,127.045898
강남구,2334,8,201906,435,356,791,37.493759,127.045898
강남구,2334,8,201907,436,275,711,37.493759,127.045898
강남구,2334,8,201908,452,259,711,37.493759,127.045898
강남구,2334,8,201909,480,305,785,37.493759,127.045898
강남구,2334,8,201910,520,321,841,37.493759,127.045898
강남구,2334,8,201911,325,218,543,37.493759,127.045898
강남구,2334, 삼호아파트 2동 ( 간선도로),201912,130,91,221,37.493759,127.045898
강남구,2334, 삼호아파트 2동 ( 간선도로),202001,177,117,294,37.493759,127.045898
강남구,2334, 삼호아파트 2동 ( 간선도로),202002,142,93,235,37.493759,127.045898
강남구,2334, 삼호아파트 2동 ( 간선도로),202003,207,150,357,37.493759,127.045898
강남구,2334, 삼호아파트 2동 ( 간선도로),202004,148,148,296,37.493759,127.045898
강남구,2334, 삼호아파트 2동 ( 간선도로),202005,115,118,233,37.493759,127.045898
강남구,2334, 삼호아파트 2동 ( 간선도로),202006,159,157,316,37.493759,127.045898
강남구,2335, 3호선 매봉역 3번출구앞,201901,311,319,630,37.486767,127.046761
강남구,2335, 3호선 매봉역 3번출구앞,201902,329,324,653,37.486767,127.046761
강남구,2335, 3호선 매봉역 3번출구앞,201903,618,671,1289,37.486767,127.046761
강남구,2335, 3호선 매봉역 3번출구앞,201904,1029,1088,2117,37.486767,127.046761
강남구,2335, 3호선 매봉역 3번출구앞,201905,1403,1395,2798,37.486767,127.046761
강남구,2335, 3호선 매봉역 3번출구앞,201906,1550,1528,3078,37.486767,127.046761
강남구,2335, 3호선 매봉역 3번출구앞,201907,1404,1391,2795,37.486767,127.046761
강남구,2335, 3호선 매봉역 3번출구앞,201908,1301,1294,2595,37.486767,127.046761
강남구,2335, 3호선 매봉역 3번출구앞,201909,1465,1473,2938,37.486767,127.046761
강남구,2335, 3호선 매봉역 3번출구앞,201910,1603,1671,3274,37.486767,127.046761
강남구,2335, 3호선 매봉역 3번출구앞,201911,1095,1185,2280,37.486767,127.046761
강남구,2335, 3호선 매봉역 3번출구앞,201912,640,666,1306,37.486767,127.046761
강남구,2335, 3호선 매봉역 3번출구앞,202001,505,559,1064,37.486767,127.046761
강남구,2335, 3호선 매봉역 3번출구앞,202002,387,410,797,37.486767,127.046761
강남구,2335, 3호선 매봉역 3번출구앞,202003,787,798,1585,37.486767,127.046761
강남구,2335, 3호선 매봉역 3번출구앞,202004,975,962,1937,37.486767,127.046761
강남구,2335, 3호선 매봉역 3번출구앞,202005,1120,1112,2232,37.486767,127.046761
강남구,2335, 3호선 매봉역 3번출구앞,202006,1295,1285,2580,37.486767,127.046761
강남구,2336, 강남세브란스교차로 래미안그레이튼 104동 앞,201901,116,108,224,37.494236,127.047462
강남구,2336, 강남세브란스교차로 래미안그레이튼 104동 앞,201902,89,90,179,37.494236,127.047462
강남구,2336, 강남세브란스교차로 래미안그레이튼 104동 앞,201903,224,213,437,37.494236,127.047462
강남구,2336, 강남세브란스교차로 래미안그레이튼 104동 앞,201904,355,324,679,37.494236,127.047462
강남구,2336, 강남세브란스교차로 래미안그레이튼 104동 앞,201905,558,411,969,37.494236,127.047462
강남구,2336, 강남세브란스교차로 래미안그레이튼 104동 앞,201906,622,475,1097,37.494236,127.047462
강남구,2336, 강남세브란스교차로 래미안그레이튼 104동 앞,201907,556,460,1016,37.494236,127.047462
강남구,2336, 강남세브란스교차로 래미안그레이튼 104동 앞,201908,528,426,954,37.494236,127.047462
강남구,2336, 강남세브란스교차로 래미안그레이튼 104동 앞,201909,539,411,950,37.494236,127.047462
강남구,2336, 강남세브란스교차로 래미안그레이튼 104동 앞,201910,558,434,992,37.494236,127.047462
강남구,2336, 강남세브란스교차로 래미안그레이튼 104동 앞,201911,332,271,603,37.494236,127.047462
강남구,2336, 강남세브란스교차로 래미안그레이튼 104동 앞,201912,165,98,263,37.494236,127.047462
강남구,2336, 강남세브란스교차로 래미안그레이튼 104동 앞,202001,144,83,227,37.494236,127.047462
강남구,2336, 강남세브란스교차로 래미안그레이튼 104동 앞,202002,142,94,236,37.494236,127.047462
강남구,2336, 강남세브란스교차로 래미안그레이튼 104동 앞,202003,321,255,576,37.494236,127.047462
강남구,2336, 강남세브란스교차로 래미안그레이튼 104동 앞,202004,301,288,589,37.494236,127.047462
강남구,2336, 강남세브란스교차로 래미안그레이튼 104동 앞,202005,295,293,588,37.494236,127.047462
강남구,2336, 강남세브란스교차로 래미안그레이튼 104동 앞,202006,292,279,571,37.494236,127.047462
강남구,2337, 대모산입구역 2번출구 앞,201901,111,55,166,37.492077,127.071976
강남구,2337, 대모산입구역 2번출구 앞,201902,137,74,211,37.492077,127.071976
강남구,2337, 대모산입구역 2번출구 앞,201903,271,184,455,37.492077,127.071976
강남구,2337, 대모산입구역 2번출구 앞,201904,430,344,774,37.492077,127.071976
강남구,2337, 대모산입구역 2번출구 앞,201905,510,449,959,37.492077,127.071976
강남구,2337, 대모산입구역 2번출구 앞,201906,424,415,839,37.492077,127.071976
강남구,2337, 대모산입구역 2번출구 앞,201907,488,411,899,37.492077,127.071976
강남구,2337, 대모산입구역 2번출구 앞,201908,469,407,876,37.492077,127.071976
강남구,2337, 대모산입구역 2번출구 앞,201909,461,392,853,37.492077,127.071976
강남구,2337, 대모산입구역 2번출구 앞,201910,462,408,870,37.492077,127.071976
강남구,2337, 대모산입구역 2번출구 앞,201911,332,233,565,37.492077,127.071976
강남구,2337, 대모산입구역 2번출구 앞,201912,236,157,393,37.492077,127.071976
강남구,2337, 대모산입구역 2번출구 앞,202001,209,172,381,37.492077,127.071976
강남구,2337, 대모산입구역 2번출구 앞,202002,179,160,339,37.492077,127.071976
강남구,2337, 대모산입구역 2번출구 앞,202003,360,352,712,37.492077,127.071976
강남구,2337, 대모산입구역 2번출구 앞,202004,409,381,790,37.492077,127.071976
강남구,2337, 대모산입구역 2번출구 앞,202005,454,435,889,37.492077,127.071976
강남구,2337, 대모산입구역 2번출구 앞,202006,533,452,985,37.492077,127.071976
강남구,2339, 현대아파트 정문 앞,201901,110,108,218,37.483261,127.052299
강남구,2339, 현대아파트 정문 앞,201902,122,139,261,37.483261,127.052299
강남구,2339, 현대아파트 정문 앞,201903,243,227,470,37.483261,127.052299
강남구,2339, 현대아파트 정문 앞,201904,433,394,827,37.483261,127.052299
강남구,2339, 현대아파트 정문 앞,201905,529,499,1028,37.483261,127.052299
강남구,2339, 현대아파트 정문 앞,201906,608,559,1167,37.483261,127.052299
강남구,2339, 현대아파트 정문 앞,201907,529,501,1030,37.483261,127.052299
강남구,2339, 현대아파트 정문 앞,201908,549,517,1066,37.483261,127.052299
강남구,2339, 현대아파트 정문 앞,201909,677,614,1291,37.483261,127.052299
강남구,2339, 현대아파트 정문 앞,201910,737,700,1437,37.483261,127.052299
강남구,2339, 현대아파트 정문 앞,201911,505,492,997,37.483261,127.052299
강남구,2339, 현대아파트 정문 앞,201912,267,256,523,37.483261,127.052299
강남구,2339, 현대아파트 정문 앞,202001,269,237,506,37.483261,127.052299
강남구,2339, 현대아파트 정문 앞,202002,201,189,390,37.483261,127.052299
강남구,2339, 현대아파트 정문 앞,202003,420,405,825,37.483261,127.052299
강남구,2339, 현대아파트 정문 앞,202004,408,410,818,37.483261,127.052299
강남구,2339, 현대아파트 정문 앞,202005,576,560,1136,37.483261,127.052299
강남구,2339, 현대아파트 정문 앞,202006,568,545,1113,37.483261,127.052299
강남구,2340, 삼호물산버스정류장(23370) 옆,201901,311,354,665,37.477509,127.045174
강남구,2340, 삼호물산버스정류장(23370) 옆,201902,304,337,641,37.477509,127.045174
강남구,2340, 삼호물산버스정류장(23370) 옆,201903,654,780,1434,37.477509,127.045174
강남구,2340, 삼호물산버스정류장(23370) 옆,201904,1326,1617,2943,37.477509,127.045174
강남구,2340, 삼호물산버스정류장(23370) 옆,201905,2001,2204,4205,37.477509,127.045174
강남구,2340, 삼호물산버스정류장(23370) 옆,201906,2357,2553,4910,37.477509,127.045174
강남구,2340, 삼호물산버스정류장(23370) 옆,201907,2093,2376,4469,37.477509,127.045174
강남구,2340, 삼호물산버스정류장(23370) 옆,201908,1777,2071,3848,37.477509,127.045174
강남구,2340, 삼호물산버스정류장(23370) 옆,201909,1798,2016,3814,37.477509,127.045174
강남구,2340, 삼호물산버스정류장(23370) 옆,201910,2150,2337,4487,37.477509,127.045174
강남구,2340, 삼호물산버스정류장(23370) 옆,201911,1272,1486,2758,37.477509,127.045174
강남구,2340, 삼호물산버스정류장(23370) 옆,201912,666,770,1436,37.477509,127.045174
강남구,2340, 삼호물산버스정류장(23370) 옆,202001,627,682,1309,37.477509,127.045174
강남구,2340, 삼호물산버스정류장(23370) 옆,202002,613,713,1326,37.477509,127.045174
강남구,2340, 삼호물산버스정류장(23370) 옆,202003,1378,1413,2791,37.477509,127.045174
강남구,2340, 삼호물산버스정류장(23370) 옆,202004,1407,1399,2806,37.477509,127.045174
강남구,2340, 삼호물산버스정류장(23370) 옆,202005,1498,1495,2993,37.477509,127.045174
강남구,2340, 삼호물산버스정류장(23370) 옆,202006,1880,1884,3764,37.477509,127.045174
강남구,2341, 일원역 4~5번 출구 사이,201901,180,125,305,37.483311,127.084938
강남구,2341, 일원역 4~5번 출구 사이,201902,162,133,295,37.483311,127.084938
강남구,2341, 일원역 4~5번 출구 사이,201903,183,129,312,37.483311,127.084938
강남구,2341, 일원역 4~5번 출구 사이,201904,340,227,567,37.483311,127.084938
강남구,2341, 일원역 4~5번 출구 사이,201905,330,315,645,37.483311,127.084938
강남구,2341, 일원역 4~5번 출구 사이,201906,322,281,603,37.483311,127.084938
강남구,2341, 일원역 4~5번 출구 사이,201907,385,266,651,37.483311,127.084938
강남구,2341, 일원역 4~5번 출구 사이,201908,332,241,573,37.483311,127.084938
강남구,2341, 일원역 4~5번 출구 사이,201909,436,328,764,37.483311,127.084938
강남구,2341, 일원역 4~5번 출구 사이,201910,333,303,636,37.483311,127.084938
강남구,2341, 일원역 4~5번 출구 사이,201911,275,183,458,37.483311,127.084938
강남구,2341, 일원역 4~5번 출구 사이,201912,139,97,236,37.483311,127.084938
강남구,2341, 일원역 4~5번 출구 사이,202001,154,104,258,37.483311,127.084938
강남구,2341, 일원역 4~5번 출구 사이,202002,130,106,236,37.483311,127.084938
강남구,2341, 일원역 4~5번 출구 사이,202003,310,285,595,37.483311,127.084938
강남구,2341, 일원역 4~5번 출구 사이,202004,430,408,838,37.483311,127.084938
강남구,2341, 일원역 4~5번 출구 사이,202005,403,383,786,37.483311,127.084938
강남구,2341, 일원역 4~5번 출구 사이,202006,461,350,811,37.483311,127.084938
강남구,2342, 대청역 1번출구 뒤,201901,371,397,768,37.494007,127.079514
강남구,2342, 대청역 1번출구 뒤,201902,366,389,755,37.494007,127.079514
강남구,2342, 대청역 1번출구 뒤,201903,686,824,1510,37.494007,127.079514
강남구,2342, 대청역 1번출구 뒤,201904,1200,1350,2550,37.494007,127.079514
강남구,2342, 대청역 1번출구 뒤,201905,1889,2059,3948,37.494007,127.079514
강남구,2342, 대청역 1번출구 뒤,201906,2096,2254,4350,37.494007,127.079514
강남구,2342, 대청역 1번출구 뒤,201907,1832,2098,3930,37.494007,127.079514
강남구,2342, 대청역 1번출구 뒤,201908,1777,1929,3706,37.494007,127.079514
강남구,2342, 대청역 1번출구 뒤,201909,1907,2017,3924,37.494007,127.079514
강남구,2342, 대청역 1번출구 뒤,201910,2271,2374,4645,37.494007,127.079514
강남구,2342, 대청역 1번출구 뒤,201911,1397,1487,2884,37.494007,127.079514
강남구,2342, 대청역 1번출구 뒤,201912,821,899,1720,37.494007,127.079514
강남구,2342, 대청역 1번출구 뒤,202001,703,779,1482,37.494007,127.079514
강남구,2342, 대청역 1번출구 뒤,202002,716,782,1498,37.494007,127.079514
강남구,2342, 대청역 1번출구 뒤,202003,1735,1752,3487,37.494007,127.079514
강남구,2342, 대청역 1번출구 뒤,202004,2253,2282,4535,37.494007,127.079514
강남구,2342, 대청역 1번출구 뒤,202005,2382,2391,4773,37.494007,127.079514
강남구,2342, 대청역 1번출구 뒤,202006,2324,2361,4685,37.494007,127.079514
강남구,2343, 세곡사거리 대왕파출소 앞,201901,43,45,88,37.465317,127.107727
강남구,2343, 세곡사거리 대왕파출소 앞,201902,34,39,73,37.465317,127.107727
강남구,2343, 세곡사거리 대왕파출소 앞,201903,55,48,103,37.465317,127.107727
강남구,2343, 세곡사거리 대왕파출소 앞,201904,101,79,180,37.465317,127.107727
강남구,2343, 세곡사거리 대왕파출소 앞,201905,203,215,418,37.465317,127.107727
강남구,2343, 세곡사거리 대왕파출소 앞,201906,209,217,426,37.465317,127.107727
강남구,2343, 세곡사거리 대왕파출소 앞,201907,177,187,364,37.465317,127.107727
강남구,2343, 세곡사거리 대왕파출소 앞,201908,159,154,313,37.465317,127.107727
강남구,2343, 세곡사거리 대왕파출소 앞,201909,113,124,237,37.465317,127.107727
강남구,2343, 세곡사거리 대왕파출소 앞,201910,171,170,341,37.465317,127.107727
강남구,2343, 세곡사거리 대왕파출소 앞,201911,114,104,218,37.465317,127.107727
강남구,2343, 세곡사거리 대왕파출소 앞,201912,38,44,82,37.465317,127.107727
강남구,2343, 세곡사거리 대왕파출소 앞,202001,50,42,92,37.465317,127.107727
강남구,2343, 세곡사거리 대왕파출소 앞,202002,56,54,110,37.465317,127.107727
강남구,2343, 세곡사거리 대왕파출소 앞,202003,125,120,245,37.465317,127.107727
강남구,2343, 세곡사거리 대왕파출소 앞,202004,180,160,340,37.465317,127.107727
강남구,2343, 세곡사거리 대왕파출소 앞,202005,198,193,391,37.465317,127.107727
강남구,2343, 세곡사거리 대왕파출소 앞,202006,179,178,357,37.465317,127.107727
강남구,2344, 리엔파크 2단지 앞,201901,148,157,305,37.465061,127.101196
강남구,2344, 리엔파크 2단지 앞,201902,142,177,319,37.465061,127.101196
강남구,2344, 리엔파크 2단지 앞,201903,286,275,561,37.465061,127.101196
강남구,2344, 리엔파크 2단지 앞,201904,362,416,778,37.465061,127.101196
강남구,2344, 리엔파크 2단지 앞,201905,605,588,1193,37.465061,127.101196
강남구,2344, 리엔파크 2단지 앞,201906,697,769,1466,37.465061,127.101196
강남구,2344, 리엔파크 2단지 앞,201907,659,766,1425,37.465061,127.101196
강남구,2344, 리엔파크 2단지 앞,201908,662,810,1472,37.465061,127.101196
강남구,2344, 리엔파크 2단지 앞,201909,641,775,1416,37.465061,127.101196
강남구,2344, 리엔파크 2단지 앞,201910,723,778,1501,37.465061,127.101196
강남구,2344, 리엔파크 2단지 앞,201911,399,469,868,37.465061,127.101196
강남구,2344, 리엔파크 2단지 앞,201912,223,255,478,37.465061,127.101196
강남구,2344, 리엔파크 2단지 앞,202001,192,225,417,37.465061,127.101196
강남구,2344, 리엔파크 2단지 앞,202002,240,243,483,37.465061,127.101196
강남구,2344, 리엔파크 2단지 앞,202003,462,476,938,37.465061,127.101196
강남구,2344, 리엔파크 2단지 앞,202004,811,838,1649,37.465061,127.101196
강남구,2344, 리엔파크 2단지 앞,202005,855,858,1713,37.465061,127.101196
강남구,2344, 리엔파크 2단지 앞,202006,867,862,1729,37.465061,127.101196
강남구,2347, 두산건설 본사,201901,139,66,205,37.518639,127.0354
강남구,2347, 두산건설 본사,201902,100,50,150,37.518639,127.0354
강남구,2347, 두산건설 본사,201903,239,107,346,37.518639,127.0354
강남구,2347, 두산건설 본사,201904,414,146,560,37.518639,127.0354
강남구,2347, 두산건설 본사,201905,531,234,765,37.518639,127.0354
강남구,2347, 두산건설 본사,201906,648,254,902,37.518639,127.0354
강남구,2347, 두산건설 본사,201907,730,275,1005,37.518639,127.0354
강남구,2347, 두산건설 본사,201908,717,257,974,37.518639,127.0354
강남구,2347, 두산건설 본사,201909,575,200,775,37.518639,127.0354
강남구,2347, 두산건설 본사,201910,745,271,1016,37.518639,127.0354
강남구,2347, 두산건설 본사,201911,491,183,674,37.518639,127.0354
강남구,2347, 두산건설 본사,201912,229,100,329,37.518639,127.0354
강남구,2347, 두산건설 본사,202001,234,104,338,37.518639,127.0354
강남구,2347, 두산건설 본사,202002,164,68,232,37.518639,127.0354
강남구,2347, 두산건설 본사,202003,328,126,454,37.518639,127.0354
강남구,2347, 두산건설 본사,202004,424,158,582,37.518639,127.0354
강남구,2347, 두산건설 본사,202005,322,123,445,37.518639,127.0354
강남구,2347, 두산건설 본사,202006,444,177,621,37.518639,127.0354
강남구,2348, 포스코사거리(기업은행),201901,503,645,1148,37.507233,127.056854
강남구,2348, 포스코사거리(기업은행),201902,441,472,913,37.507233,127.056854
강남구,2348, 포스코사거리(기업은행),201903,721,884,1605,37.507233,127.056854
강남구,2348, 포스코사거리(기업은행),201904,1551,1681,3232,37.507233,127.056854
강남구,2348, 포스코사거리(기업은행),201905,2254,2247,4501,37.507233,127.056854
강남구,2348, 포스코사거리(기업은행),201906,2466,2360,4826,37.507233,127.056854
강남구,2348, 포스코사거리(기업은행),201907,2442,2405,4847,37.507233,127.056854
강남구,2348, 포스코사거리(기업은행),201908,1949,1936,3885,37.507233,127.056854
강남구,2348, 포스코사거리(기업은행),201909,1932,1993,3925,37.507233,127.056854
강남구,2348, 포스코사거리(기업은행),201910,2447,2421,4868,37.507233,127.056854
강남구,2348, 포스코사거리(기업은행),201911,1505,1757,3262,37.507233,127.056854
강남구,2348, 포스코사거리(기업은행),201912,759,976,1735,37.507233,127.056854
강남구,2348, 포스코사거리(기업은행),202001,753,974,1727,37.507233,127.056854
강남구,2348, 포스코사거리(기업은행),202002,672,807,1479,37.507233,127.056854
강남구,2348, 포스코사거리(기업은행),202003,1304,1309,2613,37.507233,127.056854
강남구,2348, 포스코사거리(기업은행),202004,1686,1766,3452,37.507233,127.056854
강남구,2348, 포스코사거리(기업은행),202005,1749,1809,3558,37.507233,127.056854
강남구,2348, 포스코사거리(기업은행),202006,2040,2257,4297,37.507233,127.056854
강남구,2349, 역삼빌딩 앞(하나은행 옆),201901,289,163,452,37.501545,127.038567
강남구,2349, 역삼빌딩 앞(하나은행 옆),201902,256,169,425,37.501545,127.038567
강남구,2349, 역삼빌딩 앞(하나은행 옆),201903,613,345,958,37.501545,127.038567
강남구,2349, 역삼빌딩 앞(하나은행 옆),201904,905,408,1313,37.501545,127.038567
강남구,2349, 역삼빌딩 앞(하나은행 옆),201905,1060,513,1573,37.501545,127.038567
강남구,2349, 역삼빌딩 앞(하나은행 옆),201906,931,573,1504,37.501545,127.038567
강남구,2349, 역삼빌딩 앞(하나은행 옆),201907,737,432,1169,37.501545,127.038567
강남구,2349, 역삼빌딩 앞(하나은행 옆),201908,600,393,993,37.501545,127.038567
강남구,2349, 역삼빌딩 앞(하나은행 옆),201909,582,409,991,37.501545,127.038567
강남구,2349, 역삼빌딩 앞(하나은행 옆),201910,708,488,1196,37.501545,127.038567
강남구,2349, 역삼빌딩 앞(하나은행 옆),201911,658,366,1024,37.501545,127.038567
강남구,2349, 역삼빌딩 앞(하나은행 옆),201912,271,164,435,37.501545,127.038567
강남구,2349, 역삼빌딩 앞(하나은행 옆),202001,336,173,509,37.501545,127.038567
강남구,2349, 역삼빌딩 앞(하나은행 옆),202002,197,141,338,37.501545,127.038567
강남구,2349, 역삼빌딩 앞(하나은행 옆),202003,326,236,562,37.501545,127.038567
강남구,2349, 역삼빌딩 앞(하나은행 옆),202004,330,313,643,37.501545,127.038567
강남구,2349, 역삼빌딩 앞(하나은행 옆),202005,363,341,704,37.501545,127.038567
강남구,2349, 역삼빌딩 앞(하나은행 옆),202006,349,340,689,37.501545,127.038567
강남구,2350, 래미안그레이튼102동앞,201901,129,126,255,37.494823,127.047905
강남구,2350, 래미안그레이튼102동앞,201902,111,101,212,37.494823,127.047905
강남구,2350, 래미안그레이튼102동앞,201903,178,169,347,37.494823,127.047905
강남구,2350, 래미안그레이튼102동앞,201904,287,287,574,37.494823,127.047905
강남구,2350, 래미안그레이튼102동앞,201905,547,469,1016,37.494823,127.047905
강남구,2350, 래미안그레이튼102동앞,201906,577,464,1041,37.494823,127.047905
강남구,2350, 래미안그레이튼102동앞,201907,472,374,846,37.494823,127.047905
강남구,2350, 래미안그레이튼102동앞,201908,471,346,817,37.494823,127.047905
강남구,2350, 래미안그레이튼102동앞,201909,397,281,678,37.494823,127.047905
강남구,2350, 래미안그레이튼102동앞,201910,558,379,937,37.494823,127.047905
강남구,2350, 래미안그레이튼102동앞,201911,307,237,544,37.494823,127.047905
강남구,2350, 래미안그레이튼102동앞,201912,157,130,287,37.494823,127.047905
강남구,2350, 래미안그레이튼102동앞,202001,156,128,284,37.494823,127.047905
강남구,2350, 래미안그레이튼102동앞,202002,147,130,277,37.494823,127.047905
강남구,2350, 래미안그레이튼102동앞,202003,310,241,551,37.494823,127.047905
강남구,2350, 래미안그레이튼102동앞,202004,307,303,610,37.494823,127.047905
강남구,2350, 래미안그레이튼102동앞,202005,318,318,636,37.494823,127.047905
강남구,2350, 래미안그레이튼102동앞,202006,359,351,710,37.494823,127.047905
강남구,2351, 청소년수련관(수영장)앞,201901,17,8,25,37.483879,127.089027
강남구,2351, 청소년수련관(수영장)앞,201903,77,40,117,37.483879,127.089027
강남구,2351, 청소년수련관(수영장)앞,201904,203,146,349,37.483879,127.089027
강남구,2351, 청소년수련관(수영장)앞,201905,254,254,508,37.483879,127.089027
강남구,2351, 청소년수련관(수영장)앞,201906,291,289,580,37.483879,127.089027
강남구,2351, 청소년수련관(수영장)앞,201907,341,248,589,37.483879,127.089027
강남구,2351, 청소년수련관(수영장)앞,201908,278,252,530,37.483879,127.089027
강남구,2351, 청소년수련관(수영장)앞,201909,337,234,571,37.483879,127.089027
강남구,2351, 청소년수련관(수영장)앞,201910,253,217,470,37.483879,127.089027
강남구,2351, 청소년수련관(수영장)앞,201911,175,137,312,37.483879,127.089027
강남구,2351, 청소년수련관(수영장)앞,201912,70,53,123,37.483879,127.089027
강남구,2351, 청소년수련관(수영장)앞,202001,98,89,187,37.483879,127.089027
강남구,2351, 청소년수련관(수영장)앞,202002,95,80,175,37.483879,127.089027
강남구,2351, 청소년수련관(수영장)앞,202003,150,142,292,37.483879,127.089027
강남구,2351, 청소년수련관(수영장)앞,202004,315,308,623,37.483879,127.089027
강남구,2351, 청소년수련관(수영장)앞,202005,320,314,634,37.483879,127.089027
강남구,2351, 청소년수련관(수영장)앞,202006,236,201,437,37.483879,127.089027
강남구,2352, 서울본부세관(건설회관 앞),201901,155,67,222,37.51759,127.035027
강남구,2352, 서울본부세관(건설회관 앞),201902,94,50,144,37.51759,127.035027
강남구,2352, 서울본부세관(건설회관 앞),201903,267,120,387,37.51759,127.035027
강남구,2352, 서울본부세관(건설회관 앞),201904,387,134,521,37.51759,127.035027
강남구,2352, 서울본부세관(건설회관 앞),201905,466,207,673,37.51759,127.035027
강남구,2352, 서울본부세관(건설회관 앞),201906,489,170,659,37.51759,127.035027
강남구,2352, 서울본부세관(건설회관 앞),201907,459,156,615,37.51759,127.035027
강남구,2352, 서울본부세관(건설회관 앞),201908,440,147,587,37.51759,127.035027
강남구,2352, 서울본부세관(건설회관 앞),201909,421,156,577,37.51759,127.035027
강남구,2352, 서울본부세관(건설회관 앞),201910,495,190,685,37.51759,127.035027
강남구,2352, 서울본부세관(건설회관 앞),201911,351,156,507,37.51759,127.035027
강남구,2352, 서울본부세관(건설회관 앞),201912,194,71,265,37.51759,127.035027
강남구,2352, 서울본부세관(건설회관 앞),202001,184,83,267,37.51759,127.035027
강남구,2352, 서울본부세관(건설회관 앞),202002,147,66,213,37.51759,127.035027
강남구,2352, 서울본부세관(건설회관 앞),202003,270,119,389,37.51759,127.035027
강남구,2352, 서울본부세관(건설회관 앞),202004,353,156,509,37.51759,127.035027
강남구,2352, 서울본부세관(건설회관 앞),202005,280,115,395,37.51759,127.035027
강남구,2352, 서울본부세관(건설회관 앞),202006,312,142,454,37.51759,127.035027
강남구,2353, 강남구청역 2번출구 뒤,201901,337,174,511,37.516811,127.040474
강남구,2353, 강남구청역 2번출구 뒤,201902,253,138,391,37.516811,127.040474
강남구,2353, 강남구청역 2번출구 뒤,201903,605,320,925,37.516811,127.040474
강남구,2353, 강남구청역 2번출구 뒤,201904,953,544,1497,37.516811,127.040474
강남구,2353, 강남구청역 2번출구 뒤,201905,1168,744,1912,37.516811,127.040474
강남구,2353, 강남구청역 2번출구 뒤,201906,1178,751,1929,37.516811,127.040474
강남구,2353, 강남구청역 2번출구 뒤,201907,1123,710,1833,37.516811,127.040474
강남구,2353, 강남구청역 2번출구 뒤,201908,1047,682,1729,37.516811,127.040474
강남구,2353, 강남구청역 2번출구 뒤,201909,740,569,1309,37.516811,127.040474
강남구,2353, 강남구청역 2번출구 뒤,201910,795,659,1454,37.516811,127.040474
강남구,2353, 강남구청역 2번출구 뒤,201911,735,434,1169,37.516811,127.040474
강남구,2353, 강남구청역 2번출구 뒤,201912,447,268,715,37.516811,127.040474
강남구,2353, 강남구청역 2번출구 뒤,202001,347,259,606,37.516811,127.040474
강남구,2353, 강남구청역 2번출구 뒤,202002,294,225,519,37.516811,127.040474
강남구,2353, 강남구청역 2번출구 뒤,202003,593,355,948,37.516811,127.040474
강남구,2353, 강남구청역 2번출구 뒤,202004,804,460,1264,37.516811,127.040474
강남구,2353, 강남구청역 2번출구 뒤,202005,664,446,1110,37.516811,127.040474
강남구,2353, 강남구청역 2번출구 뒤,202006,824,499,1323,37.516811,127.040474
강남구,2354, 청담역 2번출구,201901,102,101,203,37.519787,127.056763
강남구,2354, 청담역 2번출구,201902,92,82,174,37.519787,127.056763
강남구,2354, 청담역 2번출구,201903,186,171,357,37.519787,127.056763
강남구,2354, 청담역 2번출구,201904,303,250,553,37.519787,127.056763
강남구,2354, 청담역 2번출구,201905,390,383,773,37.519787,127.056763
강남구,2354, 청담역 2번출구,201906,362,351,713,37.519787,127.056763
강남구,2354, 청담역 2번출구,201907,329,323,652,37.519787,127.056763
강남구,2354, 청담역 2번출구,201908,321,322,643,37.519787,127.056763
강남구,2354, 청담역 2번출구,201909,287,277,564,37.519787,127.056763
강남구,2354, 청담역 2번출구,201910,358,360,718,37.519787,127.056763
강남구,2354, 청담역 2번출구,201911,262,259,521,37.519787,127.056763
강남구,2354, 청담역 2번출구,201912,126,126,252,37.519787,127.056763
강남구,2354, 청담역 2번출구,202001,154,143,297,37.519787,127.056763
강남구,2354, 청담역 2번출구,202002,134,131,265,37.519787,127.056763
강남구,2354, 청담역 2번출구,202003,270,253,523,37.519787,127.056763
강남구,2354, 청담역 2번출구,202004,327,325,652,37.519787,127.056763
강남구,2354, 청담역 2번출구,202005,355,347,702,37.519787,127.056763
강남구,2354, 청담역 2번출구,202006,364,352,716,37.519787,127.056763
강남구,2355, 삼성역 5~6번 출구 사이,201901,602,606,1208,37.509121,127.062309
강남구,2355, 삼성역 5~6번 출구 사이,201902,500,512,1012,37.509121,127.062309
강남구,2355, 삼성역 5~6번 출구 사이,201903,1112,1095,2207,37.509121,127.062309
강남구,2355, 삼성역 5~6번 출구 사이,201904,1696,1629,3325,37.509121,127.062309
강남구,2355, 삼성역 5~6번 출구 사이,201905,2148,2120,4268,37.509121,127.062309
강남구,2355, 삼성역 5~6번 출구 사이,201906,2220,2151,4371,37.509121,127.062309
강남구,2355, 삼성역 5~6번 출구 사이,201907,1862,1851,3713,37.509121,127.062309
강남구,2355, 삼성역 5~6번 출구 사이,201908,1693,1664,3357,37.509121,127.062309
강남구,2355, 삼성역 5~6번 출구 사이,201909,1870,1847,3717,37.509121,127.062309
강남구,2355, 삼성역 5~6번 출구 사이,201910,2309,2304,4613,37.509121,127.062309
강남구,2355, 삼성역 5~6번 출구 사이,201911,1456,1436,2892,37.509121,127.062309
강남구,2355, 삼성역 5~6번 출구 사이,201912,777,780,1557,37.509121,127.062309
강남구,2355, 삼성역 5~6번 출구 사이,202001,716,715,1431,37.509121,127.062309
강남구,2355, 삼성역 5~6번 출구 사이,202002,599,599,1198,37.509121,127.062309
강남구,2355, 삼성역 5~6번 출구 사이,202003,1023,1020,2043,37.509121,127.062309
강남구,2355, 삼성역 5~6번 출구 사이,202004,1276,1260,2536,37.509121,127.062309
강남구,2355, 삼성역 5~6번 출구 사이,202005,1603,1585,3188,37.509121,127.062309
강남구,2355, 삼성역 5~6번 출구 사이,202006,1694,1680,3374,37.509121,127.062309
강남구,2356, 강남구청,201901,158,145,303,37.51807,127.047119
강남구,2356, 강남구청,201902,140,118,258,37.51807,127.047119
강남구,2356, 강남구청,201903,344,293,637,37.51807,127.047119
강남구,2356, 강남구청,201904,635,505,1140,37.51807,127.047119
강남구,2356, 강남구청,201905,871,624,1495,37.51807,127.047119
강남구,2356, 강남구청,201906,873,608,1481,37.51807,127.047119
강남구,2356, 강남구청,201907,714,509,1223,37.51807,127.047119
강남구,2356, 강남구청,201908,766,546,1312,37.51807,127.047119
강남구,2356, 강남구청,201909,704,484,1188,37.51807,127.047119
강남구,2356, 강남구청,201910,700,539,1239,37.51807,127.047119
강남구,2356, 강남구청,201911,416,343,759,37.51807,127.047119
강남구,2356, 강남구청,201912,253,177,430,37.51807,127.047119
강남구,2356, 강남구청,202001,214,143,357,37.51807,127.047119
강남구,2356, 강남구청,202002,204,171,375,37.51807,127.047119
강남구,2356, 강남구청,202003,417,314,731,37.51807,127.047119
강남구,2356, 강남구청,202004,723,566,1289,37.51807,127.047119
강남구,2356, 강남구청,202005,640,478,1118,37.51807,127.047119
강남구,2356, 강남구청,202006,773,595,1368,37.51807,127.047119
강남구,2357, 르네상스호텔사거리 역삼지하보도 3번출구 앞 (더 오번 빌딩 명동칼국수 앞),201901,186,95,281,37.501949,127.04277
강남구,2357, 르네상스호텔사거리 역삼지하보도 3번출구 앞 (더 오번 빌딩 명동칼국수 앞),201902,194,88,282,37.501949,127.04277
강남구,2357, 르네상스호텔사거리 역삼지하보도 3번출구 앞 (더 오번 빌딩 명동칼국수 앞),201903,363,195,558,37.501949,127.04277
강남구,2357, 르네상스호텔사거리 역삼지하보도 3번출구 앞 (더 오번 빌딩 명동칼국수 앞),201904,703,378,1081,37.501949,127.04277
강남구,2357, 르네상스호텔사거리 역삼지하보도 3번출구 앞 (더 오번 빌딩 명동칼국수 앞),201905,921,446,1367,37.501949,127.04277
강남구,2357, 르네상스호텔사거리 역삼지하보도 3번출구 앞 (더 오번 빌딩 명동칼국수 앞),201906,871,382,1253,37.501949,127.04277
강남구,2357, 르네상스호텔사거리 역삼지하보도 3번출구 앞 (더 오번 빌딩 명동칼국수 앞),201907,1035,565,1600,37.501949,127.04277
강남구,2357, 르네상스호텔사거리 역삼지하보도 3번출구 앞 (더 오번 빌딩 명동칼국수 앞),201908,718,405,1123,37.501949,127.04277
강남구,2357, 르네상스호텔사거리 역삼지하보도 3번출구 앞 (더 오번 빌딩 명동칼국수 앞),201909,711,360,1071,37.501949,127.04277
강남구,2357, 르네상스호텔사거리 역삼지하보도 3번출구 앞 (더 오번 빌딩 명동칼국수 앞),201910,847,446,1293,37.501949,127.04277
강남구,2357, 르네상스호텔사거리 역삼지하보도 3번출구 앞 (더 오번 빌딩 명동칼국수 앞),201911,616,328,944,37.501949,127.04277
강남구,2357, 르네상스호텔사거리 역삼지하보도 3번출구 앞 (더 오번 빌딩 명동칼국수 앞),201912,401,180,581,37.501949,127.04277
강남구,2357, 르네상스호텔사거리 역삼지하보도 3번출구 앞 (더 오번 빌딩 명동칼국수 앞),202001,382,180,562,37.501949,127.04277
강남구,2357, 르네상스호텔사거리 역삼지하보도 3번출구 앞 (더 오번 빌딩 명동칼국수 앞),202002,235,147,382,37.501949,127.04277
강남구,2357, 르네상스호텔사거리 역삼지하보도 3번출구 앞 (더 오번 빌딩 명동칼국수 앞),202003,483,221,704,37.501949,127.04277
강남구,2357, 르네상스호텔사거리 역삼지하보도 3번출구 앞 (더 오번 빌딩 명동칼국수 앞),202004,265,263,528,37.501949,127.04277
강남구,2357, 르네상스호텔사거리 역삼지하보도 3번출구 앞 (더 오번 빌딩 명동칼국수 앞),202005,415,403,818,37.501949,127.04277
강남구,2357, 르네상스호텔사거리 역삼지하보도 3번출구 앞 (더 오번 빌딩 명동칼국수 앞),202006,309,281,590,37.501949,127.04277
강남구,2358, 구룡초사거리 (현대아파트10동 앞 ),201901,92,86,178,37.481384,127.053917
강남구,2358, 구룡초사거리 (현대아파트10동 앞 ),201902,78,69,147,37.481384,127.053917
강남구,2358, 구룡초사거리 (현대아파트10동 앞 ),201903,169,144,313,37.481384,127.053917
강남구,2358, 구룡초사거리 (현대아파트10동 앞 ),201904,300,232,532,37.481384,127.053917
강남구,2358, 구룡초사거리 (현대아파트10동 앞 ),201905,385,315,700,37.481384,127.053917
강남구,2358, 구룡초사거리 (현대아파트10동 앞 ),201906,497,393,890,37.481384,127.053917
강남구,2358, 구룡초사거리 (현대아파트10동 앞 ),201907,464,407,871,37.481384,127.053917
강남구,2358, 구룡초사거리 (현대아파트10동 앞 ),201908,439,348,787,37.481384,127.053917
강남구,2358, 구룡초사거리 (현대아파트10동 앞 ),201909,450,323,773,37.481384,127.053917
강남구,2358, 구룡초사거리 (현대아파트10동 앞 ),201910,518,392,910,37.481384,127.053917
강남구,2358, 구룡초사거리 (현대아파트10동 앞 ),201911,299,241,540,37.481384,127.053917
강남구,2358, 구룡초사거리 (현대아파트10동 앞 ),201912,151,128,279,37.481384,127.053917
강남구,2358, 구룡초사거리 (현대아파트10동 앞 ),202001,177,159,336,37.481384,127.053917
강남구,2358, 구룡초사거리 (현대아파트10동 앞 ),202002,159,150,309,37.481384,127.053917
강남구,2358, 구룡초사거리 (현대아파트10동 앞 ),202003,215,196,411,37.481384,127.053917
강남구,2358, 구룡초사거리 (현대아파트10동 앞 ),202004,193,194,387,37.481384,127.053917
강남구,2358, 구룡초사거리 (현대아파트10동 앞 ),202005,237,234,471,37.481384,127.053917
강남구,2358, 구룡초사거리 (현대아파트10동 앞 ),202006,249,252,501,37.481384,127.053917
강남구,2359," 국립국악중,고교 정문 맞은편",201901,121,163,284,37.475605,127.050377
강남구,2359," 국립국악중,고교 정문 맞은편",201902,99,143,242,37.475605,127.050377
강남구,2359," 국립국악중,고교 정문 맞은편",201903,296,329,625,37.475605,127.050377
강남구,2359," 국립국악중,고교 정문 맞은편",201904,446,574,1020,37.475605,127.050377
강남구,2359," 국립국악중,고교 정문 맞은편",201905,759,948,1707,37.475605,127.050377
강남구,2359," 국립국악중,고교 정문 맞은편",201906,874,1154,2028,37.475605,127.050377
강남구,2359," 국립국악중,고교 정문 맞은편",201907,870,1144,2014,37.475605,127.050377
강남구,2359," 국립국악중,고교 정문 맞은편",201908,874,996,1870,37.475605,127.050377
강남구,2359," 국립국악중,고교 정문 맞은편",201909,818,946,1764,37.475605,127.050377
강남구,2359," 국립국악중,고교 정문 맞은편",201910,1026,1152,2178,37.475605,127.050377
강남구,2359," 국립국악중,고교 정문 맞은편",201911,551,664,1215,37.475605,127.050377
강남구,2359," 국립국악중,고교 정문 맞은편",201912,279,418,697,37.475605,127.050377
강남구,2359," 국립국악중,고교 정문 맞은편",202001,315,443,758,37.475605,127.050377
강남구,2359," 국립국악중,고교 정문 맞은편",202002,300,356,656,37.475605,127.050377
강남구,2359," 국립국악중,고교 정문 맞은편",202003,629,639,1268,37.475605,127.050377
강남구,2359," 국립국악중,고교 정문 맞은편",202004,749,736,1485,37.475605,127.050377
강남구,2359," 국립국악중,고교 정문 맞은편",202005,850,855,1705,37.475605,127.050377
강남구,2359," 국립국악중,고교 정문 맞은편",202006,962,959,1921,37.475605,127.050377
강남구,2360, 도곡1동 주민센터 교차로,201901,254,246,500,37.492809,127.041389
강남구,2360, 도곡1동 주민센터 교차로,201902,226,196,422,37.492809,127.041389
강남구,2360, 도곡1동 주민센터 교차로,201903,486,426,912,37.492809,127.041389
강남구,2360, 도곡1동 주민센터 교차로,201904,812,691,1503,37.492809,127.041389
강남구,2360, 도곡1동 주민센터 교차로,201905,1162,1072,2234,37.492809,127.041389
강남구,2360, 도곡1동 주민센터 교차로,201906,1190,1046,2236,37.492809,127.041389
강남구,2360, 도곡1동 주민센터 교차로,201907,1247,1050,2297,37.492809,127.041389
강남구,2360, 도곡1동 주민센터 교차로,201908,961,769,1730,37.492809,127.041389
강남구,2360, 도곡1동 주민센터 교차로,201909,966,749,1715,37.492809,127.041389
강남구,2360, 도곡1동 주민센터 교차로,201910,1056,832,1888,37.492809,127.041389
강남구,2360, 도곡1동 주민센터 교차로,201911,693,598,1291,37.492809,127.041389
강남구,2360, 도곡1동 주민센터 교차로,201912,460,395,855,37.492809,127.041389
강남구,2360, 도곡1동 주민센터 교차로,202001,387,346,733,37.492809,127.041389
강남구,2360, 도곡1동 주민센터 교차로,202002,245,201,446,37.492809,127.041389
강남구,2360, 도곡1동 주민센터 교차로,202003,524,409,933,37.492809,127.041389
강남구,2360, 도곡1동 주민센터 교차로,202004,470,448,918,37.492809,127.041389
강남구,2360, 도곡1동 주민센터 교차로,202005,485,474,959,37.492809,127.041389
강남구,2360, 도곡1동 주민센터 교차로,202006,543,543,1086,37.492809,127.041389
강남구,2361, 압구정역 교차로,201901,250,180,430,37.526844,127.028259
강남구,2361, 압구정역 교차로,201902,240,207,447,37.526844,127.028259
강남구,2361, 압구정역 교차로,201903,411,372,783,37.526844,127.028259
강남구,2361, 압구정역 교차로,201904,717,666,1383,37.526844,127.028259
강남구,2361, 압구정역 교차로,201905,1247,1115,2362,37.526844,127.028259
강남구,2361, 압구정역 교차로,201906,1235,1118,2353,37.526844,127.028259
강남구,2361, 압구정역 교차로,201907,1011,818,1829,37.526844,127.028259
강남구,2361, 압구정역 교차로,201908,1031,909,1940,37.526844,127.028259
강남구,2361, 압구정역 교차로,201909,1071,952,2023,37.526844,127.028259
강남구,2361, 압구정역 교차로,201910,1602,1480,3082,37.526844,127.028259
강남구,2361, 압구정역 교차로,201911,602,539,1141,37.526844,127.028259
강남구,2361, 압구정역 교차로,201912,266,257,523,37.526844,127.028259
강남구,2361, 압구정역 교차로,202001,304,293,597,37.526844,127.028259
강남구,2361, 압구정역 교차로,202002,301,292,593,37.526844,127.028259
강남구,2361, 압구정역 교차로,202003,784,788,1572,37.526844,127.028259
강남구,2361, 압구정역 교차로,202004,1198,1169,2367,37.526844,127.028259
강남구,2361, 압구정역 교차로,202005,1097,1085,2182,37.526844,127.028259
강남구,2361, 압구정역 교차로,202006,1065,1049,2114,37.526844,127.028259
강남구,2362, 신사동 가로수길 입구,201901,223,204,427,37.517635,127.022453
강남구,2362, 신사동 가로수길 입구,201902,213,242,455,37.517635,127.022453
강남구,2362, 신사동 가로수길 입구,201903,431,413,844,37.517635,127.022453
강남구,2362, 신사동 가로수길 입구,201904,821,780,1601,37.517635,127.022453
강남구,2362, 신사동 가로수길 입구,201905,1226,1214,2440,37.517635,127.022453
강남구,2362, 신사동 가로수길 입구,201906,1239,1178,2417,37.517635,127.022453
강남구,2362, 신사동 가로수길 입구,201907,971,921,1892,37.517635,127.022453
강남구,2362, 신사동 가로수길 입구,201908,1026,981,2007,37.517635,127.022453
강남구,2362, 신사동 가로수길 입구,201909,1123,1042,2165,37.517635,127.022453
강남구,2362, 신사동 가로수길 입구,201910,1526,1542,3068,37.517635,127.022453
강남구,2362, 신사동 가로수길 입구,201911,786,722,1508,37.517635,127.022453
강남구,2362, 신사동 가로수길 입구,201912,438,439,877,37.517635,127.022453
강남구,2362, 신사동 가로수길 입구,202001,438,429,867,37.517635,127.022453
강남구,2362, 신사동 가로수길 입구,202002,409,391,800,37.517635,127.022453
강남구,2362, 신사동 가로수길 입구,202003,779,721,1500,37.517635,127.022453
강남구,2362, 신사동 가로수길 입구,202004,949,869,1818,37.517635,127.022453
강남구,2362, 신사동 가로수길 입구,202005,1069,1057,2126,37.517635,127.022453
강남구,2362, 신사동 가로수길 입구,202006,1186,1115,2301,37.517635,127.022453
강남구,2363, 강남 을지병원 교차로,201901,184,186,370,37.51918,127.027466
강남구,2363, 강남 을지병원 교차로,201902,116,80,196,37.51918,127.027466
강남구,2363, 강남 을지병원 교차로,201903,295,281,576,37.51918,127.027466
강남구,2363, 강남 을지병원 교차로,201904,500,358,858,37.51918,127.027466
강남구,2363, 강남 을지병원 교차로,201905,662,509,1171,37.51918,127.027466
강남구,2363, 강남 을지병원 교차로,201906,673,616,1289,37.51918,127.027466
강남구,2363, 강남 을지병원 교차로,201907,565,512,1077,37.51918,127.027466
강남구,2363, 강남 을지병원 교차로,201908,502,469,971,37.51918,127.027466
강남구,2363, 강남 을지병원 교차로,201909,450,402,852,37.51918,127.027466
강남구,2363, 강남 을지병원 교차로,201910,574,504,1078,37.51918,127.027466
강남구,2363, 강남 을지병원 교차로,201911,343,322,665,37.51918,127.027466
강남구,2363, 강남 을지병원 교차로,201912,207,196,403,37.51918,127.027466
강남구,2363, 강남 을지병원 교차로,202001,188,178,366,37.51918,127.027466
강남구,2363, 강남 을지병원 교차로,202002,184,186,370,37.51918,127.027466
강남구,2363, 강남 을지병원 교차로,202003,324,298,622,37.51918,127.027466
강남구,2363, 강남 을지병원 교차로,202004,373,358,731,37.51918,127.027466
강남구,2363, 강남 을지병원 교차로,202005,398,382,780,37.51918,127.027466
강남구,2363, 강남 을지병원 교차로,202006,458,433,891,37.51918,127.027466
강남구,2364, 도산대로 렉서스 앞,201901,197,215,412,37.52124,127.031898
강남구,2364, 도산대로 렉서스 앞,201902,227,214,441,37.52124,127.031898
강남구,2364, 도산대로 렉서스 앞,201903,425,460,885,37.52124,127.031898
강남구,2364, 도산대로 렉서스 앞,201904,620,585,1205,37.52124,127.031898
강남구,2364, 도산대로 렉서스 앞,201905,789,765,1554,37.52124,127.031898
강남구,2364, 도산대로 렉서스 앞,201906,110,107,217,37.52124,127.031898
강남구,2364, 도산대로 렉서스 앞,201907,602,554,1156,37.52124,127.031898
강남구,2364, 도산대로 렉서스 앞,201908,619,611,1230,37.52124,127.031898
강남구,2364, 도산대로 렉서스 앞,201909,561,560,1121,37.52124,127.031898
강남구,2364, 도산대로 렉서스 앞,201910,734,723,1457,37.52124,127.031898
강남구,2364, 도산대로 렉서스 앞,201911,463,460,923,37.52124,127.031898
강남구,2364, 도산대로 렉서스 앞,201912,259,300,559,37.52124,127.031898
강남구,2364, 도산대로 렉서스 앞,202001,254,261,515,37.52124,127.031898
강남구,2364, 도산대로 렉서스 앞,202002,258,274,532,37.52124,127.031898
강남구,2364, 도산대로 렉서스 앞,202003,343,339,682,37.52124,127.031898
강남구,2364, 도산대로 렉서스 앞,202004,479,479,958,37.52124,127.031898
강남구,2364, 도산대로 렉서스 앞,202005,504,493,997,37.52124,127.031898
강남구,2364, 도산대로 렉서스 앞,202006,625,620,1245,37.52124,127.031898
강남구,2365, K+ 타워 앞,201901,156,340,496,37.5233,127.038475
강남구,2365, K+ 타워 앞,201902,225,290,515,37.5233,127.038475
강남구,2365, K+ 타워 앞,201903,513,672,1185,37.5233,127.038475
강남구,2365, K+ 타워 앞,201904,832,925,1757,37.5233,127.038475
강남구,2365, K+ 타워 앞,201905,1181,1189,2370,37.5233,127.038475
강남구,2365, K+ 타워 앞,201906,1269,1265,2534,37.5233,127.038475
강남구,2365, K+ 타워 앞,201907,1224,1263,2487,37.5233,127.038475
강남구,2365, K+ 타워 앞,201908,1218,1245,2463,37.5233,127.038475
강남구,2365, K+ 타워 앞,201909,1198,1219,2417,37.5233,127.038475
강남구,2365, K+ 타워 앞,201910,1161,1189,2350,37.5233,127.038475
강남구,2365, K+ 타워 앞,201911,721,908,1629,37.5233,127.038475
강남구,2365, K+ 타워 앞,201912,448,528,976,37.5233,127.038475
강남구,2365, K+ 타워 앞,202001,403,435,838,37.5233,127.038475
강남구,2365, K+ 타워 앞,202002,351,368,719,37.5233,127.038475
강남구,2365, K+ 타워 앞,202003,824,852,1676,37.5233,127.038475
강남구,2365, K+ 타워 앞,202004,1097,1076,2173,37.5233,127.038475
강남구,2365, K+ 타워 앞,202005,1236,1237,2473,37.5233,127.038475
강남구,2365, K+ 타워 앞,202006,1238,1227,2465,37.5233,127.038475
강남구,2368, 도곡동 경남아파트 건너편,201901,124,100,224,37.489342,127.041298
강남구,2368, 도곡동 경남아파트 건너편,201902,152,94,246,37.489342,127.041298
강남구,2368, 도곡동 경남아파트 건너편,201903,243,193,436,37.489342,127.041298
강남구,2368, 도곡동 경남아파트 건너편,201904,370,272,642,37.489342,127.041298
강남구,2368, 도곡동 경남아파트 건너편,201905,505,392,897,37.489342,127.041298
강남구,2368, 도곡동 경남아파트 건너편,201906,533,400,933,37.489342,127.041298
강남구,2368, 도곡동 경남아파트 건너편,201907,591,408,999,37.489342,127.041298
강남구,2368, 도곡동 경남아파트 건너편,201908,507,367,874,37.489342,127.041298
강남구,2368, 도곡동 경남아파트 건너편,201909,447,344,791,37.489342,127.041298
강남구,2368, 도곡동 경남아파트 건너편,201910,549,386,935,37.489342,127.041298
강남구,2368, 도곡동 경남아파트 건너편,201911,366,243,609,37.489342,127.041298
강남구,2368, 도곡동 경남아파트 건너편,201912,138,140,278,37.489342,127.041298
강남구,2368, 도곡동 경남아파트 건너편,202001,142,112,254,37.489342,127.041298
강남구,2368, 도곡동 경남아파트 건너편,202002,111,100,211,37.489342,127.041298
강남구,2368, 도곡동 경남아파트 건너편,202003,227,204,431,37.489342,127.041298
강남구,2368, 도곡동 경남아파트 건너편,202004,267,264,531,37.489342,127.041298
강남구,2368, 도곡동 경남아파트 건너편,202005,265,256,521,37.489342,127.041298
강남구,2368, 도곡동 경남아파트 건너편,202006,254,252,506,37.489342,127.041298
강남구,2369, KT선릉타워,201901,302,321,623,37.505428,127.052872
강남구,2369, KT선릉타워,201902,246,228,474,37.505428,127.052872
강남구,2369, KT선릉타워,201903,548,526,1074,37.505428,127.052872
강남구,2369, KT선릉타워,201904,940,836,1776,37.505428,127.052872
강남구,2369, KT선릉타워,201905,1172,1092,2264,37.505428,127.052872
강남구,2369, KT선릉타워,201906,1140,1137,2277,37.505428,127.052872
강남구,2369, KT선릉타워,201907,1078,1076,2154,37.505428,127.052872
강남구,2369, KT선릉타워,201908,896,889,1785,37.505428,127.052872
강남구,2369, KT선릉타워,201909,1034,1029,2063,37.505428,127.052872
강남구,2369, KT선릉타워,201910,1257,1246,2503,37.505428,127.052872
강남구,2369, KT선릉타워,201911,906,899,1805,37.505428,127.052872
강남구,2369, KT선릉타워,201912,457,434,891,37.505428,127.052872
강남구,2369, KT선릉타워,202001,430,506,936,37.505428,127.052872
강남구,2369, KT선릉타워,202002,312,332,644,37.505428,127.052872
강남구,2369, KT선릉타워,202003,627,615,1242,37.505428,127.052872
강남구,2369, KT선릉타워,202004,764,747,1511,37.505428,127.052872
강남구,2369, KT선릉타워,202005,887,873,1760,37.505428,127.052872
강남구,2369, KT선릉타워,202006,1105,1095,2200,37.505428,127.052872
강남구,2370, 한티역 3번출구,201901,268,199,467,37.496552,127.054298
강남구,2370, 한티역 3번출구,201902,251,200,451,37.496552,127.054298
강남구,2370, 한티역 3번출구,201903,527,511,1038,37.496552,127.054298
강남구,2370, 한티역 3번출구,201904,769,717,1486,37.496552,127.054298
강남구,2370, 한티역 3번출구,201905,1300,1219,2519,37.496552,127.054298
강남구,2370, 한티역 3번출구,201906,1296,1231,2527,37.496552,127.054298
강남구,2370, 한티역 3번출구,201907,1185,1127,2312,37.496552,127.054298
강남구,2370, 한티역 3번출구,201908,1030,981,2011,37.496552,127.054298
강남구,2370, 한티역 3번출구,201909,1106,1011,2117,37.496552,127.054298
강남구,2370, 한티역 3번출구,201910,1228,1138,2366,37.496552,127.054298
강남구,2370, 한티역 3번출구,201911,820,775,1595,37.496552,127.054298
강남구,2370, 한티역 3번출구,201912,390,375,765,37.496552,127.054298
강남구,2370, 한티역 3번출구,202001,381,384,765,37.496552,127.054298
강남구,2370, 한티역 3번출구,202002,337,334,671,37.496552,127.054298
강남구,2370, 한티역 3번출구,202003,741,743,1484,37.496552,127.054298
강남구,2370, 한티역 3번출구,202004,890,878,1768,37.496552,127.054298
강남구,2370, 한티역 3번출구,202005,903,885,1788,37.496552,127.054298
강남구,2370, 한티역 3번출구,202006,672,653,1325,37.496552,127.054298
강남구,2371, 한국우편사업진흥원,201901,147,55,202,37.514748,127.035133
강남구,2371, 한국우편사업진흥원,201902,130,45,175,37.514748,127.035133
강남구,2371, 한국우편사업진흥원,201903,294,109,403,37.514748,127.035133
강남구,2371, 한국우편사업진흥원,201904,476,147,623,37.514748,127.035133
강남구,2371, 한국우편사업진흥원,201905,640,215,855,37.514748,127.035133
강남구,2371, 한국우편사업진흥원,201906,632,250,882,37.514748,127.035133
강남구,2371, 한국우편사업진흥원,201907,597,186,783,37.514748,127.035133
강남구,2371, 한국우편사업진흥원,201908,561,188,749,37.514748,127.035133
강남구,2371, 한국우편사업진흥원,201909,567,211,778,37.514748,127.035133
강남구,2371, 한국우편사업진흥원,201910,704,215,919,37.514748,127.035133
강남구,2371, 한국우편사업진흥원,201911,505,160,665,37.514748,127.035133
강남구,2371, 한국우편사업진흥원,201912,232,102,334,37.514748,127.035133
강남구,2371, 한국우편사업진흥원,202001,223,73,296,37.514748,127.035133
강남구,2371, 한국우편사업진흥원,202002,191,77,268,37.514748,127.035133
강남구,2371, 한국우편사업진흥원,202003,372,129,501,37.514748,127.035133
강남구,2371, 한국우편사업진흥원,202004,341,164,505,37.514748,127.035133
강남구,2371, 한국우편사업진흥원,202005,191,136,327,37.514748,127.035133
강남구,2371, 한국우편사업진흥원,202006,336,172,508,37.514748,127.035133
강남구,2372, 대치역 사거리,201901,281,310,591,37.494499,127.063797
강남구,2372, 대치역 사거리,201902,271,304,575,37.494499,127.063797
강남구,2372, 대치역 사거리,201903,527,717,1244,37.494499,127.063797
강남구,2372, 대치역 사거리,201904,890,1027,1917,37.494499,127.063797
강남구,2372, 대치역 사거리,201905,1555,1616,3171,37.494499,127.063797
강남구,2372, 대치역 사거리,201906,1601,1622,3223,37.494499,127.063797
강남구,2372, 대치역 사거리,201907,1623,1621,3244,37.494499,127.063797
강남구,2372, 대치역 사거리,201908,1516,1550,3066,37.494499,127.063797
강남구,2372, 대치역 사거리,201909,1503,1545,3048,37.494499,127.063797
강남구,2372, 대치역 사거리,201910,1662,1694,3356,37.494499,127.063797
강남구,2372, 대치역 사거리,201911,1002,1132,2134,37.494499,127.063797
강남구,2372, 대치역 사거리,201912,540,645,1185,37.494499,127.063797
강남구,2372, 대치역 사거리,202001,440,532,972,37.494499,127.063797
강남구,2372, 대치역 사거리,202002,440,515,955,37.494499,127.063797
강남구,2372, 대치역 사거리,202003,1393,1369,2762,37.494499,127.063797
강남구,2372, 대치역 사거리,202004,1516,1469,2985,37.494499,127.063797
강남구,2372, 대치역 사거리,202005,1770,1755,3525,37.494499,127.063797
강남구,2372, 대치역 사거리,202006,1479,1471,2950,37.494499,127.063797
강남구,2373, 개포동역 사거리,201901,171,141,312,37.489277,127.065575
강남구,2373, 개포동역 사거리,201902,170,168,338,37.489277,127.065575
강남구,2373, 개포동역 사거리,201903,387,377,764,37.489277,127.065575
강남구,2373, 개포동역 사거리,201904,808,790,1598,37.489277,127.065575
강남구,2373, 개포동역 사거리,201905,1073,1054,2127,37.489277,127.065575
강남구,2373, 개포동역 사거리,201906,1162,1171,2333,37.489277,127.065575
강남구,2373, 개포동역 사거리,201907,1108,1103,2211,37.489277,127.065575
강남구,2373, 개포동역 사거리,201908,1079,1074,2153,37.489277,127.065575
강남구,2373, 개포동역 사거리,201909,1135,1092,2227,37.489277,127.065575
강남구,2373, 개포동역 사거리,201910,1157,1138,2295,37.489277,127.065575
강남구,2373, 개포동역 사거리,201911,684,657,1341,37.489277,127.065575
강남구,2373, 개포동역 사거리,201912,342,329,671,37.489277,127.065575
강남구,2373, 개포동역 사거리,202001,367,389,756,37.489277,127.065575
강남구,2373, 개포동역 사거리,202002,473,435,908,37.489277,127.065575
강남구,2373, 개포동역 사거리,202003,1292,1274,2566,37.489277,127.065575
강남구,2373, 개포동역 사거리,202004,1253,1201,2454,37.489277,127.065575
강남구,2373, 개포동역 사거리,202005,1443,1394,2837,37.489277,127.065575
강남구,2373, 개포동역 사거리,202006,1540,1395,2935,37.489277,127.065575
강남구,2375, 수서역 1번출구 앞,201901,90,119,209,37.48735,127.100998
강남구,2375, 수서역 1번출구 앞,201902,151,145,296,37.48735,127.100998
강남구,2375, 수서역 1번출구 앞,201903,248,266,514,37.48735,127.100998
강남구,2375, 수서역 1번출구 앞,201904,446,459,905,37.48735,127.100998
강남구,2375, 수서역 1번출구 앞,201905,637,636,1273,37.48735,127.100998
강남구,2375, 수서역 1번출구 앞,201906,677,677,1354,37.48735,127.100998
강남구,2375, 수서역 1번출구 앞,201907,762,728,1490,37.48735,127.100998
강남구,2375, 수서역 1번출구 앞,201908,686,680,1366,37.48735,127.100998
강남구,2375, 수서역 1번출구 앞,201909,751,745,1496,37.48735,127.100998
강남구,2375, 수서역 1번출구 앞,201910,786,787,1573,37.48735,127.100998
강남구,2375, 수서역 1번출구 앞,201911,548,541,1089,37.48735,127.100998
강남구,2375, 수서역 1번출구 앞,201912,268,272,540,37.48735,127.100998
강남구,2375, 수서역 1번출구 앞,202001,235,253,488,37.48735,127.100998
강남구,2375, 수서역 1번출구 앞,202002,275,282,557,37.48735,127.100998
강남구,2375, 수서역 1번출구 앞,202003,672,659,1331,37.48735,127.100998
강남구,2375, 수서역 1번출구 앞,202004,895,888,1783,37.48735,127.100998
강남구,2375, 수서역 1번출구 앞,202005,1119,1122,2241,37.48735,127.100998
강남구,2375, 수서역 1번출구 앞,202006,1110,1117,2227,37.48735,127.100998
강남구,2376, 수서역 6번출구 앞,201901,72,106,178,37.486778,127.100517
강남구,2376, 수서역 6번출구 앞,201902,95,86,181,37.486778,127.100517
강남구,2376, 수서역 6번출구 앞,201903,143,155,298,37.486778,127.100517
강남구,2376, 수서역 6번출구 앞,201904,201,197,398,37.486778,127.100517
강남구,2376, 수서역 6번출구 앞,201905,239,236,475,37.486778,127.100517
강남구,2376, 수서역 6번출구 앞,201906,341,336,677,37.486778,127.100517
강남구,2376, 수서역 6번출구 앞,201907,421,369,790,37.486778,127.100517
강남구,2376, 수서역 6번출구 앞,201908,307,281,588,37.486778,127.100517
강남구,2376, 수서역 6번출구 앞,201909,369,284,653,37.486778,127.100517
강남구,2376, 수서역 6번출구 앞,201910,259,258,517,37.486778,127.100517
강남구,2376, 수서역 6번출구 앞,201911,243,213,456,37.486778,127.100517
강남구,2376, 수서역 6번출구 앞,201912,112,97,209,37.486778,127.100517
강남구,2376, 수서역 6번출구 앞,202001,101,103,204,37.486778,127.100517
강남구,2376, 수서역 6번출구 앞,202002,93,91,184,37.486778,127.100517
강남구,2376, 수서역 6번출구 앞,202003,240,239,479,37.486778,127.100517
강남구,2376, 수서역 6번출구 앞,202004,260,257,517,37.486778,127.100517
강남구,2376, 수서역 6번출구 앞,202005,193,199,392,37.486778,127.100517
강남구,2376, 수서역 6번출구 앞,202006,24,27,51,37.486778,127.100517
강남구,2377, 수서역 5번출구 뒤,201901,386,379,765,37.486835,127.102753
강남구,2377, 수서역 5번출구 뒤,201902,415,418,833,37.486835,127.102753
강남구,2377, 수서역 5번출구 뒤,201903,883,896,1779,37.486835,127.102753
강남구,2377, 수서역 5번출구 뒤,201904,1457,1462,2919,37.486835,127.102753
강남구,2377, 수서역 5번출구 뒤,201905,2330,2349,4679,37.486835,127.102753
강남구,2377, 수서역 5번출구 뒤,201906,2569,2595,5164,37.486835,127.102753
강남구,2377, 수서역 5번출구 뒤,201907,2270,2326,4596,37.486835,127.102753
강남구,2377, 수서역 5번출구 뒤,201908,2222,2246,4468,37.486835,127.102753
강남구,2377, 수서역 5번출구 뒤,201909,2362,2456,4818,37.486835,127.102753
강남구,2377, 수서역 5번출구 뒤,201910,2897,2913,5810,37.486835,127.102753
강남구,2377, 수서역 5번출구 뒤,201911,1725,1744,3469,37.486835,127.102753
강남구,2377, 수서역 5번출구 뒤,201912,863,858,1721,37.486835,127.102753
강남구,2377, 수서역 5번출구 뒤,202001,775,794,1569,37.486835,127.102753
강남구,2377, 수서역 5번출구 뒤,202002,709,723,1432,37.486835,127.102753
강남구,2377, 수서역 5번출구 뒤,202003,1170,1167,2337,37.486835,127.102753
강남구,2377, 수서역 5번출구 뒤,202004,2075,2066,4141,37.486835,127.102753
강남구,2377, 수서역 5번출구 뒤,202005,2303,2298,4601,37.486835,127.102753
강남구,2377, 수서역 5번출구 뒤,202006,2820,2841,5661,37.486835,127.102753
강남구,2380, 삼성동베이직하우스앞,201901,314,250,564,37.511696,127.049347
강남구,2380, 삼성동베이직하우스앞,201902,234,186,420,37.511696,127.049347
강남구,2380, 삼성동베이직하우스앞,201903,426,390,816,37.511696,127.049347
강남구,2380, 삼성동베이직하우스앞,201904,822,675,1497,37.511696,127.049347
강남구,2380, 삼성동베이직하우스앞,201905,1008,828,1836,37.511696,127.049347
강남구,2380, 삼성동베이직하우스앞,201906,528,525,1053,37.511696,127.049347
강남구,2380, 삼성동베이직하우스앞,201907,842,669,1511,37.511696,127.049347
강남구,2380, 삼성동베이직하우스앞,201908,829,611,1440,37.511696,127.049347
강남구,2380, 삼성동베이직하우스앞,201909,728,599,1327,37.511696,127.049347
강남구,2380, 삼성동베이직하우스앞,201910,789,736,1525,37.511696,127.049347
강남구,2380, 삼성동베이직하우스앞,201911,559,502,1061,37.511696,127.049347
강남구,2380, 삼성동베이직하우스앞,201912,281,239,520,37.511696,127.049347
강남구,2380, 삼성동베이직하우스앞,202001,279,205,484,37.511696,127.049347
강남구,2380, 삼성동베이직하우스앞,202002,215,161,376,37.511696,127.049347
강남구,2380, 삼성동베이직하우스앞,202003,469,402,871,37.511696,127.049347
강남구,2380, 삼성동베이직하우스앞,202004,541,456,997,37.511696,127.049347
강남구,2380, 삼성동베이직하우스앞,202005,527,493,1020,37.511696,127.049347
강남구,2380, 삼성동베이직하우스앞,202006,557,513,1070,37.511696,127.049347
강남구,2381, 언주역 6번출구앞,201901,199,192,391,37.506367,127.034523
강남구,2381, 언주역 6번출구앞,201902,193,167,360,37.506367,127.034523
강남구,2381, 언주역 6번출구앞,201903,393,386,779,37.506367,127.034523
강남구,2381, 언주역 6번출구앞,201904,638,587,1225,37.506367,127.034523
강남구,2381, 언주역 6번출구앞,201905,754,687,1441,37.506367,127.034523
강남구,2381, 언주역 6번출구앞,201906,744,707,1451,37.506367,127.034523
강남구,2381, 언주역 6번출구앞,201907,619,570,1189,37.506367,127.034523
강남구,2381, 언주역 6번출구앞,201908,635,607,1242,37.506367,127.034523
강남구,2381, 언주역 6번출구앞,201909,538,531,1069,37.506367,127.034523
강남구,2381, 언주역 6번출구앞,201910,705,691,1396,37.506367,127.034523
강남구,2381, 언주역 6번출구앞,201911,480,450,930,37.506367,127.034523
강남구,2381, 언주역 6번출구앞,201912,254,267,521,37.506367,127.034523
강남구,2381, 언주역 6번출구앞,202001,251,246,497,37.506367,127.034523
강남구,2381, 언주역 6번출구앞,202002,182,185,367,37.506367,127.034523
강남구,2381, 언주역 6번출구앞,202003,419,396,815,37.506367,127.034523
강남구,2381, 언주역 6번출구앞,202004,483,475,958,37.506367,127.034523
강남구,2381, 언주역 6번출구앞,202005,529,530,1059,37.506367,127.034523
강남구,2381, 언주역 6번출구앞,202006,533,524,1057,37.506367,127.034523
강남구,2382, 역삼동 sk뷰 501동앞,201901,112,132,244,37.501343,127.050468
강남구,2382, 역삼동 sk뷰 501동앞,201902,121,143,264,37.501343,127.050468
강남구,2382, 역삼동 sk뷰 501동앞,201903,236,230,466,37.501343,127.050468
강남구,2382, 역삼동 sk뷰 501동앞,201904,338,324,662,37.501343,127.050468
강남구,2382, 역삼동 sk뷰 501동앞,201905,526,518,1044,37.501343,127.050468
강남구,2382, 역삼동 sk뷰 501동앞,201906,413,410,823,37.501343,127.050468
강남구,2382, 역삼동 sk뷰 501동앞,201907,377,378,755,37.501343,127.050468
강남구,2382, 역삼동 sk뷰 501동앞,201908,382,384,766,37.501343,127.050468
강남구,2382, 역삼동 sk뷰 501동앞,201909,385,384,769,37.501343,127.050468
강남구,2382, 역삼동 sk뷰 501동앞,201910,492,489,981,37.501343,127.050468
강남구,2382, 역삼동 sk뷰 501동앞,201911,295,302,597,37.501343,127.050468
강남구,2382, 역삼동 sk뷰 501동앞,201912,142,141,283,37.501343,127.050468
강남구,2382, 역삼동 sk뷰 501동앞,202001,135,136,271,37.501343,127.050468
강남구,2382, 역삼동 sk뷰 501동앞,202002,81,81,162,37.501343,127.050468
강남구,2382, 역삼동 sk뷰 501동앞,202003,202,200,402,37.501343,127.050468
강남구,2382, 역삼동 sk뷰 501동앞,202004,312,318,630,37.501343,127.050468
강남구,2382, 역삼동 sk뷰 501동앞,202005,294,287,581,37.501343,127.050468
강남구,2382, 역삼동 sk뷰 501동앞,202006,298,299,597,37.501343,127.050468
강남구,2383, 보금자리정원,201901,28,21,49,37.466328,127.094887
강남구,2383, 보금자리정원,201902,43,42,85,37.466328,127.094887
강남구,2383, 보금자리정원,201903,95,91,186,37.466328,127.094887
강남구,2383, 보금자리정원,201904,158,159,317,37.466328,127.094887
강남구,2383, 보금자리정원,201905,275,277,552,37.466328,127.094887
강남구,2383, 보금자리정원,201906,277,280,557,37.466328,127.094887
강남구,2383, 보금자리정원,201907,213,211,424,37.466328,127.094887
강남구,2383, 보금자리정원,201908,228,225,453,37.466328,127.094887
강남구,2383, 보금자리정원,201909,273,302,575,37.466328,127.094887
강남구,2383, 보금자리정원,201910,287,276,563,37.466328,127.094887
강남구,2383, 보금자리정원,201911,181,196,377,37.466328,127.094887
강남구,2383, 보금자리정원,201912,89,108,197,37.466328,127.094887
강남구,2383, 보금자리정원,202001,75,68,143,37.466328,127.094887
강남구,2383, 보금자리정원,202002,76,75,151,37.466328,127.094887
강남구,2383, 보금자리정원,202003,190,174,364,37.466328,127.094887
강남구,2383, 보금자리정원,202004,275,267,542,37.466328,127.094887
강남구,2383, 보금자리정원,202005,249,251,500,37.466328,127.094887
강남구,2383, 보금자리정원,202006,316,311,627,37.466328,127.094887
강남구,2384, 자곡사거리,201901,319,344,663,37.476028,127.105942
강남구,2384, 자곡사거리,201902,343,365,708,37.476028,127.105942
강남구,2384, 자곡사거리,201903,768,761,1529,37.476028,127.105942
강남구,2384, 자곡사거리,201904,1183,1259,2442,37.476028,127.105942
강남구,2384, 자곡사거리,201905,1968,2037,4005,37.476028,127.105942
강남구,2384, 자곡사거리,201906,2038,2096,4134,37.476028,127.105942
강남구,2384, 자곡사거리,201907,1715,1881,3596,37.476028,127.105942
강남구,2384, 자곡사거리,201908,1683,1798,3481,37.476028,127.105942
강남구,2384, 자곡사거리,201909,1815,1901,3716,37.476028,127.105942
강남구,2384, 자곡사거리,201910,2214,2288,4502,37.476028,127.105942
강남구,2384, 자곡사거리,201911,1299,1290,2589,37.476028,127.105942
강남구,2384, 자곡사거리,201912,624,599,1223,37.476028,127.105942
강남구,2384, 자곡사거리,202001,523,537,1060,37.476028,127.105942
강남구,2384, 자곡사거리,202002,591,597,1188,37.476028,127.105942
강남구,2384, 자곡사거리,202003,1156,1150,2306,37.476028,127.105942
강남구,2384, 자곡사거리,202004,1645,1645,3290,37.476028,127.105942
강남구,2384, 자곡사거리,202005,2054,2083,4137,37.476028,127.105942
강남구,2384, 자곡사거리,202006,2073,2115,4188,37.476028,127.105942
강남구,2385, 학동역,201901,279,311,590,37.51395,127.030151
강남구,2385, 학동역,201902,232,255,487,37.51395,127.030151
강남구,2385, 학동역,201903,481,492,973,37.51395,127.030151
강남구,2385, 학동역,201904,823,758,1581,37.51395,127.030151
강남구,2385, 학동역,201905,1130,1019,2149,37.51395,127.030151
강남구,2385, 학동역,201906,1169,1068,2237,37.51395,127.030151
강남구,2385, 학동역,201907,1152,1045,2197,37.51395,127.030151
강남구,2385, 학동역,201908,1114,1055,2169,37.51395,127.030151
강남구,2385, 학동역,201909,991,911,1902,37.51395,127.030151
강남구,2385, 학동역,201910,1238,1119,2357,37.51395,127.030151
강남구,2385, 학동역,201911,824,703,1527,37.51395,127.030151
강남구,2385, 학동역,201912,406,351,757,37.51395,127.030151
강남구,2385, 학동역,202001,404,366,770,37.51395,127.030151
강남구,2385, 학동역,202002,314,286,600,37.51395,127.030151
강남구,2385, 학동역,202003,549,461,1010,37.51395,127.030151
강남구,2385, 학동역,202004,566,547,1113,37.51395,127.030151
강남구,2385, 학동역,202005,709,685,1394,37.51395,127.030151
강남구,2385, 학동역,202006,761,700,1461,37.51395,127.030151
강남구,2387, 래미안강남힐즈 사거리,201901,270,241,511,37.472454,127.096077
강남구,2387, 래미안강남힐즈 사거리,201902,221,208,429,37.472454,127.096077
강남구,2387, 래미안강남힐즈 사거리,201903,415,413,828,37.472454,127.096077
강남구,2387, 래미안강남힐즈 사거리,201904,627,592,1219,37.472454,127.096077
강남구,2387, 래미안강남힐즈 사거리,201905,1050,1035,2085,37.472454,127.096077
강남구,2387, 래미안강남힐즈 사거리,201906,1290,1282,2572,37.472454,127.096077
강남구,2387, 래미안강남힐즈 사거리,201907,1217,1237,2454,37.472454,127.096077
강남구,2387, 래미안강남힐즈 사거리,201908,1224,1224,2448,37.472454,127.096077
강남구,2387, 래미안강남힐즈 사거리,201909,1222,1214,2436,37.472454,127.096077
강남구,2387, 래미안강남힐즈 사거리,201910,1267,1264,2531,37.472454,127.096077
강남구,2387, 래미안강남힐즈 사거리,201911,755,738,1493,37.472454,127.096077
강남구,2387, 래미안강남힐즈 사거리,201912,409,380,789,37.472454,127.096077
강남구,2387, 래미안강남힐즈 사거리,202001,270,263,533,37.472454,127.096077
강남구,2387, 래미안강남힐즈 사거리,202002,253,243,496,37.472454,127.096077
강남구,2387, 래미안강남힐즈 사거리,202003,519,510,1029,37.472454,127.096077
강남구,2387, 래미안강남힐즈 사거리,202004,808,811,1619,37.472454,127.096077
강남구,2387, 래미안강남힐즈 사거리,202005,861,851,1712,37.472454,127.096077
강남구,2387, 래미안강남힐즈 사거리,202006,973,952,1925,37.472454,127.096077
강남구,2388, 강남구 도시관리공단,201901,102,58,160,37.516785,127.051613
강남구,2388, 강남구 도시관리공단,201902,74,30,104,37.516785,127.051613
강남구,2388, 강남구 도시관리공단,201903,211,110,321,37.516785,127.051613
강남구,2388, 강남구 도시관리공단,201904,397,186,583,37.516785,127.051613
강남구,2388, 강남구 도시관리공단,201905,569,253,822,37.516785,127.051613
강남구,2388, 강남구 도시관리공단,201906,644,286,930,37.516785,127.051613
강남구,2388, 강남구 도시관리공단,201907,524,240,764,37.516785,127.051613
강남구,2388, 강남구 도시관리공단,201908,554,251,805,37.516785,127.051613
강남구,2388, 강남구 도시관리공단,201909,416,246,662,37.516785,127.051613
강남구,2388, 강남구 도시관리공단,201910,325,235,560,37.516785,127.051613
강남구,2388, 강남구 도시관리공단,201911,267,157,424,37.516785,127.051613
강남구,2388, 강남구 도시관리공단,201912,147,104,251,37.516785,127.051613
강남구,2388, 강남구 도시관리공단,202001,153,68,221,37.516785,127.051613
강남구,2388, 강남구 도시관리공단,202002,89,56,145,37.516785,127.051613
강남구,2388, 강남구 도시관리공단,202003,295,146,441,37.516785,127.051613
강남구,2388, 강남구 도시관리공단,202004,402,197,599,37.516785,127.051613
강남구,2388, 강남구 도시관리공단,202005,484,203,687,37.516785,127.051613
강남구,2388, 강남구 도시관리공단,202006,409,211,620,37.516785,127.051613
강남구,2389, 경기여자고등학교 후문 (삼성로3길 입구),201901,48,48,96,37.48616,127.067238
강남구,2389, 경기여자고등학교 후문 (삼성로3길 입구),201902,44,36,80,37.48616,127.067238
강남구,2389, 경기여자고등학교 후문 (삼성로3길 입구),201903,140,100,240,37.48616,127.067238
강남구,2389, 경기여자고등학교 후문 (삼성로3길 입구),201904,198,174,372,37.48616,127.067238
강남구,2389, 경기여자고등학교 후문 (삼성로3길 입구),201905,296,297,593,37.48616,127.067238
강남구,2389, 경기여자고등학교 후문 (삼성로3길 입구),201906,336,316,652,37.48616,127.067238
강남구,2389, 경기여자고등학교 후문 (삼성로3길 입구),201907,345,326,671,37.48616,127.067238
강남구,2389, 경기여자고등학교 후문 (삼성로3길 입구),201908,271,264,535,37.48616,127.067238
강남구,2389, 경기여자고등학교 후문 (삼성로3길 입구),201909,393,319,712,37.48616,127.067238
강남구,2389, 경기여자고등학교 후문 (삼성로3길 입구),201910,457,446,903,37.48616,127.067238
강남구,2389, 경기여자고등학교 후문 (삼성로3길 입구),201911,397,366,763,37.48616,127.067238
강남구,2389, 경기여자고등학교 후문 (삼성로3길 입구),201912,190,162,352,37.48616,127.067238
강남구,2389, 경기여자고등학교 후문 (삼성로3길 입구),202001,194,163,357,37.48616,127.067238
강남구,2389, 경기여자고등학교 후문 (삼성로3길 입구),202002,207,185,392,37.48616,127.067238
강남구,2389, 경기여자고등학교 후문 (삼성로3길 입구),202003,414,399,813,37.48616,127.067238
강남구,2389, 경기여자고등학교 후문 (삼성로3길 입구),202004,512,510,1022,37.48616,127.067238
강남구,2389, 경기여자고등학교 후문 (삼성로3길 입구),202005,511,497,1008,37.48616,127.067238
강남구,2389, 경기여자고등학교 후문 (삼성로3길 입구),202006,625,578,1203,37.48616,127.067238
강남구,2390, 구룡마을 입구 (래미안블레스티지 아파트),201901,11,11,22,37.480881,127.063042
강남구,2390, 구룡마을 입구 (래미안블레스티지 아파트),201902,10,8,18,37.480881,127.063042
강남구,2390, 구룡마을 입구 (래미안블레스티지 아파트),201903,38,34,72,37.480881,127.063042
강남구,2390, 구룡마을 입구 (래미안블레스티지 아파트),201904,92,85,177,37.480881,127.063042
강남구,2390, 구룡마을 입구 (래미안블레스티지 아파트),201905,189,183,372,37.480881,127.063042
강남구,2390, 구룡마을 입구 (래미안블레스티지 아파트),201906,328,339,667,37.480881,127.063042
강남구,2390, 구룡마을 입구 (래미안블레스티지 아파트),201907,439,433,872,37.480881,127.063042
강남구,2390, 구룡마을 입구 (래미안블레스티지 아파트),201908,476,488,964,37.480881,127.063042
강남구,2390, 구룡마을 입구 (래미안블레스티지 아파트),201909,482,463,945,37.480881,127.063042
강남구,2390, 구룡마을 입구 (래미안블레스티지 아파트),201910,559,540,1099,37.480881,127.063042
강남구,2390, 구룡마을 입구 (래미안블레스티지 아파트),201911,259,260,519,37.480881,127.063042
강남구,2390, 구룡마을 입구 (래미안블레스티지 아파트),201912,156,148,304,37.480881,127.063042
강남구,2390, 구룡마을 입구 (래미안블레스티지 아파트),202001,142,130,272,37.480881,127.063042
강남구,2390, 구룡마을 입구 (래미안블레스티지 아파트),202002,105,108,213,37.480881,127.063042
강남구,2390, 구룡마을 입구 (래미안블레스티지 아파트),202003,349,341,690,37.480881,127.063042
강남구,2390, 구룡마을 입구 (래미안블레스티지 아파트),202004,336,337,673,37.480881,127.063042
강남구,2390, 구룡마을 입구 (래미안블레스티지 아파트),202005,377,373,750,37.480881,127.063042
강남구,2390, 구룡마을 입구 (래미안블레스티지 아파트),202006,277,270,547,37.480881,127.063042
강남구,2391, 구룡마을 입구(개포1단지아파트),201901,20,26,46,37.475986,127.059624
강남구,2391, 구룡마을 입구(개포1단지아파트),201902,25,33,58,37.475986,127.059624
강남구,2391, 구룡마을 입구(개포1단지아파트),201903,44,54,98,37.475986,127.059624
강남구,2391, 구룡마을 입구(개포1단지아파트),201904,86,101,187,37.475986,127.059624
강남구,2391, 구룡마을 입구(개포1단지아파트),201905,111,97,208,37.475986,127.059624
강남구,2391, 구룡터널 입구(개포1단지아파트),201906,47,33,80,37.475986,127.059624
강남구,2391, 구룡터널 입구(개포1단지아파트),201907,29,23,52,37.475986,127.059624
강남구,2391, 구룡터널 입구(개포1단지아파트),201908,20,16,36,37.475986,127.059624
강남구,2391, 구룡터널 입구(개포1단지아파트),201909,21,15,36,37.475986,127.059624
강남구,2391, 구룡터널 입구(개포1단지아파트),201910,29,23,52,37.475986,127.059624
강남구,2391, 구룡터널 입구(개포1단지아파트),201911,32,22,54,37.475986,127.059624
강남구,2391, 구룡터널 입구(개포1단지아파트),201912,15,12,27,37.475986,127.059624
강남구,2391, 구룡터널 입구(개포1단지아파트),202001,19,15,34,37.475986,127.059624
강남구,2391, 구룡터널 입구(개포1단지아파트),202002,20,11,31,37.475986,127.059624
강남구,2391, 구룡터널 입구(개포1단지아파트),202003,23,20,43,37.475986,127.059624
강남구,2391, 구룡터널 입구(개포1단지아파트),202004,35,34,69,37.475986,127.059624
강남구,2391, 구룡터널 입구(개포1단지아파트),202005,13,14,27,37.475986,127.059624
강남구,2391, 구룡터널 입구(개포1단지아파트),202006,18,18,36,37.475986,127.059624
강남구,2392, 구룡산 입구 (구룡산 서울둘레길 입구),201901,17,14,31,37.474579,127.05545
강남구,2392, 구룡산 입구 (구룡산 서울둘레길 입구),201902,22,15,37,37.474579,127.05545
강남구,2392, 구룡산 입구 (구룡산 서울둘레길 입구),201903,47,27,74,37.474579,127.05545
강남구,2392, 구룡산 입구 (구룡산 서울둘레길 입구),201904,185,64,249,37.474579,127.05545
강남구,2392, 구룡산 입구 (구룡산 서울둘레길 입구),201905,197,101,298,37.474579,127.05545
강남구,2392, 구룡산 입구 (구룡산 서울둘레길 입구),201906,226,120,346,37.474579,127.05545
강남구,2392, 구룡산 입구 (구룡산 서울둘레길 입구),201907,197,98,295,37.474579,127.05545
강남구,2392, 구룡산 입구 (구룡산 서울둘레길 입구),201908,183,85,268,37.474579,127.05545
강남구,2392, 구룡산 입구 (구룡산 서울둘레길 입구),201909,144,65,209,37.474579,127.05545
강남구,2392, 구룡산 입구 (구룡산 서울둘레길 입구),201910,98,72,170,37.474579,127.05545
강남구,2392, 구룡산 입구 (구룡산 서울둘레길 입구),201911,104,51,155,37.474579,127.05545
강남구,2392, 구룡산 입구 (구룡산 서울둘레길 입구),201912,55,31,86,37.474579,127.05545
강남구,2392, 구룡산 입구 (구룡산 서울둘레길 입구),202001,110,63,173,37.474579,127.05545
강남구,2392, 구룡산 입구 (구룡산 서울둘레길 입구),202002,79,43,122,37.474579,127.05545
강남구,2392, 구룡산 입구 (구룡산 서울둘레길 입구),202003,85,55,140,37.474579,127.05545
강남구,2392, 구룡산 입구 (구룡산 서울둘레길 입구),202004,90,79,169,37.474579,127.05545
강남구,2392, 구룡산 입구 (구룡산 서울둘레길 입구),202005,67,67,134,37.474579,127.05545
강남구,2392, 구룡산 입구 (구룡산 서울둘레길 입구),202006,59,60,119,37.474579,127.05545
강남구,2393, 구룡사 앞 교차로 (보도육교),201905,25,17,42,37.472,127.051338
강남구,2393, 구룡사 앞 교차로 (보도육교),201906,169,95,264,37.472,127.051338
강남구,2393, 구룡사 앞 교차로 (보도육교),201907,134,80,214,37.472,127.051338
강남구,2393, 구룡사 앞 교차로 (보도육교),201908,111,63,174,37.472,127.051338
강남구,2393, 구룡사 앞 교차로 (보도육교),201909,131,79,210,37.472,127.051338
강남구,2393, 구룡사 앞 교차로 (보도육교),201910,137,102,239,37.472,127.051338
강남구,2393, 구룡사 앞 교차로 (보도육교),201911,83,69,152,37.472,127.051338
강남구,2393, 구룡사 앞 교차로 (보도육교),201912,48,40,88,37.472,127.051338
강남구,2393, 구룡사 앞 교차로 (보도육교),202001,54,31,85,37.472,127.051338
강남구,2393, 구룡사 앞 교차로 (보도육교),202002,51,33,84,37.472,127.051338
강남구,2393, 구룡사 앞 교차로 (보도육교),202003,75,61,136,37.472,127.051338
강남구,2393, 구룡사 앞 교차로 (보도육교),202004,63,58,121,37.472,127.051338
강남구,2393, 구룡사 앞 교차로 (보도육교),202005,61,53,114,37.472,127.051338
강남구,2393, 구룡사 앞 교차로 (보도육교),202006,83,77,160,37.472,127.051338
강남구,2394, 래미안강남포레스트 입구 (보도육교),201901,16,16,32,37.479092,127.055397
강남구,2394, 래미안강남포레스트 입구 (보도육교),201902,7,6,13,37.479092,127.055397
강남구,2394, 래미안강남포레스트 입구 (보도육교),201903,13,17,30,37.479092,127.055397
강남구,2394, 래미안강남포레스트 입구 (보도육교),201904,6,13,19,37.479092,127.055397
강남구,2394, 래미안강남포레스트 입구 (보도육교),202004,4,4,8,37.479092,127.055397
강남구,2394, 래미안강남포레스트 입구 (보도육교),202006,5,5,10,37.479092,127.055397
강남구,2395, 개포1단지아파트 입구 (보도육교),201901,23,18,41,37.47929,127.055733
강남구,2395, 개포1단지아파트 입구 (보도육교),201902,10,7,17,37.47929,127.055733
강남구,2395, 개포1단지아파트 입구 (보도육교),201903,17,13,30,37.47929,127.055733
강남구,2395, 개포1단지아파트 입구 (보도육교),201904,64,50,114,37.47929,127.055733
강남구,2395, 개포1단지아파트 입구 (보도육교),201905,143,102,245,37.47929,127.055733
강남구,2395, 개포1단지아파트 입구 (보도육교),201906,133,118,251,37.47929,127.055733
강남구,2395, 개포1단지아파트 입구 (보도육교),201907,83,65,148,37.47929,127.055733
강남구,2395, 개포1단지아파트 입구 (보도육교),201908,89,49,138,37.47929,127.055733
강남구,2395, 개포1단지아파트 입구 (보도육교),201909,117,71,188,37.47929,127.055733
강남구,2395, 개포1단지아파트 입구 (보도육교),201910,172,88,260,37.47929,127.055733
강남구,2395, 개포1단지아파트 입구 (보도육교),201911,78,38,116,37.47929,127.055733
강남구,2395, 개포1단지아파트 입구 (보도육교),201912,17,10,27,37.47929,127.055733
강남구,2395, 개포1단지아파트 입구 (보도육교),202001,29,25,54,37.47929,127.055733
강남구,2395, 개포1단지아파트 입구 (보도육교),202002,25,17,42,37.47929,127.055733
강남구,2395, 개포1단지아파트 입구 (보도육교),202003,28,22,50,37.47929,127.055733
강남구,2395, 개포1단지아파트 입구 (보도육교),202004,14,16,30,37.47929,127.055733
강남구,2395, 개포1단지아파트 입구 (보도육교),202005,12,6,18,37.47929,127.055733
강남구,2395, 개포1단지아파트 입구 (보도육교),202006,18,20,38,37.47929,127.055733
강남구,2396, 영동3교 북단(우성캐릭터 앞 보도),201901,95,97,192,37.485741,127.051048
강남구,2396, 영동3교 북단(우성캐릭터 앞 보도),201902,95,101,196,37.485741,127.051048
강남구,2396, 영동3교 북단(우성캐릭터 앞 보도),201903,268,278,546,37.485741,127.051048
강남구,2396, 영동3교 북단(우성캐릭터 앞 보도),201904,609,607,1216,37.485741,127.051048
강남구,2396, 영동3교 북단(우성캐릭터 앞 보도),201905,776,745,1521,37.485741,127.051048
강남구,2396, 영동3교 북단(우성캐릭터 앞 보도),201906,909,916,1825,37.485741,127.051048
강남구,2396, 영동3교 북단(우성캐릭터 앞 보도),201907,903,883,1786,37.485741,127.051048
강남구,2396, 영동3교 북단(우성캐릭터 앞 보도),201908,823,791,1614,37.485741,127.051048
강남구,2396, 영동3교 북단(우성캐릭터 앞 보도),201909,928,862,1790,37.485741,127.051048
강남구,2396, 영동3교 북단(우성캐릭터 앞 보도),201910,1054,977,2031,37.485741,127.051048
강남구,2396, 영동3교 북단(우성캐릭터 앞 보도),201911,566,532,1098,37.485741,127.051048
강남구,2396, 영동3교 북단(우성캐릭터 앞 보도),201912,253,250,503,37.485741,127.051048
강남구,2396, 영동3교 북단(우성캐릭터 앞 보도),202001,288,257,545,37.485741,127.051048
강남구,2396, 영동3교 북단(우성캐릭터 앞 보도),202002,277,261,538,37.485741,127.051048
강남구,2396, 영동3교 북단(우성캐릭터 앞 보도),202003,905,891,1796,37.485741,127.051048
강남구,2396, 영동3교 북단(우성캐릭터 앞 보도),202004,836,846,1682,37.485741,127.051048
강남구,2396, 영동3교 북단(우성캐릭터 앞 보도),202005,951,943,1894,37.485741,127.051048
강남구,2396, 영동3교 북단(우성캐릭터 앞 보도),202006,725,725,1450,37.485741,127.051048
강남구,2398, 더라움,201901,193,129,322,37.50811,127.039452
강남구,2398, 더라움,201902,179,98,277,37.50811,127.039452
강남구,2398, 더라움,201903,434,291,725,37.50811,127.039452
강남구,2398, 더라움,201904,571,366,937,37.50811,127.039452
강남구,2398, 더라움,201905,815,508,1323,37.50811,127.039452
강남구,2398, 더라움,201906,816,520,1336,37.50811,127.039452
강남구,2398, 더라움,201907,837,497,1334,37.50811,127.039452
강남구,2398, 더라움,201908,722,466,1188,37.50811,127.039452
강남구,2398, 더라움,201909,710,467,1177,37.50811,127.039452
강남구,2398, 더라움,201910,874,528,1402,37.50811,127.039452
강남구,2398, 더라움,201911,592,411,1003,37.50811,127.039452
강남구,2398, 더라움,201912,262,181,443,37.50811,127.039452
강남구,2398, 더라움,202001,249,166,415,37.50811,127.039452
강남구,2398, 더라움,202002,236,139,375,37.50811,127.039452
강남구,2398, 더라움,202003,408,242,650,37.50811,127.039452
강남구,2398, 더라움,202004,484,325,809,37.50811,127.039452
강남구,2398, 더라움,202005,439,330,769,37.50811,127.039452
강남구,2398, 더라움,202006,484,378,862,37.50811,127.039452
강남구,2401, 밀알학교 입구 (삼성서울병원 입구),201901,82,71,153,37.486561,127.082672
강남구,2401, 밀알학교 입구 (삼성서울병원 입구),201902,70,62,132,37.486561,127.082672
강남구,2401, 밀알학교 입구 (삼성서울병원 입구),201903,182,141,323,37.486561,127.082672
강남구,2401, 밀알학교 입구 (삼성서울병원 입구),201904,264,193,457,37.486561,127.082672
강남구,2401, 밀알학교 입구 (삼성서울병원 입구),201905,248,241,489,37.486561,127.082672
강남구,2401, 밀알학교 입구 (삼성서울병원 입구),201906,254,252,506,37.486561,127.082672
강남구,2401, 밀알학교 입구 (삼성서울병원 입구),201907,244,188,432,37.486561,127.082672
강남구,2401, 밀알학교 입구 (삼성서울병원 입구),201908,219,193,412,37.486561,127.082672
강남구,2401, 밀알학교 입구 (삼성서울병원 입구),201909,310,235,545,37.486561,127.082672
강남구,2401, 밀알학교 입구 (삼성서울병원 입구),201910,302,264,566,37.486561,127.082672
강남구,2401, 밀알학교 입구 (삼성서울병원 입구),201911,188,182,370,37.486561,127.082672
강남구,2401, 밀알학교 입구 (삼성서울병원 입구),201912,132,105,237,37.486561,127.082672
강남구,2401, 밀알학교 입구 (삼성서울병원 입구),202001,153,136,289,37.486561,127.082672
강남구,2401, 밀알학교 입구 (삼성서울병원 입구),202002,142,132,274,37.486561,127.082672
강남구,2401, 밀알학교 입구 (삼성서울병원 입구),202003,235,203,438,37.486561,127.082672
강남구,2401, 밀알학교 입구 (삼성서울병원 입구),202004,305,298,603,37.486561,127.082672
강남구,2401, 밀알학교 입구 (삼성서울병원 입구),202005,295,276,571,37.486561,127.082672
강남구,2401, 밀알학교 입구 (삼성서울병원 입구),202006,261,257,518,37.486561,127.082672
강남구,2403, 공무원연금매점 교차로 (개포주공9단지 입구),201901,20,11,31,37.48872,127.074539
강남구,2403, 공무원연금매점 교차로 (개포주공9단지 입구),201902,26,8,34,37.48872,127.074539
강남구,2403, 공무원연금매점 교차로 (개포주공9단지 입구),201903,58,36,94,37.48872,127.074539
강남구,2403, 공무원연금매점 교차로 (개포주공9단지 입구),201904,80,35,115,37.48872,127.074539
강남구,2403, 공무원연금매점 교차로 (개포주공9단지 입구),201905,132,102,234,37.48872,127.074539
강남구,2403, 공무원연금매점 교차로 (개포주공9단지 입구),201906,143,131,274,37.48872,127.074539
강남구,2403, 공무원연금매점 교차로 (개포주공9단지 입구),201907,157,139,296,37.48872,127.074539
강남구,2403, 공무원연금매점 교차로 (개포주공9단지 입구),201908,169,137,306,37.48872,127.074539
강남구,2403, 공무원연금매점 교차로 (개포주공9단지 입구),201909,161,128,289,37.48872,127.074539
강남구,2403, 공무원연금매점 교차로 (개포주공9단지 입구),201910,197,164,361,37.48872,127.074539
강남구,2403, 공무원연금매점 교차로 (개포주공9단지 입구),201911,114,129,243,37.48872,127.074539
강남구,2403, 공무원연금매점 교차로 (개포주공9단지 입구),201912,53,57,110,37.48872,127.074539
강남구,2403, 공무원연금매점 교차로 (개포주공9단지 입구),202001,75,48,123,37.48872,127.074539
강남구,2403, 공무원연금매점 교차로 (개포주공9단지 입구),202002,66,34,100,37.48872,127.074539
강남구,2403, 공무원연금매점 교차로 (개포주공9단지 입구),202003,91,64,155,37.48872,127.074539
강남구,2403, 공무원연금매점 교차로 (개포주공9단지 입구),202004,131,126,257,37.48872,127.074539
강남구,2403, 공무원연금매점 교차로 (개포주공9단지 입구),202005,131,123,254,37.48872,127.074539
강남구,2403, 공무원연금매점 교차로 (개포주공9단지 입구),202006,175,162,337,37.48872,127.074539
강남구,2404, 대모산입구역 4번 출구 앞,201901,152,151,303,37.49181,127.073158
강남구,2404, 대모산입구역 4번 출구 앞,201902,162,160,322,37.49181,127.073158
강남구,2404, 대모산입구역 4번 출구 앞,201903,276,256,532,37.49181,127.073158
강남구,2404, 대모산입구역 4번 출구 앞,201904,414,397,811,37.49181,127.073158
강남구,2404, 대모산입구역 4번 출구 앞,201905,595,591,1186,37.49181,127.073158
강남구,2404, 대모산입구역 4번 출구 앞,201906,672,662,1334,37.49181,127.073158
강남구,2404, 대모산입구역 4번 출구 앞,201907,749,759,1508,37.49181,127.073158
강남구,2404, 대모산입구역 4번 출구 앞,201908,710,704,1414,37.49181,127.073158
강남구,2404, 대모산입구역 4번 출구 앞,201909,864,859,1723,37.49181,127.073158
강남구,2404, 대모산입구역 4번 출구 앞,201910,899,891,1790,37.49181,127.073158
강남구,2404, 대모산입구역 4번 출구 앞,201911,575,576,1151,37.49181,127.073158
강남구,2404, 대모산입구역 4번 출구 앞,201912,373,406,779,37.49181,127.073158
강남구,2404, 대모산입구역 4번 출구 앞,202001,326,333,659,37.49181,127.073158
강남구,2404, 대모산입구역 4번 출구 앞,202002,338,342,680,37.49181,127.073158
강남구,2404, 대모산입구역 4번 출구 앞,202003,568,557,1125,37.49181,127.073158
강남구,2404, 대모산입구역 4번 출구 앞,202004,640,637,1277,37.49181,127.073158
강남구,2404, 대모산입구역 4번 출구 앞,202005,817,812,1629,37.49181,127.073158
강남구,2404, 대모산입구역 4번 출구 앞,202006,911,898,1809,37.49181,127.073158
강남구,2405, 청담공원앞 교차로,201901,367,128,495,37.518711,127.05085
강남구,2405, 청담공원앞 교차로,201902,191,105,296,37.518711,127.05085
강남구,2405, 청담공원앞 교차로,201903,461,185,646,37.518711,127.05085
강남구,2405, 청담공원앞 교차로,201904,936,394,1330,37.518711,127.05085
강남구,2405, 청담공원앞 교차로,201905,965,469,1434,37.518711,127.05085
강남구,2405, 청담공원앞 교차로,201906,1278,445,1723,37.518711,127.05085
강남구,2405, 청담공원앞 교차로,201907,932,384,1316,37.518711,127.05085
강남구,2405, 청담공원앞 교차로,201908,850,387,1237,37.518711,127.05085
강남구,2405, 청담공원앞 교차로,201909,848,337,1185,37.518711,127.05085
강남구,2405, 청담공원앞 교차로,201910,1105,434,1539,37.518711,127.05085
강남구,2405, 청담공원앞 교차로,201911,723,233,956,37.518711,127.05085
강남구,2405, 청담공원앞 교차로,201912,380,134,514,37.518711,127.05085
강남구,2405, 청담공원앞 교차로,202001,430,122,552,37.518711,127.05085
강남구,2405, 청담공원앞 교차로,202002,315,80,395,37.518711,127.05085
강남구,2405, 청담공원앞 교차로,202003,501,179,680,37.518711,127.05085
강남구,2405, 청담공원앞 교차로,202004,744,240,984,37.518711,127.05085
강남구,2405, 청담공원앞 교차로,202005,680,239,919,37.518711,127.05085
강남구,2405, 청담공원앞 교차로,202006,1050,311,1361,37.518711,127.05085
강남구,2406, 논현동 광명빌딩 앞,201901,94,64,158,37.51757,127.023643
강남구,2406, 논현동 광명빌딩 앞,201902,98,66,164,37.51757,127.023643
강남구,2406, 논현동 광명빌딩 앞,201903,180,126,306,37.51757,127.023643
강남구,2406, 논현동 광명빌딩 앞,201904,285,180,465,37.51757,127.023643
강남구,2406, 논현동 광명빌딩 앞,201905,478,317,795,37.51757,127.023643
강남구,2406, 논현동 광명빌딩 앞,201906,444,307,751,37.51757,127.023643
강남구,2406, 논현동 광명빌딩 앞,201907,443,295,738,37.51757,127.023643
강남구,2406, 논현동 광명빌딩 앞,201908,452,281,733,37.51757,127.023643
강남구,2406, 논현동 광명빌딩 앞,201909,350,259,609,37.51757,127.023643
강남구,2406, 논현동 광명빌딩 앞,201910,552,415,967,37.51757,127.023643
강남구,2406, 논현동 광명빌딩 앞,201911,311,227,538,37.51757,127.023643
강남구,2406, 논현동 광명빌딩 앞,201912,120,105,225,37.51757,127.023643
강남구,2406, 논현동 광명빌딩 앞,202001,130,96,226,37.51757,127.023643
강남구,2406, 논현동 광명빌딩 앞,202002,121,96,217,37.51757,127.023643
강남구,2406, 논현동 광명빌딩 앞,202003,209,138,347,37.51757,127.023643
강남구,2406, 논현동 광명빌딩 앞,202004,311,203,514,37.51757,127.023643
강남구,2406, 논현동 광명빌딩 앞,202005,259,214,473,37.51757,127.023643
강남구,2406, 논현동 광명빌딩 앞,202006,383,249,632,37.51757,127.023643
강남구,2407, 역삼,201901,380,411,791,37.49847,127.030113
강남구,2407, 역삼,201902,469,444,913,37.49847,127.030113
강남구,2407, 역삼,201903,1013,1008,2021,37.49847,127.030113
강남구,2407, 역삼,201904,1401,1354,2755,37.49847,127.030113
강남구,2407, 역삼,201905,2124,2004,4128,37.49847,127.030113
강남구,2407, 역삼,201906,2193,2136,4329,37.49847,127.030113
강남구,2407, 역삼,201907,1793,1786,3579,37.49847,127.030113
강남구,2407, 역삼,201908,1575,1545,3120,37.49847,127.030113
강남구,2407, 역삼,201909,1360,1363,2723,37.49847,127.030113
강남구,2407, 역삼,201910,1889,1881,3770,37.49847,127.030113
강남구,2407, 역삼,201911,1211,1233,2444,37.49847,127.030113
강남구,2407, 역삼,201912,742,765,1507,37.49847,127.030113
강남구,2407, 역삼,202001,617,670,1287,37.49847,127.030113
강남구,2407, 역삼,202002,510,534,1044,37.49847,127.030113
강남구,2407, 역삼,202003,805,802,1607,37.49847,127.030113
강남구,2407, 역삼,202004,1229,1211,2440,37.49847,127.030113
강남구,2407, 역삼,202005,1279,1273,2552,37.49847,127.030113
강남구,2407, 역삼,202006,1375,1377,2752,37.49847,127.030113
강남구,2408, 강남한양수자인아파트,201901,119,177,296,37.477341,127.113274
강남구,2408, 강남한양수자인아파트,201902,160,210,370,37.477341,127.113274
강남구,2408, 강남한양수자인아파트,201903,285,275,560,37.477341,127.113274
강남구,2408, 강남한양수자인아파트,201904,418,448,866,37.477341,127.113274
강남구,2408, 강남한양수자인아파트,201905,640,632,1272,37.477341,127.113274
강남구,2408, 강남한양수자인아파트,201906,768,718,1486,37.477341,127.113274
강남구,2408, 강남한양수자인아파트,201907,690,673,1363,37.477341,127.113274
강남구,2408, 강남한양수자인아파트,201908,757,759,1516,37.477341,127.113274
강남구,2408, 강남한양수자인아파트,201909,633,642,1275,37.477341,127.113274
강남구,2408, 강남한양수자인아파트,201910,771,763,1534,37.477341,127.113274
강남구,2408, 강남한양수자인아파트,201911,441,432,873,37.477341,127.113274
강남구,2408, 강남한양수자인아파트,201912,317,312,629,37.477341,127.113274
강남구,2408, 강남한양수자인아파트,202001,311,320,631,37.477341,127.113274
강남구,2408, 강남한양수자인아파트,202002,288,281,569,37.477341,127.113274
강남구,2408, 강남한양수자인아파트,202003,525,520,1045,37.477341,127.113274
강남구,2408, 강남한양수자인아파트,202004,740,734,1474,37.477341,127.113274
강남구,2408, 강남한양수자인아파트,202005,759,748,1507,37.477341,127.113274
강남구,2408, 강남한양수자인아파트,202006,722,732,1454,37.477341,127.113274
강남구,2409, 역삼동 디오슈페리움 (우성아파트 사거리),201901,204,222,426,37.492062,127.030746
강남구,2409, 역삼동 디오슈페리움 (우성아파트 사거리),201902,211,211,422,37.492062,127.030746
강남구,2409, 역삼동 디오슈페리움 (우성아파트 사거리),201903,467,480,947,37.492062,127.030746
강남구,2409, 역삼동 디오슈페리움 (우성아파트 사거리),201904,696,686,1382,37.492062,127.030746
강남구,2409, 역삼동 디오슈페리움 (우성아파트 사거리),201905,1114,1126,2240,37.492062,127.030746
강남구,2409, 역삼동 디오슈페리움 (우성아파트 사거리),201906,1157,1153,2310,37.492062,127.030746
강남구,2409, 역삼동 디오슈페리움 (우성아파트 사거리),201907,1213,1221,2434,37.492062,127.030746
강남구,2409, 역삼동 디오슈페리움 (우성아파트 사거리),201908,969,979,1948,37.492062,127.030746
강남구,2409, 역삼동 디오슈페리움 (우성아파트 사거리),201909,939,937,1876,37.492062,127.030746
강남구,2409, 역삼동 디오슈페리움 (우성아파트 사거리),201910,1016,1018,2034,37.492062,127.030746
강남구,2409, 역삼동 디오슈페리움 (우성아파트 사거리),201911,834,833,1667,37.492062,127.030746
강남구,2409, 역삼동 디오슈페리움 (우성아파트 사거리),201912,458,448,906,37.492062,127.030746
강남구,2409, 역삼동 디오슈페리움 (우성아파트 사거리),202001,419,418,837,37.492062,127.030746
강남구,2409, 역삼동 디오슈페리움 (우성아파트 사거리),202002,413,416,829,37.492062,127.030746
강남구,2409, 역삼동 디오슈페리움 (우성아파트 사거리),202003,702,695,1397,37.492062,127.030746
강남구,2409, 역삼동 디오슈페리움 (우성아파트 사거리),202004,805,794,1599,37.492062,127.030746
강남구,2409, 역삼동 디오슈페리움 (우성아파트 사거리),202005,896,899,1795,37.492062,127.030746
강남구,2409, 역삼동 디오슈페리움 (우성아파트 사거리),202006,1073,1066,2139,37.492062,127.030746
강남구,2410, 포스코피앤에스타워 (역삼역 3번출구 부근),201903,30,26,56,37.499599,127.033752
강남구,2410, 포스코피앤에스타워 (역삼역 3번출구 부근),201904,798,652,1450,37.499599,127.033752
강남구,2410, 포스코피앤에스타워 (역삼역 3번출구 부근),201905,1106,953,2059,37.499599,127.033752
강남구,2410, 포스코피앤에스타워 (역삼역 3번출구 부근),201906,1078,985,2063,37.499599,127.033752
강남구,2410, 포스코피앤에스타워 (역삼역 3번출구 부근),201907,1052,991,2043,37.499599,127.033752
강남구,2410, 포스코피앤에스타워 (역삼역 3번출구 부근),201908,878,859,1737,37.499599,127.033752
강남구,2410, 포스코피앤에스타워 (역삼역 3번출구 부근),201909,868,832,1700,37.499599,127.033752
강남구,2410, 포스코피앤에스타워 (역삼역 3번출구 부근),201910,1014,987,2001,37.499599,127.033752
강남구,2410, 포스코피앤에스타워 (역삼역 3번출구 부근),201911,696,697,1393,37.499599,127.033752
강남구,2410, 포스코피앤에스타워 (역삼역 3번출구 부근),201912,375,370,745,37.499599,127.033752
강남구,2410, 포스코피앤에스타워 (역삼역 3번출구 부근),202001,312,306,618,37.499599,127.033752
강남구,2410, 포스코피앤에스타워 (역삼역 3번출구 부근),202002,269,268,537,37.499599,127.033752
강남구,2410, 포스코피앤에스타워 (역삼역 3번출구 부근),202003,512,503,1015,37.499599,127.033752
강남구,2410, 포스코피앤에스타워 (역삼역 3번출구 부근),202004,636,610,1246,37.499599,127.033752
강남구,2410, 포스코피앤에스타워 (역삼역 3번출구 부근),202005,688,669,1357,37.499599,127.033752
강남구,2410, 포스코피앤에스타워 (역삼역 3번출구 부근),202006,666,661,1327,37.499599,127.033752
강남구,2411, 세곡동 성당,201902,16,17,33,37.472969,127.112228
강남구,2411, 세곡동 성당,201903,295,329,624,37.472969,127.112228
강남구,2411, 세곡동 성당,201904,429,446,875,37.472969,127.112228
강남구,2411, 세곡동 성당,201905,630,707,1337,37.472969,127.112228
강남구,2411, 세곡동 성당,201906,866,916,1782,37.472969,127.112228
강남구,2411, 세곡동 성당,201907,718,901,1619,37.472969,127.112228
강남구,2411, 세곡동 성당,201908,734,824,1558,37.472969,127.112228
강남구,2411, 세곡동 성당,201909,725,769,1494,37.472969,127.112228
강남구,2411, 세곡동 성당,201910,887,898,1785,37.472969,127.112228
강남구,2411, 세곡동 성당,201911,484,544,1028,37.472969,127.112228
강남구,2411, 세곡동 성당,201912,316,328,644,37.472969,127.112228
강남구,2411, 세곡동 성당,202001,281,288,569,37.472969,127.112228
강남구,2411, 세곡동 성당,202002,273,268,541,37.472969,127.112228
강남구,2411, 세곡동 성당,202003,621,628,1249,37.472969,127.112228
강남구,2411, 세곡동 성당,202004,957,936,1893,37.472969,127.112228
강남구,2411, 세곡동 성당,202005,894,894,1788,37.472969,127.112228
강남구,2411, 세곡동 성당,202006,955,948,1903,37.472969,127.112228
강남구,2412, 일원1동 주민센터,201901,111,159,270,37.491791,127.088211
강남구,2412, 일원1동 주민센터,201902,172,250,422,37.491791,127.088211
강남구,2412, 일원1동 주민센터,201903,461,556,1017,37.491791,127.088211
강남구,2412, 일원1동 주민센터,201904,779,953,1732,37.491791,127.088211
강남구,2412, 일원1동 주민센터,201905,1288,1434,2722,37.491791,127.088211
강남구,2412, 일원1동 주민센터,201906,1492,1582,3074,37.491791,127.088211
강남구,2412, 일원1동 주민센터,201907,1409,1628,3037,37.491791,127.088211
강남구,2412, 일원1동 주민센터,201908,1393,1557,2950,37.491791,127.088211
강남구,2412, 일원1동 주민센터,201909,1419,1588,3007,37.491791,127.088211
강남구,2412, 일원1동 주민센터,201910,1619,1716,3335,37.491791,127.088211
강남구,2412, 일원1동 주민센터,201911,969,1001,1970,37.491791,127.088211
강남구,2412, 일원1동 주민센터,201912,452,461,913,37.491791,127.088211
강남구,2412, 일원1동 주민센터,202001,500,524,1024,37.491791,127.088211
강남구,2412, 일원1동 주민센터,202002,557,586,1143,37.491791,127.088211
강남구,2412, 일원1동 주민센터,202003,1130,1130,2260,37.491791,127.088211
강남구,2412, 일원1동 주민센터,202004,1658,1672,3330,37.491791,127.088211
강남구,2412, 일원1동 주민센터,202005,1767,1764,3531,37.491791,127.088211
강남구,2412, 일원1동 주민센터,202006,1836,1878,3714,37.491791,127.088211
강남구,2413,도곡역 1번 출구,202003,1,1,2,37.490959,127.054985
강남구,2413,도곡역 1번 출구,202005,54,51,105,37.490959,127.054985
강남구,2413,도곡역 1번 출구,202006,373,370,743,37.490959,127.054985
강남구,2414, 도곡역 아카데미스위트 앞,202003,1,1,2,37.488972,127.051827
강남구,2414, 도곡역 아카데미스위트 앞,202004,1,1,2,37.488972,127.051827
강남구,2414, 도곡역 아카데미스위트 앞,202005,72,68,140,37.488972,127.051827
강남구,2414, 도곡역 아카데미스위트 앞,202006,731,726,1457,37.488972,127.051827
강남구,2415,한티역 롯데백화점 앞,202003,1,1,2,37.496674,127.053429
강남구,2415,한티역 롯데백화점 앞,202004,13,13,26,37.496674,127.053429
강남구,2415,한티역 롯데백화점 앞,202005,51,46,97,37.496674,127.053429
강남구,2415,한티역 롯데백화점 앞,202006,457,420,877,37.496674,127.053429
강남구,2416,한티역 6번 출구,202003,1,1,2,37.495899,127.052193
강남구,2416,한티역 6번 출구,202005,17,16,33,37.495899,127.052193
강남구,2416,한티역 6번 출구,202006,150,140,290,37.495899,127.052193
강남구,2417,선정릉 일등 추어탕 앞,202003,1,1,2,37.507999,127.04525
강남구,2417,선정릉 일등 추어탕 앞,202005,21,16,37,37.507999,127.04525
강남구,2417,선정릉 일등 추어탕 앞,202006,106,85,191,37.507999,127.04525
강남구,2418,봉은사역 7번 출구,202003,1,1,2,37.513935,127.059822
강남구,2418,봉은사역 7번 출구,202005,77,72,149,37.513935,127.059822
강남구,2418,봉은사역 7번 출구,202006,483,462,945,37.513935,127.059822
강남구,2419,"봉은사역 1,2번 출구",202003,1,1,2,37.514309,127.0597
강남구,2419,"봉은사역 1,2번 출구",202005,57,55,112,37.514309,127.0597
강남구,2419,"봉은사역 1,2번 출구",202006,420,280,700,37.514309,127.0597
강남구,2420,학여울역 사거리(LG베스트샵 앞),202003,1,1,2,37.496895,127.070137
강남구,2420,학여울역 사거리(LG베스트샵 앞),202004,11,9,20,37.496895,127.070137
강남구,2420,학여울역 사거리(LG베스트샵 앞),202005,50,48,98,37.496895,127.070137
강남구,2420,학여울역 사거리(LG베스트샵 앞),202006,496,473,969,37.496895,127.070137
강남구,2421, 신논현역 4번출구,202003,1,1,2,37.504673,127.025795
강남구,2421, 신논현역 4번출구,202005,49,46,95,37.504673,127.025795
강남구,2421, 신논현역 4번출구,202006,235,230,465,37.504673,127.025795
강남구,2422,수서동 성당 맞은편,202003,1,1,2,37.484169,127.094849
강남구,2422,수서동 성당 맞은편,202005,51,38,89,37.484169,127.094849
강남구,2422,수서동 성당 맞은편,202006,398,389,787,37.484169,127.094849
강남구,2423,영희초교 사거리(래미안개포루체하임),202003,1,1,2,37.490837,127.08065
강남구,2423,영희초교 사거리(래미안개포루체하임),202004,2,1,3,37.490837,127.08065
강남구,2423,영희초교 사거리(래미안개포루체하임),202005,87,87,174,37.490837,127.08065
강남구,2423,영희초교 사거리(래미안개포루체하임),202006,722,715,1437,37.490837,127.08065
강남구,2424,신동아파밀리에 203동 맞은편,202003,1,1,2,#N/A,#N/A
강남구,2425,세곡동 사거리(대왕초등학교 정류장),202003,1,1,2,37.464619,127.10685
강남구,2425,세곡동 사거리(대왕초등학교 정류장),202004,1,1,2,37.464619,127.10685
강남구,2425,세곡동 사거리(대왕초등학교 정류장),202005,22,20,42,37.464619,127.10685
강남구,2425,세곡동 사거리(대왕초등학교 정류장),202006,87,86,173,37.464619,127.10685
강남구,2426,강남한신휴플러스 6단지,202003,1,1,2,37.468296,127.104698
강남구,2426,강남한신휴플러스 6단지,202005,25,24,49,37.468296,127.104698
강남구,2426,강남한신휴플러스 6단지,202006,236,239,475,37.468296,127.104698
강남구,2427,개포고등학교 정문앞,202006,3,1,4,37.484852,127.058373
강남구,2428,롯데리아 개포점앞,202003,1,1,2,37.482368,127.061188
강남구,2428,롯데리아 개포점앞,202005,17,17,34,37.482368,127.061188
강남구,2428,롯데리아 개포점앞,202006,193,188,381,37.482368,127.061188
강남구,2429,압구정로데오역 6번출구,202003,1,1,2,37.527454,127.040428
강남구,2429,압구정로데오역 6번출구,202005,126,127,253,37.527454,127.040428
강남구,2429,압구정로데오역 6번출구,202006,835,832,1667,37.527454,127.040428
강남구,2430,강남파이낸스센터앞(역삼역2번출구),202003,1,1,2,37.500244,127.036057
강남구,2430,강남파이낸스센터앞(역삼역2번출구),202005,43,31,74,37.500244,127.036057
강남구,2430,강남파이낸스센터앞(역삼역2번출구),202006,274,245,519,37.500244,127.036057
강남구,2431,대치역 7번출구,202003,1,1,2,37.494118,127.062904
강남구,2431,대치역 7번출구,202005,58,55,113,37.494118,127.062904
강남구,2431,대치역 7번출구,202006,566,562,1128,37.494118,127.062904
서초구,2501, 서초 포레스타5단지,201901,208,213,421,37.450661,127.05706
서초구,2501, 서초 포레스타5단지,201902,165,183,348,37.450661,127.05706
서초구,2501, 서초 포레스타5단지,201903,325,299,624,37.450661,127.05706
서초구,2501, 서초 포레스타5단지,201904,521,553,1074,37.450661,127.05706
서초구,2501, 서초 포레스타5단지,201905,863,912,1775,37.450661,127.05706
서초구,2501, 서초 포레스타5단지,201906,999,1065,2064,37.450661,127.05706
서초구,2501, 서초 포레스타5단지,201907,1050,1068,2118,37.450661,127.05706
서초구,2501, 서초 포레스타5단지,201908,971,982,1953,37.450661,127.05706
서초구,2501, 서초 포레스타5단지,201909,800,812,1612,37.450661,127.05706
서초구,2501, 서초 포레스타5단지,201910,908,893,1801,37.450661,127.05706
서초구,2501, 서초 포레스타5단지,201911,573,568,1141,37.450661,127.05706
서초구,2501, 서초 포레스타5단지,201912,362,356,718,37.450661,127.05706
서초구,2501, 서초 포레스타5단지,202001,284,290,574,37.450661,127.05706
서초구,2501, 서초 포레스타5단지,202002,366,372,738,37.450661,127.05706
서초구,2501, 서초 포레스타5단지,202003,712,685,1397,37.450661,127.05706
서초구,2501, 서초 포레스타5단지,202004,710,669,1379,37.450661,127.05706
서초구,2501, 서초 포레스타5단지,202005,806,771,1577,37.450661,127.05706
서초구,2501, 서초 포레스타5단지,202006,791,752,1543,37.450661,127.05706
서초구,2502, 서초역1번출구 앞,201901,139,106,245,37.491951,127.008553
서초구,2502, 서초역1번출구 앞,201902,119,63,182,37.491951,127.008553
서초구,2502, 서초역1번출구 앞,201903,232,178,410,37.491951,127.008553
서초구,2502, 서초역1번출구 앞,201904,393,303,696,37.491951,127.008553
서초구,2502, 서초역1번출구 앞,201905,712,601,1313,37.491951,127.008553
서초구,2502, 서초역1번출구 앞,201906,841,744,1585,37.491951,127.008553
서초구,2502, 서초역1번출구 앞,201907,674,590,1264,37.491951,127.008553
서초구,2502, 서초역1번출구 앞,201908,657,532,1189,37.491951,127.008553
서초구,2502, 서초역1번출구 앞,201909,657,556,1213,37.491951,127.008553
서초구,2502, 서초역1번출구 앞,201910,829,704,1533,37.491951,127.008553
서초구,2502, 서초역1번출구 앞,201911,499,435,934,37.491951,127.008553
서초구,2502, 서초역1번출구 앞,201912,262,239,501,37.491951,127.008553
서초구,2502, 서초역1번출구 앞,202001,260,227,487,37.491951,127.008553
서초구,2502, 서초역1번출구 앞,202002,193,188,381,37.491951,127.008553
서초구,2502, 서초역1번출구 앞,202003,380,300,680,37.491951,127.008553
서초구,2502, 서초역1번출구 앞,202004,459,382,841,37.491951,127.008553
서초구,2502, 서초역1번출구 앞,202005,468,399,867,37.491951,127.008553
서초구,2502, 서초역1번출구 앞,202006,672,519,1191,37.491951,127.008553
서초구,2503, 반포1동 서초빌딩 앞,201901,182,190,372,37.503811,127.021362
서초구,2503, 반포1동 서초빌딩 앞,201902,183,236,419,37.503811,127.021362
서초구,2503, 반포1동 서초빌딩 앞,201903,360,445,805,37.503811,127.021362
서초구,2503, 반포1동 서초빌딩 앞,201904,657,740,1397,37.503811,127.021362
서초구,2503, 반포1동 서초빌딩 앞,201905,1021,1015,2036,37.503811,127.021362
서초구,2503, 반포1동 서초빌딩 앞,201906,1065,1037,2102,37.503811,127.021362
서초구,2503, 반포1동 서초빌딩 앞,201907,1111,1031,2142,37.503811,127.021362
서초구,2503, 반포1동 서초빌딩 앞,201908,1010,958,1968,37.503811,127.021362
서초구,2503, 반포1동 서초빌딩 앞,201909,1035,976,2011,37.503811,127.021362
서초구,2503, 반포1동 서초빌딩 앞,201910,1201,1179,2380,37.503811,127.021362
서초구,2503, 반포1동 서초빌딩 앞,201911,804,806,1610,37.503811,127.021362
서초구,2503, 반포1동 서초빌딩 앞,201912,555,561,1116,37.503811,127.021362
서초구,2503, 반포1동 서초빌딩 앞,202001,419,414,833,37.503811,127.021362
서초구,2503, 반포1동 서초빌딩 앞,202002,407,404,811,37.503811,127.021362
서초구,2503, 반포1동 서초빌딩 앞,202003,636,618,1254,37.503811,127.021362
서초구,2503, 반포1동 서초빌딩 앞,202004,925,911,1836,37.503811,127.021362
서초구,2503, 반포1동 서초빌딩 앞,202005,883,879,1762,37.503811,127.021362
서초구,2503, 반포1동 서초빌딩 앞,202006,993,963,1956,37.503811,127.021362
서초구,2504, 신사역 4번출구 뒤,201901,145,143,288,37.515881,127.019302
서초구,2504, 신사역 4번출구 뒤,201902,179,139,318,37.515881,127.019302
서초구,2504, 신사역 4번출구 뒤,201903,436,385,821,37.515881,127.019302
서초구,2504, 신사역 4번출구 뒤,201904,740,644,1384,37.515881,127.019302
서초구,2504, 신사역 4번출구 뒤,201905,990,901,1891,37.515881,127.019302
서초구,2504, 신사역 4번출구 뒤,201906,1087,1024,2111,37.515881,127.019302
서초구,2504, 신사역 4번출구 뒤,201907,964,916,1880,37.515881,127.019302
서초구,2504, 신사역 4번출구 뒤,201908,930,886,1816,37.515881,127.019302
서초구,2504, 신사역 4번출구 뒤,201909,895,860,1755,37.515881,127.019302
서초구,2504, 신사역 4번출구 뒤,201910,1250,1184,2434,37.515881,127.019302
서초구,2504, 신사역 4번출구 뒤,201911,710,648,1358,37.515881,127.019302
서초구,2504, 신사역 4번출구 뒤,201912,379,339,718,37.515881,127.019302
서초구,2504, 신사역 4번출구 뒤,202001,332,299,631,37.515881,127.019302
서초구,2504, 신사역 4번출구 뒤,202002,350,319,669,37.515881,127.019302
서초구,2504, 신사역 4번출구 뒤,202003,714,676,1390,37.515881,127.019302
서초구,2504, 신사역 4번출구 뒤,202004,1097,1008,2105,37.515881,127.019302
서초구,2504, 신사역 4번출구 뒤,202005,1014,990,2004,37.515881,127.019302
서초구,2504, 신사역 4번출구 뒤,202006,1047,942,1989,37.515881,127.019302
서초구,2505, 우성아파트사거리 (기업은행앞),201901,328,319,647,37.493259,127.029533
서초구,2505, 우성아파트사거리 (기업은행앞),201902,324,332,656,37.493259,127.029533
서초구,2505, 우성아파트사거리 (기업은행앞),201903,678,671,1349,37.493259,127.029533
서초구,2505, 우성아파트사거리 (기업은행앞),201904,1024,977,2001,37.493259,127.029533
서초구,2505, 우성아파트사거리 (기업은행앞),201905,1509,1501,3010,37.493259,127.029533
서초구,2505, 우성아파트사거리 (기업은행앞),201906,1520,1522,3042,37.493259,127.029533
서초구,2505, 우성아파트사거리 (기업은행앞),201907,1513,1513,3026,37.493259,127.029533
서초구,2505, 우성아파트사거리 (기업은행앞),201908,1365,1343,2708,37.493259,127.029533
서초구,2505, 우성아파트사거리 (기업은행앞),201909,1399,1407,2806,37.493259,127.029533
서초구,2505, 우성아파트사거리 (기업은행앞),201910,1611,1634,3245,37.493259,127.029533
서초구,2505, 우성아파트사거리 (기업은행앞),201911,1190,1208,2398,37.493259,127.029533
서초구,2505, 우성아파트사거리 (기업은행앞),201912,646,656,1302,37.493259,127.029533
서초구,2505, 우성아파트사거리 (기업은행앞),202001,579,621,1200,37.493259,127.029533
서초구,2505, 우성아파트사거리 (기업은행앞),202002,558,588,1146,37.493259,127.029533
서초구,2505, 우성아파트사거리 (기업은행앞),202003,812,807,1619,37.493259,127.029533
서초구,2505, 우성아파트사거리 (기업은행앞),202004,1058,1052,2110,37.493259,127.029533
서초구,2505, 우성아파트사거리 (기업은행앞),202005,1318,1317,2635,37.493259,127.029533
서초구,2505, 우성아파트사거리 (기업은행앞),202006,1506,1490,2996,37.493259,127.029533
서초구,2506, LG유플러스 (방배사옥),201901,74,38,112,37.479092,126.990677
서초구,2506, LG유플러스 (방배사옥),201902,102,48,150,37.479092,126.990677
서초구,2506, LG유플러스 (방배사옥),201903,161,99,260,37.479092,126.990677
서초구,2506, LG유플러스 (방배사옥),201904,306,195,501,37.479092,126.990677
서초구,2506, LG유플러스 (방배사옥),201905,485,298,783,37.479092,126.990677
서초구,2506, LG유플러스 (방배사옥),201906,492,291,783,37.479092,126.990677
서초구,2506, LG유플러스 (방배사옥),201907,485,298,783,37.479092,126.990677
서초구,2506, LG유플러스 (방배사옥),201908,452,249,701,37.479092,126.990677
서초구,2506, LG유플러스 (방배사옥),201909,466,276,742,37.479092,126.990677
서초구,2506, LG유플러스 (방배사옥),201910,571,323,894,37.479092,126.990677
서초구,2506, LG유플러스 (방배사옥),201911,342,169,511,37.479092,126.990677
서초구,2506, LG유플러스 (방배사옥),201912,198,102,300,37.479092,126.990677
서초구,2506, LG유플러스 (방배사옥),202001,189,84,273,37.479092,126.990677
서초구,2506, LG유플러스 (방배사옥),202002,145,57,202,37.479092,126.990677
서초구,2506, LG유플러스 (방배사옥),202003,201,94,295,37.479092,126.990677
서초구,2506, LG유플러스 (방배사옥),202004,276,172,448,37.479092,126.990677
서초구,2506, LG유플러스 (방배사옥),202005,311,197,508,37.479092,126.990677
서초구,2506, LG유플러스 (방배사옥),202006,365,195,560,37.479092,126.990677
서초구,2508, 양재이스타빌 앞,201901,225,247,472,37.482979,127.042259
서초구,2508, 양재이스타빌 앞,201902,179,260,439,37.482979,127.042259
서초구,2508, 양재이스타빌 앞,201903,372,476,848,37.482979,127.042259
서초구,2508, 양재이스타빌 앞,201904,721,804,1525,37.482979,127.042259
서초구,2508, 양재이스타빌 앞,201905,1332,1375,2707,37.482979,127.042259
서초구,2508, 양재이스타빌 앞,201906,1338,1390,2728,37.482979,127.042259
서초구,2508, 양재이스타빌 앞,201907,1494,1490,2984,37.482979,127.042259
서초구,2508, 양재이스타빌 앞,201908,1258,1267,2525,37.482979,127.042259
서초구,2508, 양재이스타빌 앞,201909,1229,1231,2460,37.482979,127.042259
서초구,2508, 양재이스타빌 앞,201910,1356,1375,2731,37.482979,127.042259
서초구,2508, 양재이스타빌 앞,201911,756,856,1612,37.482979,127.042259
서초구,2508, 양재이스타빌 앞,201912,442,461,903,37.482979,127.042259
서초구,2508, 양재이스타빌 앞,202001,390,453,843,37.482979,127.042259
서초구,2508, 양재이스타빌 앞,202002,398,431,829,37.482979,127.042259
서초구,2508, 양재이스타빌 앞,202003,897,915,1812,37.482979,127.042259
서초구,2508, 양재이스타빌 앞,202004,1054,1053,2107,37.482979,127.042259
서초구,2508, 양재이스타빌 앞,202005,1140,1133,2273,37.482979,127.042259
서초구,2508, 양재이스타빌 앞,202006,1299,1275,2574,37.482979,127.042259
서초구,2509, KT반포지사,201901,218,188,406,37.498371,126.992462
서초구,2509, KT반포지사,201902,219,174,393,37.498371,126.992462
서초구,2509, KT반포지사,201903,461,431,892,37.498371,126.992462
서초구,2509, KT반포지사,201904,703,601,1304,37.498371,126.992462
서초구,2509, KT반포지사,201905,883,801,1684,37.498371,126.992462
서초구,2509, KT반포지사,201906,968,905,1873,37.498371,126.992462
서초구,2509, KT반포지사,201907,379,386,765,37.498371,126.992462
서초구,2509, KT반포지사,201909,11,8,19,37.498371,126.992462
서초구,2509, KT반포지사,201910,912,806,1718,37.498371,126.992462
서초구,2509, KT반포지사,201911,611,566,1177,37.498371,126.992462
서초구,2509, KT반포지사,201912,385,374,759,37.498371,126.992462
서초구,2509, KT반포지사,202001,350,349,699,37.498371,126.992462
서초구,2509, KT반포지사,202002,238,221,459,37.498371,126.992462
서초구,2509, KT반포지사,202003,485,420,905,37.498371,126.992462
서초구,2509, KT반포지사,202004,699,645,1344,37.498371,126.992462
서초구,2509, KT반포지사,202005,724,698,1422,37.498371,126.992462
서초구,2509, KT반포지사,202006,679,653,1332,37.498371,126.992462
서초구,2510, JW타워,201903,10,5,15,37.48304,127.021461
서초구,2510, JW타워,201904,230,167,397,37.48304,127.021461
서초구,2510, JW타워,201905,292,240,532,37.48304,127.021461
서초구,2510, JW타워,201906,317,249,566,37.48304,127.021461
서초구,2510, JW타워,201907,235,193,428,37.48304,127.021461
서초구,2510, JW타워,201908,233,176,409,37.48304,127.021461
서초구,2510, JW타워,201909,256,216,472,37.48304,127.021461
서초구,2510, JW타워,201910,329,244,573,37.48304,127.021461
서초구,2510, JW타워,201911,242,176,418,37.48304,127.021461
서초구,2510, JW타워,201912,142,117,259,37.48304,127.021461
서초구,2510, JW타워,202001,168,121,289,37.48304,127.021461
서초구,2510, JW타워,202002,132,120,252,37.48304,127.021461
서초구,2510, JW타워,202003,167,165,332,37.48304,127.021461
서초구,2510, JW타워,202004,249,232,481,37.48304,127.021461
서초구,2510, JW타워,202005,242,233,475,37.48304,127.021461
서초구,2510, JW타워,202006,201,201,402,37.48304,127.021461
서초구,2511, 이수역 6번출구 앞,201903,93,98,191,37.483662,126.982323
서초구,2511, 이수역 6번출구 앞,201904,547,565,1112,37.483662,126.982323
서초구,2511, 이수역 6번출구 앞,201905,1349,1223,2572,37.483662,126.982323
서초구,2511, 이수역 6번출구 앞,201906,1399,1298,2697,37.483662,126.982323
서초구,2511, 이수역 6번출구 앞,201907,1497,1404,2901,37.483662,126.982323
서초구,2511, 이수역 6번출구 앞,201908,1490,1452,2942,37.483662,126.982323
서초구,2511, 이수역 6번출구 앞,201909,1317,1203,2520,37.483662,126.982323
서초구,2511, 이수역 6번출구 앞,201910,1399,1301,2700,37.483662,126.982323
서초구,2511, 이수역 6번출구 앞,201911,798,821,1619,37.483662,126.982323
서초구,2511, 이수역 6번출구 앞,201912,431,490,921,37.483662,126.982323
서초구,2511, 이수역 6번출구 앞,202001,356,394,750,37.483662,126.982323
서초구,2511, 이수역 6번출구 앞,202002,309,348,657,37.483662,126.982323
서초구,2511, 이수역 6번출구 앞,202003,705,625,1330,37.483662,126.982323
서초구,2511, 이수역 6번출구 앞,202004,998,928,1926,37.483662,126.982323
서초구,2511, 이수역 6번출구 앞,202005,1253,1152,2405,37.483662,126.982323
서초구,2511, 이수역 6번출구 앞,202006,1365,1317,2682,37.483662,126.982323
서초구,2514,사평역 2번출구,202003,1,1,2,37.503643,127.016022
서초구,2514,사평역 2번출구,202006,57,54,111,37.503643,127.016022
서초구,2515,서초초등학교 후문,202003,1,1,2,37.498928,127.024727
서초구,2515,서초초등학교 후문,202006,50,47,97,37.498928,127.024727
서초구,2516,본마을 노인복지센터 앞,202003,1,1,2,37.454418,127.052742
서초구,2516,본마을 노인복지센터 앞,202006,139,124,263,37.454418,127.052742
서초구,2517,서초3교(효령로69길 방면),202003,1,1,2,37.48716,127.024376
서초구,2517,서초3교(효령로69길 방면),202006,110,81,191,37.48716,127.024376
서초구,2518,서초3교(효령로70길 방면),202003,1,1,2,37.487484,127.025147
서초구,2518,서초3교(효령로70길 방면),202006,151,120,271,37.487484,127.025147
서초구,2519,서초2교(사임당로 방면),202003,1,1,2,37.491009,127.023521
서초구,2519,서초2교(사임당로 방면),202006,20,16,36,37.491009,127.023521
서초구,2520,서초1교 (진흥아파트 방면),202003,1,1,2,37.496193,127.021011
서초구,2520,서초1교 (진흥아파트 방면),202006,122,90,212,37.496193,127.021011
서초구,2521,서초 크로바타워 앞,202003,1,1,2,37.495564,127.01918
서초구,2521,서초 크로바타워 앞,202006,112,86,198,37.495564,127.01918
서초구,2523,뉴코아 킴스클럽 앞,202003,1,1,2,37.510193,127.007256
서초구,2523,뉴코아 킴스클럽 앞,202006,481,480,961,37.510193,127.007256
서초구,2524,반포쇼핑타운 8동 앞,202003,1,1,2,37.507351,127.008019
서초구,2525,반포쇼핑타운 2동 앞,202006,10,12,22,37.505608,127.002159
서초구,2526,반포경남쇼핑 앞,202003,1,1,2,37.504787,126.999924
서초구,2526,반포경남쇼핑 앞,202006,536,536,1072,37.504787,126.999924
서초구,2527,반포중학교 앞(세화여고 맞은편),202003,1,1,2,37.502674,126.993698
서초구,2527,반포중학교 앞(세화여고 맞은편),202006,183,177,360,37.502674,126.993698
서초구,2528,함지박 사거리,202003,1,1,2,37.493771,126.990067
서초구,2528,함지박 사거리,202006,282,261,543,37.493771,126.990067
서초구,2529,우리은행 방배동지점 앞,202003,1,1,2,37.489918,126.992081
서초구,2529,우리은행 방배동지점 앞,202004,4,4,8,37.489918,126.992081
서초구,2529,우리은행 방배동지점 앞,202006,424,417,841,37.489918,126.992081
서초구,2530,삼호3차아파트 앞,202003,1,1,2,37.497795,126.987068
서초구,2530,삼호3차아파트 앞,202006,492,452,944,37.497795,126.987068
서초구,2531,멤피스아파트 앞,202003,1,1,2,37.494205,126.989357
서초구,2531,멤피스아파트 앞,202006,415,409,824,37.494205,126.989357
서초구,2532,국립국악원 앞,202003,1,1,2,37.478203,127.008781
서초구,2532,국립국악원 앞,202006,46,12,58,37.478203,127.008781
서초구,2533,한가람미술관 앞,202003,1,1,2,37.481098,127.014061
서초구,2533,한가람미술관 앞,202006,92,58,150,37.481098,127.014061
서초구,2534,신흥교(애견훈련소),202003,1,0,1,37.455631,127.080978
서초구,2534,신흥교(애견훈련소),202006,27,20,47,37.455631,127.080978
서초구,2535,신반포역 3번출구 뒤,202003,1,1,2,37.503624,126.997322
서초구,2535,신반포역 3번출구 뒤,202006,146,136,282,37.503624,126.997322
서초구,2536,서초종합체육관 입구,202003,1,1,2,37.459248,127.041634
서초구,2536,서초종합체육관 입구,202006,12,8,20,37.459248,127.041634
서초구,2537,양재역 8번출구 앞,202003,1,1,2,37.482571,127.036438
서초구,2537,양재역 8번출구 앞,202006,215,173,388,37.482571,127.036438
서초구,2538,사평리 공원,202003,1,1,2,37.520267,127.015251
서초구,2538,사평리 공원,202006,487,491,978,37.520267,127.015251
서초구,2539,대한무역투자진흥공사 KOTRA 앞,202006,1,1,2,37.464897,127.044182
서초구,2540,반포천 앞,202003,1,1,2,37.498455,126.996643
서초구,2540,반포천 앞,202004,1,1,2,37.498455,126.996643
서초구,2540,반포천 앞,202006,228,233,461,37.498455,126.996643
서초구,2541,옛골 입구,202003,0,1,1,37.430977,127.070335
서초구,2541,옛골 입구,202006,51,28,79,37.430977,127.070335
서초구,2542,신논현타워 앞,202003,1,1,2,37.505089,127.023911
서초구,2542,신논현타워 앞,202006,320,321,641,37.505089,127.023911
서초구,2543,경문고교 사거리,202003,1,1,2,37.491264,126.982956
서초구,2545,국립중앙도서관(국제회의장옆),202003,1,1,2,37.497688,127.002388
서초구,2545,국립중앙도서관(국제회의장옆),202006,23,23,46,37.497688,127.002388
서초구,2546,한신18차아파트,202003,1,1,2,#N/A,#N/A
서초구,2546,한신18차아파트,202004,3,3,6,#N/A,#N/A
서초구,2547,포드서초서비스센터앞,202006,97,100,197,#N/A,#N/A
서초구,2548,반포1동 자율방범초소 옆,202006,3,4,7,#N/A,#N/A
서초구,2549,LH 서초 4단지 403동,202006,1,2,3,#N/A,#N/A
송파구,2601, 석촌호수 서호사거리,201901,676,658,1334,37.506748,127.098831
송파구,2601, 석촌호수 서호사거리,201902,641,652,1293,37.506748,127.098831
송파구,2601, 석촌호수 서호사거리,201903,1142,1102,2244,37.506748,127.098831
송파구,2601, 석촌호수 서호사거리,201904,1888,1868,3756,37.506748,127.098831
송파구,2601, 석촌호수 서호사거리,201905,2791,2768,5559,37.506748,127.098831
송파구,2601, 석촌호수 서호사거리,201906,3002,2940,5942,37.506748,127.098831
송파구,2601, 석촌호수 서호사거리,201907,2947,2909,5856,37.506748,127.098831
송파구,2601, 석촌호수 서호사거리,201908,2836,2774,5610,37.506748,127.098831
송파구,2601, 석촌호수 서호사거리,201909,2542,2531,5073,37.506748,127.098831
송파구,2601, 석촌호수 서호사거리,201910,2983,2980,5963,37.506748,127.098831
송파구,2601, 석촌호수 서호사거리,201911,1789,1792,3581,37.506748,127.098831
송파구,2601, 석촌호수 서호사거리,201912,953,979,1932,37.506748,127.098831
송파구,2601, 석촌호수 서호사거리,202001,840,835,1675,37.506748,127.098831
송파구,2601, 석촌호수 서호사거리,202002,755,794,1549,37.506748,127.098831
송파구,2601, 석촌호수 서호사거리,202003,1502,1502,3004,37.506748,127.098831
송파구,2601, 석촌호수 서호사거리,202004,1873,1889,3762,37.506748,127.098831
송파구,2601, 석촌호수 서호사거리,202005,2569,2568,5137,37.506748,127.098831
송파구,2601, 석촌호수 서호사거리,202006,2744,2764,5508,37.506748,127.098831
송파구,2603, 송파 글마루 도서관,201901,207,177,384,37.480801,127.130341
송파구,2603, 송파 글마루 도서관,201902,196,174,370,37.480801,127.130341
송파구,2603, 송파 글마루 도서관,201903,374,333,707,37.480801,127.130341
송파구,2603, 송파 글마루 도서관,201904,634,594,1228,37.480801,127.130341
송파구,2603, 송파 글마루 도서관,201905,1091,1067,2158,37.480801,127.130341
송파구,2603, 송파 글마루 도서관,201906,1188,1157,2345,37.480801,127.130341
송파구,2603, 송파 글마루 도서관,201907,1291,1212,2503,37.480801,127.130341
송파구,2603, 송파 글마루 도서관,201908,1104,1018,2122,37.480801,127.130341
송파구,2603, 송파 글마루 도서관,201909,1019,1013,2032,37.480801,127.130341
송파구,2603, 송파 글마루 도서관,201910,1085,1082,2167,37.480801,127.130341
송파구,2603, 송파 글마루 도서관,201911,741,733,1474,37.480801,127.130341
송파구,2603, 송파 글마루 도서관,201912,327,326,653,37.480801,127.130341
송파구,2603, 송파 글마루 도서관,202001,331,320,651,37.480801,127.130341
송파구,2603, 송파 글마루 도서관,202002,288,274,562,37.480801,127.130341
송파구,2603, 송파 글마루 도서관,202003,593,588,1181,37.480801,127.130341
송파구,2603, 송파 글마루 도서관,202004,824,808,1632,37.480801,127.130341
송파구,2603, 송파 글마루 도서관,202005,913,924,1837,37.480801,127.130341
송파구,2603, 송파 글마루 도서관,202006,1135,1109,2244,37.480801,127.130341
송파구,2604, 삼표레미콘 앞,201901,302,313,615,37.531311,127.111282
송파구,2604, 삼표레미콘 앞,201902,245,271,516,37.531311,127.111282
송파구,2604, 삼표레미콘 앞,201903,473,476,949,37.531311,127.111282
송파구,2604, 삼표레미콘 앞,201904,760,858,1618,37.531311,127.111282
송파구,2604, 삼표레미콘 앞,201905,1116,1264,2380,37.531311,127.111282
송파구,2604, 삼표레미콘 앞,201906,1258,1448,2706,37.531311,127.111282
송파구,2604, 삼표레미콘 앞,201907,1208,1438,2646,37.531311,127.111282
송파구,2604, 삼표레미콘 앞,201908,1197,1416,2613,37.531311,127.111282
송파구,2604, 삼표레미콘 앞,201909,1182,1395,2577,37.531311,127.111282
송파구,2604, 삼표레미콘 앞,201910,1413,1639,3052,37.531311,127.111282
송파구,2604, 삼표레미콘 앞,201911,865,1002,1867,37.531311,127.111282
송파구,2604, 삼표레미콘 앞,201912,501,517,1018,37.531311,127.111282
송파구,2604, 삼표레미콘 앞,202001,439,476,915,37.531311,127.111282
송파구,2604, 삼표레미콘 앞,202002,399,412,811,37.531311,127.111282
송파구,2604, 삼표레미콘 앞,202003,761,826,1587,37.531311,127.111282
송파구,2604, 삼표레미콘 앞,202004,994,1022,2016,37.531311,127.111282
송파구,2604, 삼표레미콘 앞,202005,1290,1334,2624,37.531311,127.111282
송파구,2604, 삼표레미콘 앞,202006,1403,1491,2894,37.531311,127.111282
송파구,2605, 복정역 1번 출구 앞,201901,129,119,248,37.471298,127.12709
송파구,2605, 복정역 1번 출구 앞,201902,108,76,184,37.471298,127.12709
송파구,2605, 복정역 1번 출구 앞,201903,234,197,431,37.471298,127.12709
송파구,2605, 복정역 1번 출구 앞,201904,420,329,749,37.471298,127.12709
송파구,2605, 복정역 1번 출구 앞,201905,709,661,1370,37.471298,127.12709
송파구,2605, 복정역 1번 출구 앞,201906,589,576,1165,37.471298,127.12709
송파구,2605, 복정역 1번 출구 앞,201907,520,466,986,37.471298,127.12709
송파구,2605, 복정역 1번 출구 앞,201908,376,362,738,37.471298,127.12709
송파구,2605, 복정역 1번 출구 앞,201909,484,436,920,37.471298,127.12709
송파구,2605, 복정역 1번 출구 앞,201910,615,561,1176,37.471298,127.12709
송파구,2605, 복정역 1번 출구 앞,201911,453,321,774,37.471298,127.12709
송파구,2605, 복정역 1번 출구 앞,201912,152,143,295,37.471298,127.12709
송파구,2605, 복정역 1번 출구 앞,202001,156,147,303,37.471298,127.12709
송파구,2605, 복정역 1번 출구 앞,202002,165,148,313,37.471298,127.12709
송파구,2605, 복정역 1번 출구 앞,202003,348,314,662,37.471298,127.12709
송파구,2605, 복정역 1번 출구 앞,202004,595,592,1187,37.471298,127.12709
송파구,2605, 복정역 1번 출구 앞,202005,582,581,1163,37.471298,127.12709
송파구,2605, 복정역 1번 출구 앞,202006,632,610,1242,37.471298,127.12709
송파구,2606, 위례동주민센터 맞은편 근린공원,201901,143,116,259,37.481739,127.143227
송파구,2606, 위례동주민센터 맞은편 근린공원,201902,128,105,233,37.481739,127.143227
송파구,2606, 위례동주민센터 맞은편 근린공원,201903,288,285,573,37.481739,127.143227
송파구,2606, 위례동주민센터 맞은편 근린공원,201904,428,439,867,37.481739,127.143227
송파구,2606, 위례동주민센터 맞은편 근린공원,201905,792,783,1575,37.481739,127.143227
송파구,2606, 위례동주민센터 맞은편 근린공원,201906,907,881,1788,37.481739,127.143227
송파구,2606, 위례동주민센터 맞은편 근린공원,201907,749,738,1487,37.481739,127.143227
송파구,2606, 위례동주민센터 맞은편 근린공원,201908,810,796,1606,37.481739,127.143227
송파구,2606, 위례동주민센터 맞은편 근린공원,201909,759,765,1524,37.481739,127.143227
송파구,2606, 위례동주민센터 맞은편 근린공원,201910,1004,1001,2005,37.481739,127.143227
송파구,2606, 위례동주민센터 맞은편 근린공원,201911,656,695,1351,37.481739,127.143227
송파구,2606, 위례동주민센터 맞은편 근린공원,201912,381,393,774,37.481739,127.143227
송파구,2606, 위례동주민센터 맞은편 근린공원,202001,390,421,811,37.481739,127.143227
송파구,2606, 위례동주민센터 맞은편 근린공원,202002,438,431,869,37.481739,127.143227
송파구,2606, 위례동주민센터 맞은편 근린공원,202003,805,804,1609,37.481739,127.143227
송파구,2606, 위례동주민센터 맞은편 근린공원,202004,1179,1171,2350,37.481739,127.143227
송파구,2606, 위례동주민센터 맞은편 근린공원,202005,1334,1309,2643,37.481739,127.143227
송파구,2606, 위례동주민센터 맞은편 근린공원,202006,1410,1388,2798,37.481739,127.143227
송파구,2607, 복정역 2번출구 후문 (장지치안센터),201901,110,72,182,37.47065,127.127113
송파구,2607, 복정역 2번출구 후문 (장지치안센터),201902,111,71,182,37.47065,127.127113
송파구,2607, 복정역 2번출구 후문 (장지치안센터),201903,280,200,480,37.47065,127.127113
송파구,2607, 복정역 2번출구 후문 (장지치안센터),201904,518,479,997,37.47065,127.127113
송파구,2607, 복정역 2번출구 후문 (장지치안센터),201905,891,816,1707,37.47065,127.127113
송파구,2607, 복정역 2번출구 후문 (장지치안센터),201906,871,826,1697,37.47065,127.127113
송파구,2607, 복정역 2번출구 후문 (장지치안센터),201907,901,864,1765,37.47065,127.127113
송파구,2607, 복정역 2번출구 후문 (장지치안센터),201908,753,738,1491,37.47065,127.127113
송파구,2607, 복정역 2번출구 후문 (장지치안센터),201909,885,867,1752,37.47065,127.127113
송파구,2607, 복정역 2번출구 후문 (장지치안센터),201910,965,941,1906,37.47065,127.127113
송파구,2607, 복정역 2번출구 후문 (장지치안센터),201911,578,488,1066,37.47065,127.127113
송파구,2607, 복정역 2번출구 후문 (장지치안센터),201912,234,218,452,37.47065,127.127113
송파구,2607, 복정역 2번출구 후문 (장지치안센터),202001,271,244,515,37.47065,127.127113
송파구,2607, 복정역 2번출구 후문 (장지치안센터),202002,257,258,515,37.47065,127.127113
송파구,2607, 복정역 2번출구 후문 (장지치안센터),202003,639,621,1260,37.47065,127.127113
송파구,2607, 복정역 2번출구 후문 (장지치안센터),202004,847,841,1688,37.47065,127.127113
송파구,2607, 복정역 2번출구 후문 (장지치안센터),202005,1003,983,1986,37.47065,127.127113
송파구,2607, 복정역 2번출구 후문 (장지치안센터),202006,1115,1057,2172,37.47065,127.127113
송파구,2608, 송파구청,201901,240,244,484,37.514359,127.106194
송파구,2608, 송파구청,201902,354,351,705,37.514359,127.106194
송파구,2608, 송파구청,201903,706,702,1408,37.514359,127.106194
송파구,2608, 송파구청,201904,1191,1173,2364,37.514359,127.106194
송파구,2608, 송파구청,201905,1918,1912,3830,37.514359,127.106194
송파구,2608, 송파구청,201906,2297,2322,4619,37.514359,127.106194
송파구,2608, 송파구청,201907,1952,1962,3914,37.514359,127.106194
송파구,2608, 송파구청,201908,1831,1844,3675,37.514359,127.106194
송파구,2608, 송파구청,201909,2140,2168,4308,37.514359,127.106194
송파구,2608, 송파구청,201910,2716,2727,5443,37.514359,127.106194
송파구,2608, 송파구청,201911,1529,1543,3072,37.514359,127.106194
송파구,2608, 송파구청,201912,916,928,1844,37.514359,127.106194
송파구,2608, 송파구청,202001,800,794,1594,37.514359,127.106194
송파구,2608, 송파구청,202002,535,534,1069,37.514359,127.106194
송파구,2608, 송파구청,202003,1122,1124,2246,37.514359,127.106194
송파구,2608, 송파구청,202004,1317,1320,2637,37.514359,127.106194
송파구,2608, 송파구청,202005,1411,1435,2846,37.514359,127.106194
송파구,2608, 송파구청,202006,1673,1674,3347,37.514359,127.106194
송파구,2609, 보성중고등학교 후문 앞,201901,29,16,45,37.520489,127.135201
송파구,2609, 보성중고등학교 후문 앞,201902,36,35,71,37.520489,127.135201
송파구,2609, 보성중고등학교 후문 앞,201903,39,40,79,37.520489,127.135201
송파구,2609, 보성중고등학교 후문 앞,201904,55,40,95,37.520489,127.135201
송파구,2609, 보성중고등학교 후문 앞,201905,152,78,230,37.520489,127.135201
송파구,2609, 보성중고등학교 후문 앞,201906,194,98,292,37.520489,127.135201
송파구,2609, 보성중고등학교 후문 앞,201907,216,106,322,37.520489,127.135201
송파구,2609, 보성중고등학교 후문 앞,201908,229,150,379,37.520489,127.135201
송파구,2609, 보성중고등학교 후문 앞,201909,170,105,275,37.520489,127.135201
송파구,2609, 보성중고등학교 후문 앞,201910,152,118,270,37.520489,127.135201
송파구,2609, 보성중고등학교 후문 앞,201911,163,125,288,37.520489,127.135201
송파구,2609, 보성중고등학교 후문 앞,201912,74,60,134,37.520489,127.135201
송파구,2609, 보성중고등학교 후문 앞,202001,71,41,112,37.520489,127.135201
송파구,2609, 보성중고등학교 후문 앞,202002,56,40,96,37.520489,127.135201
송파구,2609, 보성중고등학교 후문 앞,202003,328,310,638,37.520489,127.135201
송파구,2609, 보성중고등학교 후문 앞,202004,159,159,318,37.520489,127.135201
송파구,2609, 보성중고등학교 후문 앞,202005,318,283,601,37.520489,127.135201
송파구,2609, 보성중고등학교 후문 앞,202006,205,154,359,37.520489,127.135201
송파구,2610, 여흥레이크빌 앞 (석촌호수 까페거리),201901,239,216,455,37.510441,127.106377
송파구,2610, 여흥레이크빌 앞 (석촌호수 까페거리),201902,295,273,568,37.510441,127.106377
송파구,2610, 여흥레이크빌 앞 (석촌호수 까페거리),201903,542,525,1067,37.510441,127.106377
송파구,2610, 여흥레이크빌 앞 (석촌호수 까페거리),201904,1069,939,2008,37.510441,127.106377
송파구,2610, 여흥레이크빌 앞 (석촌호수 까페거리),201905,1622,1566,3188,37.510441,127.106377
송파구,2610, 여흥레이크빌 앞 (석촌호수 까페거리),201906,1906,1834,3740,37.510441,127.106377
송파구,2610, 여흥레이크빌 앞 (석촌호수 까페거리),201907,1940,1897,3837,37.510441,127.106377
송파구,2610, 여흥레이크빌 앞 (석촌호수 까페거리),201908,1824,1805,3629,37.510441,127.106377
송파구,2610, 여흥레이크빌 앞 (석촌호수 까페거리),201909,1721,1699,3420,37.510441,127.106377
송파구,2610, 여흥레이크빌 앞 (석촌호수 까페거리),201910,1442,1444,2886,37.510441,127.106377
송파구,2610, 여흥레이크빌 앞 (석촌호수 까페거리),201911,224,221,445,37.510441,127.106377
송파구,2610, 여흥레이크빌 앞 (석촌호수 까페거리),201912,629,639,1268,37.510441,127.106377
송파구,2610, 여흥레이크빌 앞 (석촌호수 까페거리),202001,740,696,1436,37.510441,127.106377
송파구,2610, 여흥레이크빌 앞 (석촌호수 까페거리),202002,615,609,1224,37.510441,127.106377
송파구,2610, 여흥레이크빌 앞 (석촌호수 까페거리),202003,1049,959,2008,37.510441,127.106377
송파구,2610, 여흥레이크빌 앞 (석촌호수 까페거리),202004,1423,1418,2841,37.510441,127.106377
송파구,2610, 여흥레이크빌 앞 (석촌호수 까페거리),202005,1675,1681,3356,37.510441,127.106377
송파구,2610, 여흥레이크빌 앞 (석촌호수 까페거리),202006,2152,2150,4302,37.510441,127.106377
송파구,2611, 송파지역자활센터 뒤,201901,111,122,233,37.536331,127.11618
송파구,2611, 송파지역자활센터 뒤,201902,159,181,340,37.536331,127.11618
송파구,2611, 송파지역자활센터 뒤,201903,339,371,710,37.536331,127.11618
송파구,2611, 송파지역자활센터 뒤,201904,631,743,1374,37.536331,127.11618
송파구,2611, 송파지역자활센터 뒤,201905,1049,1336,2385,37.536331,127.11618
송파구,2611, 송파지역자활센터 뒤,201906,1170,1668,2838,37.536331,127.11618
송파구,2611, 송파지역자활센터 뒤,201907,1367,1818,3185,37.536331,127.11618
송파구,2611, 송파지역자활센터 뒤,201908,1393,1980,3373,37.536331,127.11618
송파구,2611, 송파지역자활센터 뒤,201909,1370,1824,3194,37.536331,127.11618
송파구,2611, 송파지역자활센터 뒤,201910,1733,2153,3886,37.536331,127.11618
송파구,2611, 송파지역자활센터 뒤,201911,1150,1403,2553,37.536331,127.11618
송파구,2611, 송파지역자활센터 뒤,201912,744,844,1588,37.536331,127.11618
송파구,2611, 송파지역자활센터 뒤,202001,614,718,1332,37.536331,127.11618
송파구,2611, 송파지역자활센터 뒤,202002,662,733,1395,37.536331,127.11618
송파구,2611, 송파지역자활센터 뒤,202003,1156,1370,2526,37.536331,127.11618
송파구,2611, 송파지역자활센터 뒤,202004,1590,1845,3435,37.536331,127.11618
송파구,2611, 송파지역자활센터 뒤,202005,1945,2211,4156,37.536331,127.11618
송파구,2611, 송파지역자활센터 뒤,202006,2178,2537,4715,37.536331,127.11618
송파구,2612, 문정·가락 대여소 앞,201901,5,3,8,37.489071,127.109299
송파구,2612, 문정·가락 대여소 앞,201903,39,28,67,37.489071,127.109299
송파구,2612, 문정·가락 대여소 앞,201904,118,109,227,37.489071,127.109299
송파구,2612, 문정·가락 대여소 앞,201905,154,142,296,37.489071,127.109299
송파구,2612, 문정·가락 대여소 앞,201906,127,125,252,37.489071,127.109299
송파구,2612, 문정·가락 대여소 앞,201907,130,130,260,37.489071,127.109299
송파구,2612, 문정·가락 대여소 앞,201908,100,102,202,37.489071,127.109299
송파구,2612, 문정·가락 대여소 앞,201909,98,92,190,37.489071,127.109299
송파구,2612, 문정·가락 대여소 앞,201910,91,92,183,37.489071,127.109299
송파구,2612, 문정·가락 대여소 앞,201911,33,34,67,37.489071,127.109299
송파구,2612, 문정·가락 대여소 앞,201912,20,16,36,37.489071,127.109299
송파구,2612, 문정·가락 대여소 앞,202001,36,24,60,37.489071,127.109299
송파구,2612, 문정·가락 대여소 앞,202002,22,24,46,37.489071,127.109299
송파구,2612, 문정·가락 대여소 앞,202003,95,92,187,37.489071,127.109299
송파구,2612, 문정·가락 대여소 앞,202004,139,138,277,37.489071,127.109299
송파구,2612, 문정·가락 대여소 앞,202005,111,110,221,37.489071,127.109299
송파구,2612, 문정·가락 대여소 앞,202006,81,84,165,37.489071,127.109299
송파구,2613, 잠실나들목,201901,141,119,260,37.516781,127.090492
송파구,2613, 잠실나들목,201902,252,289,541,37.516781,127.090492
송파구,2613, 잠실나들목,201903,654,737,1391,37.516781,127.090492
송파구,2613, 잠실나들목,201904,1767,2069,3836,37.516781,127.090492
송파구,2613, 잠실나들목,201905,3668,3989,7657,37.516781,127.090492
송파구,2613, 잠실나들목,201906,3453,3607,7060,37.516781,127.090492
송파구,2613, 잠실나들목,201907,2999,3002,6001,37.516781,127.090492
송파구,2613, 잠실나들목,201908,3957,4096,8053,37.516781,127.090492
송파구,2613, 잠실나들목,201909,4023,4153,8176,37.516781,127.090492
송파구,2613, 잠실나들목,201910,3776,3957,7733,37.516781,127.090492
송파구,2613, 잠실나들목,201911,1355,1377,2732,37.516781,127.090492
송파구,2613, 잠실나들목,201912,532,530,1062,37.516781,127.090492
송파구,2613, 잠실나들목,202001,574,611,1185,37.516781,127.090492
송파구,2613, 잠실나들목,202002,739,732,1471,37.516781,127.090492
송파구,2613, 잠실나들목,202003,3940,4435,8375,37.516781,127.090492
송파구,2613, 잠실나들목,202004,4711,5032,9743,37.516781,127.090492
송파구,2613, 잠실나들목,202005,5753,5962,11715,37.516781,127.090492
송파구,2613, 잠실나들목,202006,4779,4868,9647,37.516781,127.090492
송파구,2614, 가락고등학교 앞,201901,234,204,438,37.501862,127.117233
송파구,2614, 가락고등학교 앞,201902,336,267,603,37.501862,127.117233
송파구,2614, 가락고등학교 앞,201903,584,475,1059,37.501862,127.117233
송파구,2614, 가락고등학교 앞,201904,902,782,1684,37.501862,127.117233
송파구,2614, 가락고등학교 앞,201905,1492,1438,2930,37.501862,127.117233
송파구,2614, 가락고등학교 앞,201906,1545,1476,3021,37.501862,127.117233
송파구,2614, 가락고등학교 앞,201907,1564,1523,3087,37.501862,127.117233
송파구,2614, 가락고등학교 앞,201908,1530,1509,3039,37.501862,127.117233
송파구,2614, 가락고등학교 앞,201909,1548,1530,3078,37.501862,127.117233
송파구,2614, 가락고등학교 앞,201910,1728,1735,3463,37.501862,127.117233
송파구,2614, 가락고등학교 앞,201911,1174,1071,2245,37.501862,127.117233
송파구,2614, 가락고등학교 앞,201912,606,555,1161,37.501862,127.117233
송파구,2614, 가락고등학교 앞,202001,574,500,1074,37.501862,127.117233
송파구,2614, 가락고등학교 앞,202002,652,611,1263,37.501862,127.117233
송파구,2614, 가락고등학교 앞,202003,1206,1132,2338,37.501862,127.117233
송파구,2614, 가락고등학교 앞,202004,1316,1234,2550,37.501862,127.117233
송파구,2614, 가락고등학교 앞,202005,1311,1306,2617,37.501862,127.117233
송파구,2614, 가락고등학교 앞,202006,1254,1226,2480,37.501862,127.117233
송파구,2615, 테라타워2,201901,337,329,666,37.48835,127.120781
송파구,2615, 테라타워2,201902,178,181,359,37.48835,127.120781
송파구,2615, 테라타워2,201903,517,504,1021,37.48835,127.120781
송파구,2615, 테라타워2,201904,1181,1169,2350,37.48835,127.120781
송파구,2615, 테라타워2,201905,1957,1931,3888,37.48835,127.120781
송파구,2615, 테라타워2,201906,2172,2186,4358,37.48835,127.120781
송파구,2615, 테라타워2,201907,2439,2444,4883,37.48835,127.120781
송파구,2615, 테라타워2,201908,2151,2146,4297,37.48835,127.120781
송파구,2615, 테라타워2,201909,2304,2317,4621,37.48835,127.120781
송파구,2615, 테라타워2,201910,2919,2927,5846,37.48835,127.120781
송파구,2615, 테라타워2,201911,1734,1726,3460,37.48835,127.120781
송파구,2615, 테라타워2,201912,972,959,1931,37.48835,127.120781
송파구,2615, 테라타워2,202001,831,824,1655,37.48835,127.120781
송파구,2615, 테라타워2,202002,768,765,1533,37.48835,127.120781
송파구,2615, 테라타워2,202003,1555,1544,3099,37.48835,127.120781
송파구,2615, 테라타워2,202004,2198,2185,4383,37.48835,127.120781
송파구,2615, 테라타워2,202005,2322,2327,4649,37.48835,127.120781
송파구,2615, 테라타워2,202006,2700,2702,5402,37.48835,127.120781
송파구,2616, 거여동 사거리,201901,58,49,107,37.496078,127.140106
송파구,2616, 거여동 사거리,201902,34,13,47,37.496078,127.140106
송파구,2616, 거여동 사거리,201903,89,61,150,37.496078,127.140106
송파구,2616, 거여동 사거리,201904,226,154,380,37.496078,127.140106
송파구,2616, 거여동 사거리,201905,360,262,622,37.496078,127.140106
송파구,2616, 거여동 사거리,201906,452,284,736,37.496078,127.140106
송파구,2616, 거여동 사거리,201907,521,276,797,37.496078,127.140106
송파구,2616, 거여동 사거리,201908,477,272,749,37.496078,127.140106
송파구,2616, 거여동 사거리,201909,418,280,698,37.496078,127.140106
송파구,2616, 거여동 사거리,201910,624,377,1001,37.496078,127.140106
송파구,2616, 거여동 사거리,201911,542,481,1023,37.496078,127.140106
송파구,2616, 거여동 사거리,201912,353,351,704,37.496078,127.140106
송파구,2616, 거여동 사거리,202001,237,193,430,37.496078,127.140106
송파구,2616, 거여동 사거리,202002,197,160,357,37.496078,127.140106
송파구,2616, 거여동 사거리,202003,382,338,720,37.496078,127.140106
송파구,2616, 거여동 사거리,202004,569,467,1036,37.496078,127.140106
송파구,2616, 거여동 사거리,202005,663,599,1262,37.496078,127.140106
송파구,2616, 거여동 사거리,202006,527,488,1015,37.496078,127.140106
송파구,2617, 가락삼환아파트 앞,201901,164,108,272,37.496181,127.138031
송파구,2617, 가락삼환아파트 앞,201902,209,152,361,37.496181,127.138031
송파구,2617, 가락삼환아파트 앞,201903,393,312,705,37.496181,127.138031
송파구,2617, 가락삼환아파트 앞,201904,706,629,1335,37.496181,127.138031
송파구,2617, 가락삼환아파트 앞,201905,1238,1148,2386,37.496181,127.138031
송파구,2617, 가락삼환아파트 앞,201906,1387,1318,2705,37.496181,127.138031
송파구,2617, 가락삼환아파트 앞,201907,1417,1307,2724,37.496181,127.138031
송파구,2617, 가락삼환아파트 앞,201908,1233,1135,2368,37.496181,127.138031
송파구,2617, 가락삼환아파트 앞,201909,1288,1147,2435,37.496181,127.138031
송파구,2617, 가락삼환아파트 앞,201910,1460,1329,2789,37.496181,127.138031
송파구,2617, 가락삼환아파트 앞,201911,1032,819,1851,37.496181,127.138031
송파구,2617, 가락삼환아파트 앞,201912,526,461,987,37.496181,127.138031
송파구,2617, 가락삼환아파트 앞,202001,470,418,888,37.496181,127.138031
송파구,2617, 가락삼환아파트 앞,202002,459,394,853,37.496181,127.138031
송파구,2617, 가락삼환아파트 앞,202003,1088,929,2017,37.496181,127.138031
송파구,2617, 가락삼환아파트 앞,202004,1484,1366,2850,37.496181,127.138031
송파구,2617, 가락삼환아파트 앞,202005,1560,1458,3018,37.496181,127.138031
송파구,2617, 가락삼환아파트 앞,202006,1673,1563,3236,37.496181,127.138031
송파구,2618, 삼전역 1번출구,201901,314,309,623,37.504711,127.087563
송파구,2618, 삼전역 1번출구,201902,264,281,545,37.504711,127.087563
송파구,2618, 삼전역 1번출구,201903,548,585,1133,37.504711,127.087563
송파구,2618, 삼전역 1번출구,201904,861,891,1752,37.504711,127.087563
송파구,2618, 삼전역 1번출구,201905,1612,1630,3242,37.504711,127.087563
송파구,2618, 삼전역 1번출구,201906,1804,1842,3646,37.504711,127.087563
송파구,2618, 삼전역 1번출구,201907,1760,1797,3557,37.504711,127.087563
송파구,2618, 삼전역 1번출구,201908,1704,1736,3440,37.504711,127.087563
송파구,2618, 삼전역 1번출구,201909,1733,1782,3515,37.504711,127.087563
송파구,2618, 삼전역 1번출구,201910,2093,2108,4201,37.504711,127.087563
송파구,2618, 삼전역 1번출구,201911,1226,1200,2426,37.504711,127.087563
송파구,2618, 삼전역 1번출구,201912,677,714,1391,37.504711,127.087563
송파구,2618, 삼전역 1번출구,202001,567,577,1144,37.504711,127.087563
송파구,2618, 삼전역 1번출구,202002,487,498,985,37.504711,127.087563
송파구,2618, 삼전역 1번출구,202003,1045,1123,2168,37.504711,127.087563
송파구,2618, 삼전역 1번출구,202004,1684,1768,3452,37.504711,127.087563
송파구,2618, 삼전역 1번출구,202005,2046,2163,4209,37.504711,127.087563
송파구,2618, 삼전역 1번출구,202006,1675,1746,3421,37.504711,127.087563
송파구,2619, 석촌고분역 4번출구,201901,235,268,503,37.502338,127.096443
송파구,2619, 석촌고분역 4번출구,201902,566,634,1200,37.502338,127.096443
송파구,2619, 석촌고분역 4번출구,201903,1156,1394,2550,37.502338,127.096443
송파구,2619, 석촌고분역 4번출구,201904,1805,2250,4055,37.502338,127.096443
송파구,2619, 석촌고분역 4번출구,201905,3211,3912,7123,37.502338,127.096443
송파구,2619, 석촌고분역 4번출구,201906,3734,4536,8270,37.502338,127.096443
송파구,2619, 석촌고분역 4번출구,201907,3677,4478,8155,37.502338,127.096443
송파구,2619, 석촌고분역 4번출구,201908,3311,4072,7383,37.502338,127.096443
송파구,2619, 석촌고분역 4번출구,201909,3365,4196,7561,37.502338,127.096443
송파구,2619, 석촌고분역 4번출구,201910,4105,5057,9162,37.502338,127.096443
송파구,2619, 석촌고분역 4번출구,201911,2390,2962,5352,37.502338,127.096443
송파구,2619, 석촌고분역 4번출구,201912,1419,1581,3000,37.502338,127.096443
송파구,2619, 석촌고분역 4번출구,202001,1207,1525,2732,37.502338,127.096443
송파구,2619, 석촌고분역 4번출구,202002,1127,1421,2548,37.502338,127.096443
송파구,2619, 석촌고분역 4번출구,202003,2322,2875,5197,37.502338,127.096443
송파구,2619, 석촌고분역 4번출구,202004,2949,3769,6718,37.502338,127.096443
송파구,2619, 석촌고분역 4번출구,202005,3434,3972,7406,37.502338,127.096443
송파구,2619, 석촌고분역 4번출구,202006,3098,3577,6675,37.502338,127.096443
송파구,2620, 송파나루역 4번 출구옆,201901,74,101,175,37.509979,127.112312
송파구,2620, 송파나루역 4번 출구옆,201902,456,562,1018,37.509979,127.112312
송파구,2620, 송파나루역 4번 출구옆,201903,1081,1337,2418,37.509979,127.112312
송파구,2620, 송파나루역 4번 출구옆,201904,2152,2520,4672,37.509979,127.112312
송파구,2620, 송파나루역 4번 출구옆,201905,3893,4158,8051,37.509979,127.112312
송파구,2620, 송파나루역 4번 출구옆,201906,4165,4268,8433,37.509979,127.112312
송파구,2620, 송파나루역 4번 출구옆,201907,4334,4472,8806,37.509979,127.112312
송파구,2620, 송파나루역 4번 출구옆,201908,3873,3903,7776,37.509979,127.112312
송파구,2620, 송파나루역 4번 출구옆,201909,4011,4164,8175,37.509979,127.112312
송파구,2620, 송파나루역 4번 출구옆,201910,4483,4771,9254,37.509979,127.112312
송파구,2620, 송파나루역 4번 출구옆,201911,2512,2846,5358,37.509979,127.112312
송파구,2620, 송파나루역 4번 출구옆,201912,1377,1474,2851,37.509979,127.112312
송파구,2620, 송파나루역 4번 출구옆,202001,1136,1306,2442,37.509979,127.112312
송파구,2620, 송파나루역 4번 출구옆,202002,1196,1331,2527,37.509979,127.112312
송파구,2620, 송파나루역 4번 출구옆,202003,2397,2687,5084,37.509979,127.112312
송파구,2620, 송파나루역 4번 출구옆,202004,3379,3594,6973,37.509979,127.112312
송파구,2620, 송파나루역 4번 출구옆,202005,4279,4319,8598,37.509979,127.112312
송파구,2620, 송파나루역 4번 출구옆,202006,4483,4544,9027,37.509979,127.112312
송파구,2621, 한성백제역 2번 출구,201901,274,274,548,37.516659,127.116257
송파구,2621, 한성백제역 2번 출구,201902,446,438,884,37.516659,127.116257
송파구,2621, 한성백제역 2번 출구,201903,1006,1037,2043,37.516659,127.116257
송파구,2621, 한성백제역 2번 출구,201904,2321,2332,4653,37.516659,127.116257
송파구,2621, 한성백제역 2번 출구,201905,3924,3833,7757,37.516659,127.116257
송파구,2621, 한성백제역 2번 출구,201906,3932,3824,7756,37.516659,127.116257
송파구,2621, 한성백제역 2번 출구,201907,3376,3173,6549,37.516659,127.116257
송파구,2621, 한성백제역 2번 출구,201908,3724,3661,7385,37.516659,127.116257
송파구,2621, 한성백제역 2번 출구,201909,4221,4113,8334,37.516659,127.116257
송파구,2621, 한성백제역 2번 출구,201910,5039,4941,9980,37.516659,127.116257
송파구,2621, 한성백제역 2번 출구,201911,2538,2521,5059,37.516659,127.116257
송파구,2621, 한성백제역 2번 출구,201912,1067,1093,2160,37.516659,127.116257
송파구,2621, 한성백제역 2번 출구,202001,983,1045,2028,37.516659,127.116257
송파구,2621, 한성백제역 2번 출구,202002,1048,1047,2095,37.516659,127.116257
송파구,2621, 한성백제역 2번 출구,202003,3185,3204,6389,37.516659,127.116257
송파구,2621, 한성백제역 2번 출구,202004,4073,4063,8136,37.516659,127.116257
송파구,2621, 한성백제역 2번 출구,202005,4665,4683,9348,37.516659,127.116257
송파구,2621, 한성백제역 2번 출구,202006,5305,5255,10560,37.516659,127.116257
송파구,2622, 올림픽공원역 3번출구,201901,455,414,869,37.516258,127.130592
송파구,2622, 올림픽공원역 3번출구,201902,547,515,1062,37.516258,127.130592
송파구,2622, 올림픽공원역 3번출구,201903,1334,1291,2625,37.516258,127.130592
송파구,2622, 올림픽공원역 3번출구,201904,2888,2814,5702,37.516258,127.130592
송파구,2622, 올림픽공원역 3번출구,201905,4762,4735,9497,37.516258,127.130592
송파구,2622, 올림픽공원역 3번출구,201906,4795,4838,9633,37.516258,127.130592
송파구,2622, 올림픽공원역 3번출구,201907,4001,4000,8001,37.516258,127.130592
송파구,2622, 올림픽공원역 3번출구,201908,4831,4796,9627,37.516258,127.130592
송파구,2622, 올림픽공원역 3번출구,201909,5028,5005,10033,37.516258,127.130592
송파구,2622, 올림픽공원역 3번출구,201910,6448,6336,12784,37.516258,127.130592
송파구,2622, 올림픽공원역 3번출구,201911,3085,3040,6125,37.516258,127.130592
송파구,2622, 올림픽공원역 3번출구,201912,1234,1195,2429,37.516258,127.130592
송파구,2622, 올림픽공원역 3번출구,202001,1439,1295,2734,37.516258,127.130592
송파구,2622, 올림픽공원역 3번출구,202002,1426,1284,2710,37.516258,127.130592
송파구,2622, 올림픽공원역 3번출구,202003,4628,4589,9217,37.516258,127.130592
송파구,2622, 올림픽공원역 3번출구,202004,5500,5391,10891,37.516258,127.130592
송파구,2622, 올림픽공원역 3번출구,202005,6332,6303,12635,37.516258,127.130592
송파구,2622, 올림픽공원역 3번출구,202006,5673,5516,11189,37.516258,127.130592
송파구,2623,석촌동 주민센터,202003,1,1,2,37.503624,127.103554
송파구,2623,석촌동 주민센터,202004,5,4,9,37.503624,127.103554
송파구,2623,석촌동 주민센터,202005,480,486,966,37.503624,127.103554
송파구,2623,석촌동 주민센터,202006,1393,1399,2792,37.503624,127.103554
송파구,2625,가락1동 주민센터,202003,1,1,2,37.495876,127.108505
송파구,2625,가락1동 주민센터,202005,296,286,582,37.495876,127.108505
송파구,2625,가락1동 주민센터,202006,767,767,1534,37.495876,127.108505
송파구,2626,"경찰병원역 1,2번 출구 사이",202003,1,1,2,37.49543,127.123108
송파구,2626,"경찰병원역 1,2번 출구 사이",202004,5,5,10,37.49543,127.123108
송파구,2626,"경찰병원역 1,2번 출구 사이",202005,1,0,1,37.49543,127.123108
송파구,2626,"경찰병원역 1,2번 출구 사이",202006,271,268,539,37.49543,127.123108
송파구,2627,문정시영아파트 5동 앞 공원,202003,1,1,2,37.491123,127.135109
송파구,2628,문정역 1번출구,202003,1,1,2,37.486698,127.122444
송파구,2628,문정역 1번출구,202005,316,318,634,37.486698,127.122444
송파구,2628,문정역 1번출구,202006,1047,1035,2082,37.486698,127.122444
송파구,2629,문정동 힐스데이트 에코 송파,202003,1,1,2,37.485218,127.115402
송파구,2629,문정동 힐스데이트 에코 송파,202004,2,1,3,37.485218,127.115402
송파구,2629,문정동 힐스데이트 에코 송파,202006,798,809,1607,37.485218,127.115402
송파구,2630,서울방이동 고분군,202003,1,1,2,37.507866,127.116989
송파구,2630,서울방이동 고분군,202005,378,376,754,37.507866,127.116989
송파구,2630,서울방이동 고분군,202006,1359,1321,2680,37.507866,127.116989
송파구,2631,배명고등학교,202003,1,1,2,37.497414,127.096306
송파구,2631,배명고등학교,202005,269,276,545,37.497414,127.096306
송파구,2631,배명고등학교,202006,754,766,1520,37.497414,127.096306
송파구,2632,석촌고분역 2번 출구,202003,1,1,2,37.502644,127.097397
송파구,2632,석촌고분역 2번 출구,202005,331,334,665,37.502644,127.097397
송파구,2632,석촌고분역 2번 출구,202006,1232,1237,2469,37.502644,127.097397
송파구,2633,송파학사 옆,202003,1,0,1,37.47813,127.147217
송파구,2633,송파학사 옆,202005,207,206,413,37.47813,127.147217
송파구,2633,송파학사 옆,202006,733,696,1429,37.47813,127.147217
송파구,2634,위례포레샤인아파트 2318동,202003,1,1,2,37.477211,127.137177
송파구,2634,위례포레샤인아파트 2318동,202004,1,1,2,37.477211,127.137177
송파구,2634,위례포레샤인아파트 2318동,202005,157,159,316,37.477211,127.137177
송파구,2634,위례포레샤인아파트 2318동,202006,473,468,941,37.477211,127.137177
송파구,2635,잠실새내역 1번출구,202003,2,2,4,37.511295,127.086739
송파구,2635,잠실새내역 1번출구,202005,213,213,426,37.511295,127.086739
송파구,2635,잠실새내역 1번출구,202006,697,694,1391,37.511295,127.086739
송파구,2637,잠실월드 메르디앙,202005,421,425,846,37.511463,127.078812
송파구,2637,잠실월드 메르디앙,202006,1337,1333,2670,37.511463,127.078812
송파구,2638,쌍용아파트,202005,0,1,1,37.526814,127.118149
송파구,2639,석촌역 8번출구,202003,1,1,2,37.505505,127.106575
송파구,2639,석촌역 8번출구,202004,1,1,2,37.505505,127.106575
송파구,2639,석촌역 8번출구,202005,495,491,986,37.505505,127.106575
송파구,2639,석촌역 8번출구,202006,1548,1554,3102,37.505505,127.106575
송파구,2640,서울아산병원,202003,1,1,2,#N/A,#N/A
송파구,2641,송파역 4번출구,202003,1,1,2,37.497726,127.107033
송파구,2641,송파역 4번출구,202005,802,805,1607,37.497726,127.107033
송파구,2641,송파역 4번출구,202006,2203,2190,4393,37.497726,127.107033
송파구,2642,마천동 성내천 쉼터,202003,1,1,2,37.501495,127.147781
송파구,2642,마천동 성내천 쉼터,202005,423,428,851,37.501495,127.147781
송파구,2642,마천동 성내천 쉼터,202006,931,936,1867,37.501495,127.147781
송파구,2643,풍납중학교 측면,202003,1,1,2,37.525291,127.112473
송파구,2643,풍납중학교 측면,202005,723,726,1449,37.525291,127.112473
송파구,2643,풍납중학교 측면,202006,1829,1840,3669,37.525291,127.112473
송파구,2644,성내5교 (GS주유소),202003,1,1,2,37.501984,127.138046
송파구,2644,성내5교 (GS주유소),202004,1,1,2,37.501984,127.138046
송파구,2644,성내5교 (GS주유소),202005,251,251,502,37.501984,127.138046
송파구,2644,성내5교 (GS주유소),202006,820,800,1620,37.501984,127.138046
송파구,2645,잠실나들목2(엘스아파트136동),202003,1,0,1,37.515049,127.081612
송파구,2645,잠실나들목2(엘스아파트136동),202005,1207,1215,2422,37.515049,127.081612
송파구,2645,잠실나들목2(엘스아파트136동),202006,2574,2569,5143,37.515049,127.081612
송파구,2646,레이클펠리스101동앞,202003,1,1,2,37.507759,127.091293
송파구,2646,레이클펠리스101동앞,202004,1,1,2,37.507759,127.091293
송파구,2646,레이클펠리스101동앞,202005,460,457,917,37.507759,127.091293
송파구,2646,레이클펠리스101동앞,202006,1310,1295,2605,37.507759,127.091293
송파구,2647,잠실 자전거 수리센터 앞,202003,1,1,2,37.51157,127.101074
송파구,2647,잠실 자전거 수리센터 앞,202005,287,288,575,37.51157,127.101074
송파구,2647,잠실 자전거 수리센터 앞,202006,749,747,1496,37.51157,127.101074
송파구,2648,헬리오시티 112동 앞,202003,1,1,2,37.494698,127.104645
송파구,2648,헬리오시티 112동 앞,202005,470,477,947,37.494698,127.104645
송파구,2648,헬리오시티 112동 앞,202006,1209,1219,2428,37.494698,127.104645
송파구,2649,오금공원사거리2,202003,1,1,2,37.505444,127.132332
송파구,2649,오금공원사거리2,202004,1,1,2,37.505444,127.132332
송파구,2649,오금공원사거리2,202005,85,80,165,37.505444,127.132332
송파구,2649,오금공원사거리2,202006,221,198,419,37.505444,127.132332
송파구,2650,위례22단지 2208동 다리앞,202003,1,1,2,37.47855,127.138138
송파구,2651,경찰병원역 3번출구 앞,202003,1,1,2,37.495773,127.12458
송파구,2651,경찰병원역 3번출구 앞,202005,377,374,751,37.495773,127.12458
송파구,2651,경찰병원역 3번출구 앞,202006,968,960,1928,37.495773,127.12458
송파구,2652,송파 레미니스1단지 102동 앞,202003,1,1,2,37.508831,127.134262
송파구,2652,송파 레미니스1단지 102동 앞,202005,184,168,352,37.508831,127.134262
송파구,2652,송파 레미니스1단지 102동 앞,202006,579,556,1135,37.508831,127.134262
송파구,2653,올림픽공원사거리(선수촌아파트),202003,1,1,2,37.511498,127.12912
송파구,2653,올림픽공원사거리(선수촌아파트),202005,507,504,1011,37.511498,127.12912
송파구,2653,올림픽공원사거리(선수촌아파트),202006,1172,1158,2330,37.511498,127.12912
송파구,2654,올림픽선수촌아파트 136동 앞,202005,193,191,384,37.509975,127.133698
송파구,2654,올림픽선수촌아파트 136동 앞,202006,517,506,1023,37.509975,127.133698
송파구,2655,송이공원,202003,1,1,2,37.50058,127.118843
송파구,2655,송이공원,202005,296,299,595,37.50058,127.118843
송파구,2655,송이공원,202006,984,970,1954,37.50058,127.118843
송파구,2656,풍납동 아이파크 107동 앞,202006,3,3,6,37.524525,127.11451
송파구,2657,송파 파인타운 11단지,202006,8,10,18,37.478825,127.132668
송파구,2658,가락몰 업무동,202006,116,96,212,#N/A,#N/A
송파구,2659,서울친환경유통센터,202006,23,21,44,#N/A,#N/A
강서구,2701, 마곡나루역 5번출구 뒤편,201901,930,905,1835,37.565201,126.827316
강서구,2701, 마곡나루역 5번출구 뒤편,201902,898,893,1791,37.565201,126.827316
강서구,2701, 마곡나루역 5번출구 뒤편,201903,1762,1893,3655,37.565201,126.827316
강서구,2701, 마곡나루역 5번출구 뒤편,201904,2909,3000,5909,37.565201,126.827316
강서구,2701, 마곡나루역 5번출구 뒤편,201905,5006,5094,10100,37.565201,126.827316
강서구,2701, 마곡나루역 5번출구 뒤편,201906,6659,6668,13327,37.565201,126.827316
강서구,2701, 마곡나루역 5번출구 뒤편,201907,6792,6771,13563,37.565201,126.827316
강서구,2701, 마곡나루역 5번출구 뒤편,201908,6870,6933,13803,37.565201,126.827316
강서구,2701, 마곡나루역 5번출구 뒤편,201909,6807,6847,13654,37.565201,126.827316
강서구,2701, 마곡나루역 5번출구 뒤편,201910,8426,8638,17064,37.565201,126.827316
강서구,2701, 마곡나루역 5번출구 뒤편,201911,5845,6068,11913,37.565201,126.827316
강서구,2701, 마곡나루역 5번출구 뒤편,201912,3628,3653,7281,37.565201,126.827316
강서구,2701, 마곡나루역 5번출구 뒤편,202001,3174,3322,6496,37.565201,126.827316
강서구,2701, 마곡나루역 5번출구 뒤편,202002,3117,3126,6243,37.565201,126.827316
강서구,2701, 마곡나루역 5번출구 뒤편,202003,4665,4543,9208,37.565201,126.827316
강서구,2701, 마곡나루역 5번출구 뒤편,202004,6479,6429,12908,37.565201,126.827316
강서구,2701, 마곡나루역 5번출구 뒤편,202005,8307,8191,16498,37.565201,126.827316
강서구,2701, 마곡나루역 5번출구 뒤편,202006,8670,8403,17073,37.565201,126.827316
강서구,2702, 마곡 엠밸리2단지,201901,161,93,254,37.56918,126.819443
강서구,2702, 마곡 엠밸리2단지,201902,145,104,249,37.56918,126.819443
강서구,2702, 마곡 엠밸리2단지,201903,278,194,472,37.56918,126.819443
강서구,2702, 마곡 엠밸리2단지,201904,337,279,616,37.56918,126.819443
강서구,2702, 마곡 엠밸리2단지,201905,599,523,1122,37.56918,126.819443
강서구,2702, 마곡 엠밸리2단지,201906,846,768,1614,37.56918,126.819443
강서구,2702, 마곡 엠밸리2단지,201907,1035,828,1863,37.56918,126.819443
강서구,2702, 마곡 엠밸리2단지,201908,998,854,1852,37.56918,126.819443
강서구,2702, 마곡 엠밸리2단지,201909,570,453,1023,37.56918,126.819443
강서구,2702, 마곡 엠밸리2단지,201910,1240,857,2097,37.56918,126.819443
강서구,2702, 마곡 엠밸리2단지,201911,828,631,1459,37.56918,126.819443
강서구,2702, 마곡 엠밸리2단지,201912,523,409,932,37.56918,126.819443
강서구,2702, 마곡 엠밸리2단지,202001,530,428,958,37.56918,126.819443
강서구,2702, 마곡 엠밸리2단지,202002,426,338,764,37.56918,126.819443
강서구,2702, 마곡 엠밸리2단지,202003,742,513,1255,37.56918,126.819443
강서구,2702, 마곡 엠밸리2단지,202004,1007,764,1771,37.56918,126.819443
강서구,2702, 마곡 엠밸리2단지,202005,1303,1025,2328,37.56918,126.819443
강서구,2702, 마곡 엠밸리2단지,202006,1416,1195,2611,37.56918,126.819443
강서구,2703,서울도시가스 앞,202004,1,1,2,37.547485,126.872025
강서구,2703,서울도시가스 앞,202006,419,285,704,37.547485,126.872025
강서구,2704,홈플러스(강서점),202004,4,4,8,37.558334,126.854065
강서구,2704,홈플러스(강서점),202006,1322,1274,2596,37.558334,126.854065
강서구,2705,홈플러스(가양점),202004,3,3,6,#N/A,#N/A
강서구,2706,강서공업고등학교 앞,202004,1,1,2,37.576317,126.816498
강서구,2706,강서공업고등학교 앞,202006,753,765,1518,37.576317,126.816498
강서구,2707,한강아파트,202004,1,1,2,37.57037,126.844414
강서구,2707,한강아파트,202006,1002,1000,2002,37.57037,126.844414
강서구,2708,강서한강자이타워 앞,202004,1,1,2,37.564682,126.848908
강서구,2708,강서한강자이타워 앞,202006,17,13,30,37.564682,126.848908
강서구,2709,강변아파트 310동 앞,202004,1,1,2,37.564587,126.856918
강서구,2709,강변아파트 310동 앞,202006,412,421,833,37.564587,126.856918
강서구,2710,라이품 공영주차장 앞,202004,1,1,2,37.570728,126.841568
강서구,2710,라이품 공영주차장 앞,202006,1078,1071,2149,37.570728,126.841568
강서구,2711,가로공원공영주차장 1번 출구,202004,1,1,2,37.537361,126.837448
강서구,2711,가로공원공영주차장 1번 출구,202005,239,241,480,37.537361,126.837448
강서구,2711,가로공원공영주차장 1번 출구,202006,847,966,1813,37.537361,126.837448
강서구,2712,화곡터널입구교차로,202004,1,1,2,37.538338,126.842392
강서구,2712,화곡터널입구교차로,202006,229,129,358,37.538338,126.842392
강서구,2713,우장초등학교 앞,202004,1,1,2,37.548534,126.846672
강서구,2713,우장초등학교 앞,202006,65,45,110,37.548534,126.846672
강서구,2714,발산1동주민센터교차로,202004,1,1,2,37.553173,126.831238
강서구,2714,발산1동주민센터교차로,202006,1011,1007,2018,37.553173,126.831238
강서구,2715,마곡나루역 2번 출구,202006,2242,2139,4381,37.566883,126.827683
강서구,2716,롯데 R&D 센터,202004,2,2,4,37.569176,126.828217
강서구,2716,롯데 R&D 센터,202006,190,124,314,37.569176,126.828217
강서구,2717,LG유플러스 마곡사옥,202004,1,1,2,37.561337,126.833901
강서구,2717,LG유플러스 마곡사옥,202005,411,402,813,37.561337,126.833901
강서구,2717,LG유플러스 마곡사옥,202006,1947,2000,3947,37.561337,126.833901
강서구,2718,마곡수명산파크1단지,202004,1,1,2,37.554993,126.831894
강서구,2718,마곡수명산파크1단지,202005,389,374,763,37.554993,126.831894
강서구,2718,마곡수명산파크1단지,202006,745,638,1383,37.554993,126.831894
강서구,2719,마곡문화공원,202004,1,1,2,37.561371,126.830124
강서구,2719,마곡문화공원,202005,13,9,22,37.561371,126.830124
강서구,2720,힐스테이트에코,202004,1,1,2,37.559589,126.829781
강서구,2720,힐스테이트에코,202005,490,474,964,37.559589,126.829781
강서구,2720,힐스테이트에코,202006,2286,2215,4501,37.559589,126.829781
강서구,2721,등촌1-10단지 교차로,202004,4,5,9,37.563145,126.839562
강서구,2721,등촌1-10단지 교차로,202006,975,970,1945,37.563145,126.839562
강서구,2722,마곡 문영비지윅스,202004,1,1,2,37.560604,126.83873
강서구,2722,마곡 문영비지윅스,202006,942,929,1871,37.560604,126.83873
강서구,2723,마곡 필네이처,202006,442,409,851,37.560894,126.836693
강서구,2724,(재)FITI시험연구원,202006,566,532,1098,37.568665,126.838799
강서구,2725,서울식물원 식물문화센터,202006,471,350,821,37.569294,126.836197
강서구,2726,서울식물원 주제원입구,202004,1,1,2,#N/A,#N/A
강서구,2727,서울식물원 잔디마당 앞,202004,1,1,2,37.564087,126.830849
강서구,2727,서울식물원 잔디마당 앞,202006,38,33,71,37.564087,126.830849
강서구,2728,마곡나루역 3번 출구,202004,1,1,2,37.565804,126.828079
강서구,2728,마곡나루역 3번 출구,202006,1371,1162,2533,37.565804,126.828079
강서구,2729,넥센 유니버시티 앞,202006,558,500,1058,37.569485,126.828095
강서구,2730,마곡메가박스 앞,202004,1,1,2,37.559128,126.834953
강서구,2730,마곡메가박스 앞,202005,206,206,412,37.559128,126.834953
강서구,2730,마곡메가박스 앞,202006,941,943,1884,37.559128,126.834953
강서구,2731,명덕고교,202004,1,1,2,37.554951,126.834732
강서구,2731,명덕고교,202005,95,69,164,37.554951,126.834732
강서구,2731,명덕고교,202006,532,418,950,37.554951,126.834732
강서구,2732,마곡수명산 1-2단지,202004,1,1,2,37.555145,126.829453
강서구,2732,마곡수명산 1-2단지,202005,146,153,299,37.555145,126.829453
강서구,2732,마곡수명산 1-2단지,202006,1204,1068,2272,37.555145,126.829453
강서구,2733,마곡13단지 정문 앞,202004,1,1,2,37.55854,126.820107
강서구,2733,마곡13단지 정문 앞,202005,401,395,796,37.55854,126.820107
강서구,2733,마곡13단지 정문 앞,202006,1768,1750,3518,37.55854,126.820107
강서구,2735,마곡 공공청사,202004,4,4,8,37.562294,126.823952
강서구,2735,마곡 공공청사,202006,634,625,1259,37.562294,126.823952
강서구,2736,마곡엠벨리7단지 M타워,202006,39,33,72,#N/A,#N/A
강서구,2737,까치산역 3번 출구,202004,0,1,1,37.531693,126.846588
강서구,2737,까치산역 3번 출구,202005,315,313,628,37.531693,126.846588
강서구,2737,까치산역 3번 출구,202006,1091,1077,2168,37.531693,126.846588
강서구,2739,수명산파크1단지교차로,202006,123,130,253,37.553585,126.828568
강서구,2740,마곡레포츠센터,202004,14,15,29,37.57272,126.832069
강서구,2740,마곡레포츠센터,202005,82,87,169,37.57272,126.832069
강서구,2740,마곡레포츠센터,202006,282,248,530,37.57272,126.832069
강서구,2741,마곡수명산파크5-6단지,202004,2,2,4,37.550617,126.826881
강서구,2741,마곡수명산파크5-6단지,202005,185,176,361,37.550617,126.826881
강서구,2741,마곡수명산파크5-6단지,202006,831,823,1654,37.550617,126.826881
강서구,2742,강서구민올림픽체육센터,202004,16,16,32,37.559402,126.850441
강서구,2742,강서구민올림픽체육센터,202005,45,55,100,37.559402,126.850441
강서구,2742,강서구민올림픽체육센터,202006,309,297,606,37.559402,126.850441
강서구,2743,동신아파트 104동 앞,202006,6,6,12,#N/A,#N/A
강서구,2744,강서세무서 앞,202006,1,0,1,#N/A,#N/A
강서구,2745,수명초등학교,202006,172,182,354,#N/A,#N/A
강서구,2746,수명산파크 4단지 411동 앞,202006,81,74,155,#N/A,#N/A
구로구,2801, 대륭포스트타워1차,201907,387,372,759,37.484371,126.895424
구로구,2801, 대륭포스트타워1차,201908,1177,1159,2336,37.484371,126.895424
구로구,2801, 대륭포스트타워1차,201909,1100,1161,2261,37.484371,126.895424
구로구,2801, 대륭포스트타워1차,201910,1441,1535,2976,37.484371,126.895424
구로구,2801, 대륭포스트타워1차,201911,1044,1211,2255,37.484371,126.895424
구로구,2801, 대륭포스트타워1차,201912,593,658,1251,37.484371,126.895424
구로구,2801, 대륭포스트타워1차,202001,594,632,1226,37.484371,126.895424
구로구,2801, 대륭포스트타워1차,202002,579,624,1203,37.484371,126.895424
구로구,2801, 대륭포스트타워1차,202003,768,767,1535,37.484371,126.895424
구로구,2801, 대륭포스트타워1차,202004,977,1021,1998,37.484371,126.895424
구로구,2801, 대륭포스트타워1차,202005,1353,1378,2731,37.484371,126.895424
구로구,2801, 대륭포스트타워1차,202006,2019,2168,4187,37.484371,126.895424
구로구,2803,항동지구 6단지 602동 건너편,202003,1,1,2,#N/A,#N/A
구로구,2804,항동지구 6단지 602동 앞,202006,87,86,173,37.477375,126.820015
구로구,2805,구로자원순환센터,202003,1,1,2,37.48251,126.82576
구로구,2805,구로자원순환센터,202006,75,97,172,37.48251,126.82576
구로구,2806,항동지구 4단지 입구,202003,2,2,4,37.482597,126.826454
구로구,2806,항동지구 4단지 입구,202006,246,205,451,37.482597,126.826454
구로구,2807,항동지구 1단지 105동 앞,202003,1,1,2,37.480629,126.821816
구로구,2807,항동지구 1단지 105동 앞,202006,261,276,537,37.480629,126.821816
구로구,2808,항동지구 2단지 202동 앞,202003,1,1,2,37.480808,126.821907
구로구,2808,항동지구 2단지 202동 앞,202006,238,258,496,37.480808,126.821907
구로구,2809,항동지구 11단지 1103동 앞,202003,1,1,2,37.477905,126.823113
구로구,2809,항동지구 11단지 1103동 앞,202006,35,43,78,37.477905,126.823113
구로구,2810,항동지구 3단지 311동 앞,202003,1,1,2,37.47794,126.823273
구로구,2810,항동지구 3단지 311동 앞,202006,37,41,78,37.47794,126.823273
구로구,2812,항동프라자,202003,1,1,2,37.479832,126.822754
구로구,2812,항동프라자,202004,1,1,2,37.479832,126.822754
구로구,2812,항동프라자,202006,353,414,767,37.479832,126.822754
구로구,2813,항동지구 3단지 302동 앞,202003,1,1,2,37.47937,126.82547
구로구,2813,항동지구 3단지 302동 앞,202006,24,30,54,37.47937,126.82547
구로구,2814,항동지구 10단지 1001동 앞,202003,2,2,4,37.479343,126.825638
구로구,2814,항동지구 10단지 1001동 앞,202006,77,78,155,37.479343,126.825638
구로구,2815,항동지구 7단지 정문,202003,1,1,2,37.476013,126.81646
구로구,2815,항동지구 7단지 정문,202006,153,158,311,37.476013,126.81646
구로구,2816,항동지구 8단지 803동옆(주차장입구),202003,1,1,2,37.474731,126.817009
구로구,2816,항동지구 8단지 803동옆(주차장입구),202006,126,173,299,37.474731,126.817009
구로구,2817,천왕이펜하우스5단지 앞,202003,1,1,2,37.479897,126.84037
구로구,2817,천왕이펜하우스5단지 앞,202006,182,145,327,37.479897,126.84037
구로구,2818,천왕이펜하우스3단지 앞,202003,2,2,4,37.482239,126.838532
구로구,2818,천왕이펜하우스3단지 앞,202006,147,67,214,37.482239,126.838532
구로구,2819,하늘숲초등학교 앞,202003,1,1,2,37.483665,126.841614
구로구,2819,하늘숲초등학교 앞,202006,288,252,540,37.483665,126.841614
구로구,2820,신세기아파트 앞,202003,1,1,2,37.493965,126.853043
구로구,2820,신세기아파트 앞,202006,222,200,422,37.493965,126.853043
구로구,2821,청구아파트 앞,202006,147,136,283,37.50119,126.863533
구로구,2822,제니스스포츠 앞,202006,32,26,58,37.50452,126.870552
구로구,2823,중앙유통단지 앞,202006,64,48,112,37.499813,126.874313
구로구,2824,미래사랑어린이공원 앞,202003,1,1,2,37.510063,126.889565
구로구,2824,미래사랑어린이공원 앞,202004,1,1,2,37.510063,126.889565
구로구,2824,미래사랑어린이공원 앞,202006,628,625,1253,37.510063,126.889565
구로구,2825,초롱타운 앞,202003,1,1,2,37.495453,126.880394
구로구,2825,초롱타운 앞,202006,241,241,482,37.495453,126.880394
구로구,2826,가마산지하보도 옆,202003,1,1,2,37.488647,126.88047
구로구,2826,가마산지하보도 옆,202006,172,176,348,37.488647,126.88047
노원구,2901,공릉동풍림아파트 101동,202004,0,1,1,37.630001,127.065682
노원구,2901,공릉동풍림아파트 101동,202005,55,62,117,37.630001,127.065682
노원구,2901,공릉동풍림아파트 101동,202006,969,974,1943,37.630001,127.065682
노원구,2902,공릉풍림아파트 108동,202005,87,92,179,37.62862,127.06691
노원구,2902,공릉풍림아파트 108동,202006,1119,1120,2239,37.62862,127.06691
노원구,2903,월계초안아파트 1단지,202004,1,1,2,37.633259,127.0439
노원구,2903,월계초안아파트 1단지,202005,31,34,65,37.633259,127.0439
노원구,2903,월계초안아파트 1단지,202006,615,624,1239,37.633259,127.0439
노원구,2904,중계3차청구아파트,202004,1,1,2,37.650505,127.073982
노원구,2904,중계3차청구아파트,202005,44,43,87,37.650505,127.073982
노원구,2904,중계3차청구아파트,202006,715,706,1421,37.650505,127.073982
노원구,2905,중계주공6단지,202004,1,1,2,37.648163,127.078987
노원구,2905,중계주공6단지,202005,23,21,44,37.648163,127.078987
노원구,2905,중계주공6단지,202006,432,348,780,37.648163,127.078987
노원구,2907, 월계중학교,202004,1,1,2,37.630749,127.053108
노원구,2907, 월계중학교,202005,33,34,67,37.630749,127.053108
노원구,2907, 월계중학교,202006,464,361,825,37.630749,127.053108
노원구,2908, 광운대학교 중앙도서관,202004,6,5,11,37.620003,127.058563
노원구,2908, 광운대학교 중앙도서관,202005,65,58,123,37.620003,127.058563
노원구,2908, 광운대학교 중앙도서관,202006,689,636,1325,37.620003,127.058563
노원구,2909, 석계역 3번 출구,202004,2,2,4,37.615459,127.067452
노원구,2909, 석계역 3번 출구,202005,103,82,185,37.615459,127.067452
노원구,2909, 석계역 3번 출구,202006,610,574,1184,37.615459,127.067452
노원구,2910,도깨비시장,202004,1,1,2,37.622093,127.074425
노원구,2910,도깨비시장,202005,109,114,223,37.622093,127.074425
노원구,2910,도깨비시장,202006,1622,1599,3221,37.622093,127.074425
노원구,2911,상계역중앙시장,202004,2,3,5,37.659233,127.072098
노원구,2911,상계역중앙시장,202005,96,95,191,37.659233,127.072098
노원구,2911,상계역중앙시장,202006,914,823,1737,37.659233,127.072098
노원구,2912,대진고등학교,202004,1,1,2,37.638191,127.073731
노원구,2912,대진고등학교,202005,85,87,172,37.638191,127.073731
노원구,2912,대진고등학교,202006,1490,1445,2935,37.638191,127.073731
노원구,2913,상계8동 주민센터,202004,1,1,2,37.666996,127.051529
노원구,2913,상계8동 주민센터,202005,139,151,290,37.666996,127.051529
노원구,2913,상계8동 주민센터,202006,1711,1719,3430,37.666996,127.051529
노원구,2915,서울과학기술대학교(어학교육원),202004,1,1,2,37.635109,127.076599
노원구,2915,서울과학기술대학교(어학교육원),202005,11,10,21,37.635109,127.076599
노원구,2915,서울과학기술대학교(어학교육원),202006,837,823,1660,37.635109,127.076599
노원구,2917,신창중학교 후문 맞은편 버스정류장,202004,1,1,2,37.628071,127.046921
노원구,2917,신창중학교 후문 맞은편 버스정류장,202005,39,39,78,37.628071,127.046921
노원구,2917,신창중학교 후문 맞은편 버스정류장,202006,831,836,1667,37.628071,127.046921
노원구,2918,골마을 근린공원,202004,1,1,2,#N/A,#N/A
노원구,2919,등나무 근린공원(시립북서울미술관 앞),202004,1,1,2,37.639996,127.066574
노원구,2919,등나무 근린공원(시립북서울미술관 앞),202005,164,163,327,37.639996,127.066574
노원구,2919,등나무 근린공원(시립북서울미술관 앞),202006,1771,1745,3516,37.639996,127.066574
노원구,2920,상계중학교(당현2교사거리),202004,1,1,2,37.651035,127.06871
노원구,2920,상계중학교(당현2교사거리),202005,69,60,129,37.651035,127.06871
노원구,2920,상계중학교(당현2교사거리),202006,573,503,1076,37.651035,127.06871
노원구,2921,중계역 2번출구,202004,2,2,4,37.645489,127.064583
노원구,2921,중계역 2번출구,202005,74,74,148,37.645489,127.064583
노원구,2921,중계역 2번출구,202006,962,923,1885,37.645489,127.064583
마포구,3001,마포구청역 3번출구,202004,1,1,2,#N/A,#N/A
마포구,3002,벽산상암스마트큐브,202004,20,22,42,37.565044,126.903603
마포구,3002,벽산상암스마트큐브,202005,768,776,1544,37.565044,126.903603
마포구,3002,벽산상암스마트큐브,202006,2192,2159,4351,37.565044,126.903603
마포구,3003,래미안신공덕3차아파트,202004,1,1,2,37.548805,126.951073
마포구,3003,래미안신공덕3차아파트,202005,22,21,43,37.548805,126.951073
마포구,3003,래미안신공덕3차아파트,202006,66,44,110,37.548805,126.951073
마포구,3004,마포자이3차아파트,202004,1,1,2,#N/A,#N/A
마포구,3005,마포구청 청사내,202004,2,2,4,37.566246,126.902184
마포구,3005,마포구청 청사내,202005,90,90,180,37.566246,126.902184
마포구,3005,마포구청 청사내,202006,279,255,534,37.566246,126.902184
마포구,3006, 상암월드컵파크5단지(상암중학교),202004,2,2,4,37.57991,126.888237
마포구,3006, 상암월드컵파크5단지(상암중학교),202005,41,41,82,37.57991,126.888237
마포구,3006, 상암월드컵파크5단지(상암중학교),202006,213,186,399,37.57991,126.888237
마포구,3007,MBC 앞,202004,1,1,2,37.581947,126.890297
마포구,3007,MBC 앞,202005,165,162,327,37.581947,126.890297
마포구,3007,MBC 앞,202006,673,671,1344,37.581947,126.890297
마포구,3008,DMC역7번출구,202004,3,2,5,37.577114,126.898361
마포구,3008,DMC역7번출구,202006,138,103,241,37.577114,126.898361
마포구,3009,서교동사거리(신),202004,1,1,2,37.55584,126.920433
마포구,3009,서교동사거리(신),202005,414,416,830,37.55584,126.920433
마포구,3009,서교동사거리(신),202006,1373,1353,2726,37.55584,126.920433
마포구,3010,홍대입구역 3번출구,202004,4,4,8,37.558296,126.925385
마포구,3010,홍대입구역 3번출구,202005,659,659,1318,37.558296,126.925385
마포구,3010,홍대입구역 3번출구,202006,1698,1680,3378,37.558296,126.925385
마포구,3011,경의선(노고산동),202004,1,1,2,37.553429,126.933792
마포구,3011,경의선(노고산동),202005,261,263,524,37.553429,126.933792
마포구,3011,경의선(노고산동),202006,679,671,1350,37.553429,126.933792
서대문구,3100, 북성초교,201901,132,54,186,37.557396,126.952164
서대문구,3100, 북성초교,201902,115,69,184,37.557396,126.952164
서대문구,3100, 북성초교,201903,237,133,370,37.557396,126.952164
서대문구,3100, 북성초교,201904,334,208,542,37.557396,126.952164
서대문구,3100, 북성초교,201905,546,334,880,37.557396,126.952164
서대문구,3100, 북성초교,201906,478,283,761,37.557396,126.952164
서대문구,3100, 북성초교,201907,528,287,815,37.557396,126.952164
서대문구,3100, 북성초교,201908,401,198,599,37.557396,126.952164
서대문구,3100, 북성초교,201909,394,229,623,37.557396,126.952164
서대문구,3100, 북성초교,201910,408,256,664,37.557396,126.952164
서대문구,3100, 북성초교,201911,365,179,544,37.557396,126.952164
서대문구,3100, 북성초교,201912,184,78,262,37.557396,126.952164
서대문구,3100, 북성초교,202001,201,72,273,37.557396,126.952164
서대문구,3100, 북성초교,202002,166,95,261,37.557396,126.952164
서대문구,3100, 북성초교,202003,260,179,439,37.557396,126.952164
서대문구,3100, 북성초교,202004,261,248,509,37.557396,126.952164
서대문구,3100, 북성초교,202005,253,226,479,37.557396,126.952164
서대문구,3100, 북성초교,202006,305,251,556,37.557396,126.952164
서대문구,3101, 서대문구청,201901,335,257,592,37.578381,126.936096
서대문구,3101, 서대문구청,201902,326,255,581,37.578381,126.936096
서대문구,3101, 서대문구청,201903,623,437,1060,37.578381,126.936096
서대문구,3101, 서대문구청,201904,972,893,1865,37.578381,126.936096
서대문구,3101, 서대문구청,201905,1277,1170,2447,37.578381,126.936096
서대문구,3101, 서대문구청,201906,1335,1215,2550,37.578381,126.936096
서대문구,3101, 서대문구청,201907,1394,1236,2630,37.578381,126.936096
서대문구,3101, 서대문구청,201908,1171,1038,2209,37.578381,126.936096
서대문구,3101, 서대문구청,201909,1110,1060,2170,37.578381,126.936096
서대문구,3101, 서대문구청,201910,1251,1163,2414,37.578381,126.936096
서대문구,3101, 서대문구청,201911,987,876,1863,37.578381,126.936096
서대문구,3101, 서대문구청,201912,597,496,1093,37.578381,126.936096
서대문구,3101, 서대문구청,202001,576,406,982,37.578381,126.936096
서대문구,3101, 서대문구청,202002,582,408,990,37.578381,126.936096
서대문구,3101, 서대문구청,202003,1039,870,1909,37.578381,126.936096
서대문구,3101, 서대문구청,202004,1311,1240,2551,37.578381,126.936096
서대문구,3101, 서대문구청,202005,1172,1161,2333,37.578381,126.936096
서대문구,3101, 서대문구청,202006,1268,1191,2459,37.578381,126.936096
서대문구,3102, 연희삼거리,201901,471,473,944,37.567966,126.931725
서대문구,3102, 연희삼거리,201902,392,379,771,37.567966,126.931725
서대문구,3102, 연희삼거리,201903,816,818,1634,37.567966,126.931725
서대문구,3102, 연희삼거리,201904,1121,1199,2320,37.567966,126.931725
서대문구,3102, 연희삼거리,201905,1647,1637,3284,37.567966,126.931725
서대문구,3102, 연희삼거리,201906,1669,1640,3309,37.567966,126.931725
서대문구,3102, 연희삼거리,201907,1659,1655,3314,37.567966,126.931725
서대문구,3102, 연희삼거리,201908,1413,1394,2807,37.567966,126.931725
서대문구,3102, 연희삼거리,201909,1256,1257,2513,37.567966,126.931725
서대문구,3102, 연희삼거리,201910,1668,1687,3355,37.567966,126.931725
서대문구,3102, 연희삼거리,201911,1053,1067,2120,37.567966,126.931725
서대문구,3102, 연희삼거리,201912,707,681,1388,37.567966,126.931725
서대문구,3102, 연희삼거리,202001,550,554,1104,37.567966,126.931725
서대문구,3102, 연희삼거리,202002,546,530,1076,37.567966,126.931725
서대문구,3102, 연희삼거리,202003,984,995,1979,37.567966,126.931725
서대문구,3102, 연희삼거리,202004,1299,1289,2588,37.567966,126.931725
서대문구,3102, 연희삼거리,202005,1492,1494,2986,37.567966,126.931725
서대문구,3102, 연희삼거리,202006,1361,1351,2712,37.567966,126.931725
서대문구,3103, 홍제삼거리 북측,201901,240,262,502,37.5867,126.94677
서대문구,3103, 홍제삼거리 북측,201902,237,290,527,37.5867,126.94677
서대문구,3103, 홍제삼거리 북측,201903,477,574,1051,37.5867,126.94677
서대문구,3103, 홍제삼거리 북측,201904,518,534,1052,37.5867,126.94677
서대문구,3103, 홍제삼거리 북측,201905,818,828,1646,37.5867,126.94677
서대문구,3103, 홍제삼거리 북측,201906,948,976,1924,37.5867,126.94677
서대문구,3103, 홍제삼거리 북측,201907,842,866,1708,37.5867,126.94677
서대문구,3103, 홍제삼거리 북측,201908,812,797,1609,37.5867,126.94677
서대문구,3103, 홍제삼거리 북측,201909,811,802,1613,37.5867,126.94677
서대문구,3103, 홍제삼거리 북측,201910,847,865,1712,37.5867,126.94677
서대문구,3103, 홍제삼거리 북측,201911,563,557,1120,37.5867,126.94677
서대문구,3103, 홍제삼거리 북측,201912,248,295,543,37.5867,126.94677
서대문구,3103, 홍제삼거리 북측,202001,255,285,540,37.5867,126.94677
서대문구,3103, 홍제삼거리 북측,202002,297,326,623,37.5867,126.94677
서대문구,3103, 홍제삼거리 북측,202003,705,711,1416,37.5867,126.94677
서대문구,3103, 홍제삼거리 북측,202004,986,978,1964,37.5867,126.94677
서대문구,3103, 홍제삼거리 북측,202005,1003,1010,2013,37.5867,126.94677
서대문구,3103, 홍제삼거리 북측,202006,1197,1186,2383,37.5867,126.94677
서대문구,3104, e편한세상 신촌4단지 앞,201901,156,188,344,37.558128,126.956207
서대문구,3104, e편한세상 신촌4단지 앞,201902,210,204,414,37.558128,126.956207
서대문구,3104, e편한세상 신촌4단지 앞,201903,410,395,805,37.558128,126.956207
서대문구,3104, e편한세상 신촌4단지 앞,201904,550,636,1186,37.558128,126.956207
서대문구,3104, e편한세상 신촌4단지 앞,201905,981,976,1957,37.558128,126.956207
서대문구,3104, e편한세상 신촌4단지 앞,201906,915,875,1790,37.558128,126.956207
서대문구,3104, e편한세상 신촌4단지 앞,201907,891,888,1779,37.558128,126.956207
서대문구,3104, e편한세상 신촌4단지 앞,201908,813,767,1580,37.558128,126.956207
서대문구,3104, e편한세상 신촌4단지 앞,201909,801,752,1553,37.558128,126.956207
서대문구,3104, e편한세상 신촌4단지 앞,201910,1018,990,2008,37.558128,126.956207
서대문구,3104, e편한세상 신촌4단지 앞,201911,757,770,1527,37.558128,126.956207
서대문구,3104, e편한세상 신촌4단지 앞,201912,389,407,796,37.558128,126.956207
서대문구,3104, e편한세상 신촌4단지 앞,202001,322,338,660,37.558128,126.956207
서대문구,3104, e편한세상 신촌4단지 앞,202002,361,343,704,37.558128,126.956207
서대문구,3104, e편한세상 신촌4단지 앞,202003,547,532,1079,37.558128,126.956207
서대문구,3104, e편한세상 신촌4단지 앞,202004,934,928,1862,37.558128,126.956207
서대문구,3104, e편한세상 신촌4단지 앞,202005,1061,1056,2117,37.558128,126.956207
서대문구,3104, e편한세상 신촌4단지 앞,202006,1014,1011,2025,37.558128,126.956207
서대문구,3105, 홍은센트레빌 아파트 앞,201901,146,58,204,37.597149,126.93853
서대문구,3105, 홍은센트레빌 아파트 앞,201902,125,40,165,37.597149,126.93853
서대문구,3105, 홍은센트레빌 아파트 앞,201903,292,89,381,37.597149,126.93853
서대문구,3105, 홍은센트레빌 아파트 앞,201904,358,144,502,37.597149,126.93853
서대문구,3105, 홍은센트레빌 아파트 앞,201905,472,180,652,37.597149,126.93853
서대문구,3105, 홍은센트레빌 아파트 앞,201906,460,142,602,37.597149,126.93853
서대문구,3105, 홍은센트레빌 아파트 앞,201907,543,178,721,37.597149,126.93853
서대문구,3105, 홍은센트레빌 아파트 앞,201908,507,166,673,37.597149,126.93853
서대문구,3105, 홍은센트레빌 아파트 앞,201909,376,148,524,37.597149,126.93853
서대문구,3105, 홍은센트레빌 아파트 앞,201910,433,180,613,37.597149,126.93853
서대문구,3105, 홍은센트레빌 아파트 앞,201911,411,142,553,37.597149,126.93853
서대문구,3105, 홍은센트레빌 아파트 앞,201912,280,79,359,37.597149,126.93853
서대문구,3105, 홍은센트레빌 아파트 앞,202001,304,72,376,37.597149,126.93853
서대문구,3105, 홍은센트레빌 아파트 앞,202002,281,81,362,37.597149,126.93853
서대문구,3105, 홍은센트레빌 아파트 앞,202003,309,146,455,37.597149,126.93853
서대문구,3105, 홍은센트레빌 아파트 앞,202004,304,216,520,37.597149,126.93853
서대문구,3105, 홍은센트레빌 아파트 앞,202005,278,218,496,37.597149,126.93853
서대문구,3105, 홍은센트레빌 아파트 앞,202006,515,228,743,37.597149,126.93853
서대문구,3106, 홍남교 두바퀴쉼터,201901,361,369,730,37.574909,126.926147
서대문구,3106, 홍남교 두바퀴쉼터,201902,375,402,777,37.574909,126.926147
서대문구,3106, 홍남교 두바퀴쉼터,201903,778,802,1580,37.574909,126.926147
서대문구,3106, 홍남교 두바퀴쉼터,201904,1132,1216,2348,37.574909,126.926147
서대문구,3106, 홍남교 두바퀴쉼터,201905,1900,2125,4025,37.574909,126.926147
서대문구,3106, 홍남교 두바퀴쉼터,201906,1928,2148,4076,37.574909,126.926147
서대문구,3106, 홍남교 두바퀴쉼터,201907,1644,2084,3728,37.574909,126.926147
서대문구,3106, 홍남교 두바퀴쉼터,201908,1619,1877,3496,37.574909,126.926147
서대문구,3106, 홍남교 두바퀴쉼터,201909,1882,2036,3918,37.574909,126.926147
서대문구,3106, 홍남교 두바퀴쉼터,201910,2171,2312,4483,37.574909,126.926147
서대문구,3106, 홍남교 두바퀴쉼터,201911,1371,1443,2814,37.574909,126.926147
서대문구,3106, 홍남교 두바퀴쉼터,201912,868,918,1786,37.574909,126.926147
서대문구,3106, 홍남교 두바퀴쉼터,202001,876,910,1786,37.574909,126.926147
서대문구,3106, 홍남교 두바퀴쉼터,202002,807,852,1659,37.574909,126.926147
서대문구,3106, 홍남교 두바퀴쉼터,202003,1742,1761,3503,37.574909,126.926147
서대문구,3106, 홍남교 두바퀴쉼터,202004,2293,2332,4625,37.574909,126.926147
서대문구,3106, 홍남교 두바퀴쉼터,202005,2606,2618,5224,37.574909,126.926147
서대문구,3106, 홍남교 두바퀴쉼터,202006,2708,2817,5525,37.574909,126.926147
서대문구,3107, 연희초등학교 앞,201901,153,122,275,37.56974,126.933327
서대문구,3107, 연희초등학교 앞,201902,125,95,220,37.56974,126.933327
서대문구,3107, 연희초등학교 앞,201903,247,187,434,37.56974,126.933327
서대문구,3107, 연희초등학교 앞,201904,250,202,452,37.56974,126.933327
서대문구,3107, 연희초등학교 앞,201905,551,506,1057,37.56974,126.933327
서대문구,3107, 연희초등학교 앞,201906,620,594,1214,37.56974,126.933327
서대문구,3107, 연희초등학교 앞,201907,612,601,1213,37.56974,126.933327
서대문구,3107, 연희초등학교 앞,201908,638,600,1238,37.56974,126.933327
서대문구,3107, 연희초등학교 앞,201909,614,573,1187,37.56974,126.933327
서대문구,3107, 연희초등학교 앞,201910,637,643,1280,37.56974,126.933327
서대문구,3107, 연희초등학교 앞,201911,537,504,1041,37.56974,126.933327
서대문구,3107, 연희초등학교 앞,201912,348,316,664,37.56974,126.933327
서대문구,3107, 연희초등학교 앞,202001,304,264,568,37.56974,126.933327
서대문구,3107, 연희초등학교 앞,202002,263,296,559,37.56974,126.933327
서대문구,3107, 연희초등학교 앞,202003,417,412,829,37.56974,126.933327
서대문구,3107, 연희초등학교 앞,202004,502,495,997,37.56974,126.933327
서대문구,3107, 연희초등학교 앞,202005,547,538,1085,37.56974,126.933327
서대문구,3107, 연희초등학교 앞,202006,562,547,1109,37.56974,126.933327
서대문구,3108,서울홍성교회,202004,2,2,4,#N/A,#N/A
서대문구,3109,북한산더? 106동 앞,202004,1,1,2,37.592934,126.941292
서대문구,3109,북한산더? 106동 앞,202006,80,70,150,37.592934,126.941292
서대문구,3110,홍은 현대아이파크 아파트 202동 앞,202004,1,1,2,37.589283,126.936943
서대문구,3110,홍은 현대아이파크 아파트 202동 앞,202005,1,1,2,37.589283,126.936943
서대문구,3110,홍은 현대아이파크 아파트 202동 앞,202006,147,150,297,37.589283,126.936943
서대문구,3111,무악재역 4번 출구,202004,1,1,2,37.582211,126.950165
서대문구,3111,무악재역 4번 출구,202006,57,47,104,37.582211,126.950165
서대문구,3112,독립문역 5번 출구,202004,1,1,2,37.57386,126.958298
서대문구,3112,독립문역 5번 출구,202006,37,30,67,37.57386,126.958298
서대문구,3113,독립문역사거리,202004,2,2,4,37.572205,126.959747
서대문구,3113,독립문역사거리,202006,78,62,140,37.572205,126.959747
서대문구,3114,충정로역 3번 출구,202004,1,1,2,37.560463,126.965523
서대문구,3114,충정로역 3번 출구,202006,162,138,300,37.560463,126.965523
서대문구,3115,북아현 치안센터 인근,202004,1,1,2,37.561455,126.95575
서대문구,3115,북아현 치안센터 인근,202006,221,204,425,37.561455,126.95575
서대문구,3116,신촌역 4번출구,202004,1,1,2,37.555504,126.937203
서대문구,3116,신촌역 4번출구,202006,223,210,433,37.555504,126.937203
서대문구,3117,이화여대 인문관 인근,202004,1,1,2,37.564068,126.945328
서대문구,3117,이화여대 인문관 인근,202006,126,90,216,37.564068,126.945328
서대문구,3118,연대 정문앞,202004,1,1,2,#N/A,#N/A
서대문구,3119,연희 브라운스톤 아파트 앞,202004,4,4,8,37.565197,126.929855
서대문구,3119,연희 브라운스톤 아파트 앞,202006,431,413,844,37.565197,126.929855
서대문구,3120,DMC엘가아파트 앞,202004,2,2,4,37.569836,126.918091
서대문구,3120,DMC엘가아파트 앞,202006,321,316,637,37.569836,126.918091
서대문구,3121,가좌삼거리,202004,1,1,2,37.570652,126.912987
서대문구,3121,가좌삼거리,202006,284,259,543,37.570652,126.912987
서대문구,3122,북가좌삼거리2,202004,2,2,4,37.574284,126.906464
서대문구,3122,북가좌삼거리2,202006,206,184,390,37.574284,126.906464
서대문구,3123,DMC파크뷰자이1단지 110동 앞,202006,116,111,227,37.572388,126.915108
서대문구,3124,DMC센트럴아이파크아파트,202004,2,2,4,37.578121,126.921753
서대문구,3125,연희파크푸르지오아파트 앞,202004,1,1,2,37.575642,126.927826
서대문구,3126,남가좌동 제2공영주차장,202004,2,2,4,37.583344,126.922745
서대문구,3126,남가좌동 제2공영주차장,202006,125,90,215,37.583344,126.922745
서대문구,3127,홍은2파출소 옆,202004,1,1,2,37.583336,126.936287
서대문구,3127,홍은2파출소 옆,202006,91,89,180,37.583336,126.936287
서대문구,3128,동신병원 맞은편,202004,1,1,2,37.581318,126.935997
서대문구,3128,동신병원 맞은편,202006,158,130,288,37.581318,126.935997
서대문구,3129,DMC래미안e편한세상203동옆,202004,1,1,2,37.576263,126.911324
서대문구,3129,DMC래미안e편한세상203동옆,202006,196,178,374,37.576263,126.911324
서대문구,3130,가재울사거리,202004,1,1,2,37.574348,126.918823
서대문구,3131,연가교 교차로,202006,208,192,400,37.572159,126.921188
서대문구,3132,홍제교,202004,1,1,2,37.591862,126.944214
서대문구,3132,홍제교,202006,74,71,145,37.591862,126.944214
서대문구,3133,핀란드 타워앞,202004,1,1,2,37.557114,126.948814
서대문구,3133,핀란드 타워앞,202006,47,16,63,37.557114,126.948814
서대문구,3134,SK리쳄블(상수도사업본부),202004,2,2,4,37.561317,126.966583
서대문구,3134,SK리쳄블(상수도사업본부),202006,170,141,311,37.561317,126.966583
영등포구,3201,당산skv1센터,202003,1,1,2,37.530735,126.89917
영등포구,3201,당산skv1센터,202005,40,38,78,37.530735,126.89917
영등포구,3201,당산skv1센터,202006,547,548,1095,37.530735,126.89917
영등포구,3202,당산롯데캐슬프레스티지,202003,1,1,2,37.52869,126.903862
영등포구,3202,당산롯데캐슬프레스티지,202005,91,90,181,37.52869,126.903862
영등포구,3202,당산롯데캐슬프레스티지,202006,1261,1275,2536,37.52869,126.903862
영등포구,3203,도림동배드민턴체육관,202003,1,1,2,37.506115,126.89859
영등포구,3203,도림동배드민턴체육관,202005,16,14,30,37.506115,126.89859
영등포구,3203,도림동배드민턴체육관,202006,230,220,450,37.506115,126.89859
영등포구,3204,도림고가도로 밑,202006,57,53,110,37.511242,126.898186
영등포구,3205,문래중학교,202003,1,1,2,37.520466,126.884819
영등포구,3205,문래중학교,202004,2,2,4,37.520466,126.884819
영등포구,3205,문래중학교,202005,119,118,237,37.520466,126.884819
영등포구,3205,문래중학교,202006,1192,1170,2362,37.520466,126.884819
영등포구,3206,문래동 주민센터,202003,1,1,2,37.517071,126.899086
영등포구,3206,문래동 주민센터,202004,3,3,6,37.517071,126.899086
영등포구,3206,문래동 주민센터,202005,29,26,55,37.517071,126.899086
영등포구,3206,문래동 주민센터,202006,399,397,796,37.517071,126.899086
영등포구,3207,양남사거리 교통섬,202003,1,1,2,37.522526,126.889969
영등포구,3207,양남사거리 교통섬,202005,31,30,61,37.522526,126.889969
영등포구,3207,양남사거리 교통섬,202006,311,314,625,37.522526,126.889969
영등포구,3208,양평역 2번출구,202003,1,1,2,#N/A,#N/A
영등포구,3211,신길 래미안 프레비뉴,202003,1,1,2,37.504383,126.908089
영등포구,3211,신길 래미안 프레비뉴,202005,59,56,115,37.504383,126.908089
영등포구,3211,신길 래미안 프레비뉴,202006,542,540,1082,37.504383,126.908089
영등포구,3212,신풍역 6번출구,202003,1,1,2,37.500172,126.911308
영등포구,3212,신풍역 6번출구,202005,278,282,560,37.500172,126.911308
영등포구,3212,신풍역 6번출구,202006,843,837,1680,37.500172,126.911308
영등포구,3214,영등포 푸르지오,202003,1,1,2,37.512024,126.901054
영등포구,3214,영등포 푸르지오,202005,114,113,227,37.512024,126.901054
영등포구,3214,영등포 푸르지오,202006,819,804,1623,37.512024,126.901054
영등포구,3215,강변삼성래미안,202003,1,1,2,37.529743,126.907829
영등포구,3215,강변삼성래미안,202005,33,34,67,37.529743,126.907829
영등포구,3215,강변삼성래미안,202006,600,600,1200,37.529743,126.907829
영등포구,3218,여의도 미원빌딩,202003,1,1,2,#N/A,#N/A
영등포구,3219,영등포역 2번출구,202006,642,639,1281,37.514874,126.907585
영등포구,3220,래미안에스티움 앞 (신풍로),202003,1,1,2,37.500137,126.913979
영등포구,3220,래미안에스티움 앞 (신풍로),202004,1,1,2,37.500137,126.913979
영등포구,3220,래미안에스티움 앞 (신풍로),202006,537,532,1069,37.500137,126.913979
영등포구,3221,서울특별시 남부교육지원청,202003,1,1,2,37.519333,126.895302
영등포구,3221,서울특별시 남부교육지원청,202004,1,1,2,37.519333,126.895302
영등포구,3221,서울특별시 남부교육지원청,202005,16,13,29,37.519333,126.895302
영등포구,3221,서울특별시 남부교육지원청,202006,104,103,207,37.519333,126.895302
관악구,3301,도림천 신림2교,202006,10,9,19,#N/A,#N/A
관악구,3304,낙성대역 5번 출구,202006,286,264,550,37.477753,126.962364
관악구,3305,낙성대역 8번 출구,202006,171,151,322,37.476776,126.964867
관악구,3306,서울신우초등학교,202006,30,28,58,37.462147,126.931778
관악구,3307,봉천고개 육교,202006,109,30,139,37.491226,126.956078
관악구,3310,영락고등학교,202006,118,82,200,37.476627,126.943642
관악구,3311,서울대입구역 4번 출구,202006,134,123,257,37.48122,126.951576
종로구,3402,이화공영주차장,202004,28,15,43,37.576607,127.00557
종로구,3402,이화공영주차장,202005,190,149,339,37.576607,127.00557
종로구,3402,이화공영주차장,202006,421,338,759,37.576607,127.00557
종로구,3403,서울특별시 교육청,202003,29,22,51,37.569508,126.967011
종로구,3403,서울특별시 교육청,202004,151,62,213,37.569508,126.967011
종로구,3403,서울특별시 교육청,202005,109,94,203,37.569508,126.967011
종로구,3403,서울특별시 교육청,202006,142,116,258,37.569508,126.967011
종로구,3404,서울특별시 중부교육지원청,202003,1,1,2,37.571854,127.002358
종로구,3404,서울특별시 중부교육지원청,202006,74,48,122,37.571854,127.002358
종로구,3405,파크팰리스,202002,6,4,10,37.574551,126.970551
종로구,3405,파크팰리스,202003,89,72,161,37.574551,126.970551
종로구,3405,파크팰리스,202004,392,306,698,37.574551,126.970551
종로구,3405,파크팰리스,202005,532,466,998,37.574551,126.970551
종로구,3405,파크팰리스,202006,757,655,1412,37.574551,126.970551
종로구,3406,세종로공원,202004,2,0,2,37.574059,126.9758
종로구,3406,세종로공원,202006,148,104,252,37.574059,126.9758
종로구,3407,안국동사거리(신),202003,126,99,225,37.575806,126.983391
종로구,3407,안국동사거리(신),202004,434,363,797,37.575806,126.983391
종로구,3407,안국동사거리(신),202005,666,654,1320,37.575806,126.983391
종로구,3407,안국동사거리(신),202006,827,760,1587,37.575806,126.983391
종로구,3408,종로타워빌딩,202002,3,2,5,37.570511,126.983368
종로구,3408,종로타워빌딩,202003,118,96,214,37.570511,126.983368
종로구,3408,종로타워빌딩,202004,390,365,755,37.570511,126.983368
종로구,3408,종로타워빌딩,202005,575,574,1149,37.570511,126.983368
종로구,3408,종로타워빌딩,202006,1024,1005,2029,37.570511,126.983368
종로구,3410,종로3가역 8번출구,202003,80,80,160,37.572037,126.991844
종로구,3410,종로3가역 8번출구,202004,430,421,851,37.572037,126.991844
종로구,3410,종로3가역 8번출구,202005,88,88,176,37.572037,126.991844
종로구,3411,종묘,202003,61,49,110,37.570702,126.994812
종로구,3411,종묘,202004,338,308,646,37.570702,126.994812
종로구,3411,종묘,202005,362,359,721,37.570702,126.994812
종로구,3411,종묘,202006,623,614,1237,37.570702,126.994812
종로구,3412,세운상가,202003,95,81,176,37.570313,126.994545
종로구,3412,세운상가,202004,291,268,559,37.570313,126.994545
종로구,3412,세운상가,202005,351,333,684,37.570313,126.994545
종로구,3412,세운상가,202006,457,456,913,37.570313,126.994545
종로구,3413,종로플레이스,202003,98,90,188,37.5732,126.997963
종로구,3413,종로플레이스,202004,429,369,798,37.5732,126.997963
종로구,3413,종로플레이스,202005,621,605,1226,37.5732,126.997963
종로구,3413,종로플레이스,202006,1013,937,1950,37.5732,126.997963
종로구,3414,종로5가역 4번출구,202003,1,1,2,37.571175,127.002228
종로구,3414,종로5가역 4번출구,202006,41,40,81,37.571175,127.002228
종로구,3415,동대문역6번출구,202004,1,1,2,#N/A,#N/A
종로구,3415,동대문역6번출구,202006,167,166,333,#N/A,#N/A
종로구,3416,동묘앞역 6번출구,202003,1,1,2,37.571533,127.015617
종로구,3416,동묘앞역 6번출구,202004,3,3,6,37.571533,127.015617
종로구,3416,동묘앞역 6번출구,202006,60,51,111,37.571533,127.015617
종로구,3417,창신3동주민센터,202004,5,5,10,37.577724,127.015251
종로구,3417,창신3동주민센터,202005,1,1,2,37.577724,127.015251
종로구,3417,창신3동주민센터,202006,270,250,520,37.577724,127.015251
종로구,3418,창신역2번 출구,202003,1,1,2,37.579987,127.01506
종로구,3418,창신역2번 출구,202004,4,4,8,37.579987,127.01506
종로구,3418,창신역2번 출구,202005,12,16,28,37.579987,127.01506
종로구,3418,창신역2번 출구,202006,37,35,72,37.579987,127.01506
종로구,3419,국립어린이과학관,202003,1,1,2,37.581947,126.997368
종로구,3419,국립어린이과학관,202006,145,109,254,37.581947,126.997368
종로구,3420,성균관대입구사거리(맥도날드),202003,1,1,2,37.583275,126.998856
종로구,3420,성균관대입구사거리(맥도날드),202004,4,4,8,37.583275,126.998856
종로구,3420,성균관대입구사거리(맥도날드),202006,268,261,529,37.583275,126.998856
종로구,3421,혜화역 1번출구,202003,1,1,2,37.583855,127.001854
종로구,3421,혜화역 1번출구,202004,1,1,2,37.583855,127.001854
종로구,3421,혜화역 1번출구,202006,23,22,45,37.583855,127.001854
종로구,3422,성균관대 정문,202003,1,1,2,37.584797,126.997131
종로구,3422,성균관대 정문,202006,462,459,921,37.584797,126.997131
종로구,3423,현대그룹(본사),202003,1,1,2,37.575836,127.000694
종로구,3423,현대그룹(본사),202006,308,257,565,37.575836,127.000694
종로구,3425,광화문 풍림스페이스본 1단지앞,202004,3,3,6,37.574848,126.968269
종로구,3426,독립문역 2번출구 뒤,202003,1,1,2,37.575016,126.95755
종로구,3426,독립문역 2번출구 뒤,202006,94,80,174,37.575016,126.95755
종로구,3427,인왕산 아이파크 정문,202003,1,1,2,37.576603,126.956749
종로구,3427,인왕산 아이파크 정문,202006,88,90,178,37.576603,126.956749
종로구,3428,서울미술관,202003,1,1,2,37.595127,126.963493
종로구,3428,서울미술관,202006,118,98,216,37.595127,126.963493
종로구,3429,AW컨벤션앞,202003,1,1,2,37.59726,126.963089
종로구,3429,AW컨벤션앞,202006,74,45,119,37.59726,126.963089
종로구,3430,구기치안센터 앞,202003,1,1,2,37.60854,126.957138
종로구,3430,구기치안센터 앞,202006,77,55,132,37.60854,126.957138
종로구,3431,로제우스 레포츠센터,202003,1,1,2,37.607601,126.957687
종로구,3431,로제우스 레포츠센터,202006,79,62,141,37.607601,126.957687
종로구,3432,종로2가 사거리,202002,1,1,2,37.569992,126.988342
종로구,3432,종로2가 사거리,202003,62,54,116,37.569992,126.988342
종로구,3432,종로2가 사거리,202004,433,335,768,37.569992,126.988342
종로구,3432,종로2가 사거리,202005,722,708,1430,37.569992,126.988342
종로구,3432,종로2가 사거리,202006,901,900,1801,37.569992,126.988342
광진구,3500, 군자역2번출구,201901,491,535,1026,37.557587,127.079697
광진구,3500, 군자역2번출구,201902,456,495,951,37.557587,127.079697
광진구,3500, 군자역2번출구,201903,922,989,1911,37.557587,127.079697
광진구,3500, 군자역2번출구,201904,1458,1500,2958,37.557587,127.079697
광진구,3500, 군자역2번출구,201905,2155,2171,4326,37.557587,127.079697
광진구,3500, 군자역2번출구,201906,2406,2403,4809,37.557587,127.079697
광진구,3500, 군자역2번출구,201907,2223,2234,4457,37.557587,127.079697
광진구,3500, 군자역2번출구,201908,2010,2015,4025,37.557587,127.079697
광진구,3500, 군자역2번출구,201909,1946,1956,3902,37.557587,127.079697
광진구,3500, 군자역2번출구,201910,2309,2310,4619,37.557587,127.079697
광진구,3500, 군자역2번출구,201911,1448,1447,2895,37.557587,127.079697
광진구,3500, 군자역2번출구,201912,884,886,1770,37.557587,127.079697
광진구,3500, 군자역2번출구,202001,762,775,1537,37.557587,127.079697
광진구,3500, 군자역2번출구,202002,792,802,1594,37.557587,127.079697
광진구,3500, 군자역2번출구,202003,1393,1414,2807,37.557587,127.079697
광진구,3500, 군자역2번출구,202004,2046,2045,4091,37.557587,127.079697
광진구,3500, 군자역2번출구,202005,2404,2419,4823,37.557587,127.079697
광진구,3500, 군자역2번출구,202006,2610,2608,5218,37.557587,127.079697
광진구,3501, 광진구청 앞,201901,630,552,1182,37.539501,127.083
광진구,3501, 광진구청 앞,201902,651,581,1232,37.539501,127.083
광진구,3501, 광진구청 앞,201903,1368,1248,2616,37.539501,127.083
광진구,3501, 광진구청 앞,201904,2000,1922,3922,37.539501,127.083
광진구,3501, 광진구청 앞,201905,2811,2713,5524,37.539501,127.083
광진구,3501, 광진구청 앞,201906,2854,2790,5644,37.539501,127.083
광진구,3501, 광진구청 앞,201907,2648,2590,5238,37.539501,127.083
광진구,3501, 광진구청 앞,201908,2778,2709,5487,37.539501,127.083
광진구,3501, 광진구청 앞,201909,2735,2638,5373,37.539501,127.083
광진구,3501, 광진구청 앞,201910,2815,2761,5576,37.539501,127.083
광진구,3501, 광진구청 앞,201911,1904,1818,3722,37.539501,127.083
광진구,3501, 광진구청 앞,201912,1285,1264,2549,37.539501,127.083
광진구,3501, 광진구청 앞,202001,1199,1190,2389,37.539501,127.083
광진구,3501, 광진구청 앞,202002,1134,1125,2259,37.539501,127.083
광진구,3501, 광진구청 앞,202003,1741,1732,3473,37.539501,127.083
광진구,3501, 광진구청 앞,202004,2390,2356,4746,37.539501,127.083
광진구,3501, 광진구청 앞,202005,2621,2612,5233,37.539501,127.083
광진구,3501, 광진구청 앞,202006,2956,2904,5860,37.539501,127.083
광진구,3502, 중곡역 1번출구,201901,243,269,512,37.565659,127.084297
광진구,3502, 중곡역 1번출구,201902,245,285,530,37.565659,127.084297
광진구,3502, 중곡역 1번출구,201903,420,484,904,37.565659,127.084297
광진구,3502, 중곡역 1번출구,201904,674,748,1422,37.565659,127.084297
광진구,3502, 중곡역 1번출구,201905,931,1035,1966,37.565659,127.084297
광진구,3502, 중곡역 1번출구,201906,1070,1197,2267,37.565659,127.084297
광진구,3502, 중곡역 1번출구,201907,1057,1153,2210,37.565659,127.084297
광진구,3502, 중곡역 1번출구,201908,984,1020,2004,37.565659,127.084297
광진구,3502, 중곡역 1번출구,201909,987,990,1977,37.565659,127.084297
광진구,3502, 중곡역 1번출구,201910,1115,1121,2236,37.565659,127.084297
광진구,3502, 중곡역 1번출구,201911,734,721,1455,37.565659,127.084297
광진구,3502, 중곡역 1번출구,201912,502,505,1007,37.565659,127.084297
광진구,3502, 중곡역 1번출구,202001,403,403,806,37.565659,127.084297
광진구,3502, 중곡역 1번출구,202002,386,382,768,37.565659,127.084297
광진구,3502, 중곡역 1번출구,202003,604,629,1233,37.565659,127.084297
광진구,3502, 중곡역 1번출구,202004,932,937,1869,37.565659,127.084297
광진구,3502, 중곡역 1번출구,202005,961,972,1933,37.565659,127.084297
광진구,3502, 중곡역 1번출구,202006,998,992,1990,37.565659,127.084297
광진구,3503, 광진유진스웰,201901,155,16,171,37.550488,127.108955
광진구,3503, 광진유진스웰,201902,147,22,169,37.550488,127.108955
광진구,3503, 광진유진스웰,201903,263,49,312,37.550488,127.108955
광진구,3503, 광진유진스웰,201904,325,84,409,37.550488,127.108955
광진구,3503, 광진유진스웰,201905,446,144,590,37.550488,127.108955
광진구,3503, 광진유진스웰,201906,455,112,567,37.550488,127.108955
광진구,3503, 광진유진스웰,201907,377,81,458,37.550488,127.108955
광진구,3503, 광진유진스웰,201908,371,104,475,37.550488,127.108955
광진구,3503, 광진유진스웰,201909,179,71,250,37.550488,127.108955
광진구,3503, 광진유진스웰,201910,209,94,303,37.550488,127.108955
광진구,3503, 광진유진스웰,201911,163,51,214,37.550488,127.108955
광진구,3503, 광진유진스웰,201912,95,28,123,37.550488,127.108955
광진구,3503, 광진유진스웰,202001,156,25,181,37.550488,127.108955
광진구,3503, 광진유진스웰,202002,86,33,119,37.550488,127.108955
광진구,3503, 광진유진스웰,202003,163,84,247,37.550488,127.108955
광진구,3503, 광진유진스웰,202004,235,82,317,37.550488,127.108955
광진구,3503, 광진유진스웰,202005,185,91,276,37.550488,127.108955
광진구,3503, 광진유진스웰,202006,205,116,321,37.550488,127.108955
광진구,3504, 원일교회,201901,605,531,1136,37.538052,127.076599
광진구,3504, 원일교회,201902,521,439,960,37.538052,127.076599
광진구,3504, 원일교회,201903,1042,924,1966,37.538052,127.076599
광진구,3504, 원일교회,201904,1414,1295,2709,37.538052,127.076599
광진구,3504, 원일교회,201905,2161,2043,4204,37.538052,127.076599
광진구,3504, 원일교회,201906,2358,2224,4582,37.538052,127.076599
광진구,3504, 원일교회,201907,2275,2186,4461,37.538052,127.076599
광진구,3504, 원일교회,201908,2191,2080,4271,37.538052,127.076599
광진구,3504, 원일교회,201909,1980,1850,3830,37.538052,127.076599
광진구,3504, 원일교회,201910,2113,2046,4159,37.538052,127.076599
광진구,3504, 원일교회,201911,1666,1472,3138,37.538052,127.076599
광진구,3504, 원일교회,201912,1035,1014,2049,37.538052,127.076599
광진구,3504, 원일교회,202001,1002,937,1939,37.538052,127.076599
광진구,3504, 원일교회,202002,874,825,1699,37.538052,127.076599
광진구,3504, 원일교회,202003,1363,1345,2708,37.538052,127.076599
광진구,3504, 원일교회,202004,1924,1895,3819,37.538052,127.076599
광진구,3504, 원일교회,202005,2193,2175,4368,37.538052,127.076599
광진구,3504, 원일교회,202006,2263,2199,4462,37.538052,127.076599
광진구,3505, 신양초교앞 교차로,201901,270,257,527,37.535221,127.068398
광진구,3505, 신양초교앞 교차로,201902,266,242,508,37.535221,127.068398
광진구,3505, 신양초교앞 교차로,201903,571,533,1104,37.535221,127.068398
광진구,3505, 신양초교앞 교차로,201904,995,904,1899,37.535221,127.068398
광진구,3505, 신양초교앞 교차로,201905,1132,1070,2202,37.535221,127.068398
광진구,3505, 신양초교앞 교차로,201906,1365,1320,2685,37.535221,127.068398
광진구,3505, 신양초교앞 교차로,201907,1511,1404,2915,37.535221,127.068398
광진구,3505, 신양초교앞 교차로,201908,1475,1435,2910,37.535221,127.068398
광진구,3505, 신양초교앞 교차로,201909,1252,1241,2493,37.535221,127.068398
광진구,3505, 신양초교앞 교차로,201910,1655,1606,3261,37.535221,127.068398
광진구,3505, 신양초교앞 교차로,201911,1055,1033,2088,37.535221,127.068398
광진구,3505, 신양초교앞 교차로,201912,685,651,1336,37.535221,127.068398
광진구,3505, 신양초교앞 교차로,202001,555,563,1118,37.535221,127.068398
광진구,3505, 신양초교앞 교차로,202002,484,484,968,37.535221,127.068398
광진구,3505, 신양초교앞 교차로,202003,971,976,1947,37.535221,127.068398
광진구,3505, 신양초교앞 교차로,202004,1303,1300,2603,37.535221,127.068398
광진구,3505, 신양초교앞 교차로,202005,1409,1397,2806,37.535221,127.068398
광진구,3505, 신양초교앞 교차로,202006,1400,1380,2780,37.535221,127.068398
광진구,3506, 영동대교 북단,201901,322,339,661,37.537014,127.061096
광진구,3506, 영동대교 북단,201902,314,335,649,37.537014,127.061096
광진구,3506, 영동대교 북단,201903,682,679,1361,37.537014,127.061096
광진구,3506, 영동대교 북단,201904,971,1040,2011,37.537014,127.061096
광진구,3506, 영동대교 북단,201905,1475,1502,2977,37.537014,127.061096
광진구,3506, 영동대교 북단,201906,1688,1709,3397,37.537014,127.061096
광진구,3506, 영동대교 북단,201907,1708,1730,3438,37.537014,127.061096
광진구,3506, 영동대교 북단,201908,1537,1537,3074,37.537014,127.061096
광진구,3506, 영동대교 북단,201909,1503,1510,3013,37.537014,127.061096
광진구,3506, 영동대교 북단,201910,1665,1652,3317,37.537014,127.061096
광진구,3506, 영동대교 북단,201911,1177,1191,2368,37.537014,127.061096
광진구,3506, 영동대교 북단,201912,687,678,1365,37.537014,127.061096
광진구,3506, 영동대교 북단,202001,530,533,1063,37.537014,127.061096
광진구,3506, 영동대교 북단,202002,555,561,1116,37.537014,127.061096
광진구,3506, 영동대교 북단,202003,985,993,1978,37.537014,127.061096
광진구,3506, 영동대교 북단,202004,1297,1308,2605,37.537014,127.061096
광진구,3506, 영동대교 북단,202005,1431,1417,2848,37.537014,127.061096
광진구,3506, 영동대교 북단,202006,1504,1491,2995,37.537014,127.061096
광진구,3507, 어린이회관,201901,412,298,710,37.545952,127.078003
광진구,3507, 어린이회관,201902,306,208,514,37.545952,127.078003
광진구,3507, 어린이회관,201903,643,413,1056,37.545952,127.078003
광진구,3507, 어린이회관,201904,956,608,1564,37.545952,127.078003
광진구,3507, 어린이회관,201905,1208,798,2006,37.545952,127.078003
광진구,3507, 어린이회관,201906,1149,821,1970,37.545952,127.078003
광진구,3507, 어린이회관,201907,1030,786,1816,37.545952,127.078003
광진구,3507, 어린이회관,201908,976,825,1801,37.545952,127.078003
광진구,3507, 어린이회관,201909,955,780,1735,37.545952,127.078003
광진구,3507, 어린이회관,201910,1140,862,2002,37.545952,127.078003
광진구,3507, 어린이회관,201911,873,604,1477,37.545952,127.078003
광진구,3507, 어린이회관,201912,530,375,905,37.545952,127.078003
광진구,3507, 어린이회관,202001,578,331,909,37.545952,127.078003
광진구,3507, 어린이회관,202002,577,324,901,37.545952,127.078003
광진구,3507, 어린이회관,202003,878,514,1392,37.545952,127.078003
광진구,3507, 어린이회관,202004,765,548,1313,37.545952,127.078003
광진구,3507, 어린이회관,202005,635,498,1133,37.545952,127.078003
광진구,3507, 어린이회관,202006,1066,593,1659,37.545952,127.078003
광진구,3508, 화양사거리,201901,816,825,1641,37.548222,127.067879
광진구,3508, 화양사거리,201902,620,660,1280,37.548222,127.067879
광진구,3508, 화양사거리,201903,1318,1296,2614,37.548222,127.067879
광진구,3508, 화양사거리,201904,2079,1987,4066,37.548222,127.067879
광진구,3508, 화양사거리,201905,3111,3070,6181,37.548222,127.067879
광진구,3508, 화양사거리,201906,3168,3142,6310,37.548222,127.067879
광진구,3508, 화양사거리,201907,3118,3116,6234,37.548222,127.067879
광진구,3508, 화양사거리,201908,2986,2980,5966,37.548222,127.067879
광진구,3508, 화양사거리,201909,2679,2674,5353,37.548222,127.067879
광진구,3508, 화양사거리,201910,3181,3155,6336,37.548222,127.067879
광진구,3508, 화양사거리,201911,2169,2176,4345,37.548222,127.067879
광진구,3508, 화양사거리,201912,1359,1367,2726,37.548222,127.067879
광진구,3508, 화양사거리,202001,1114,1104,2218,37.548222,127.067879
광진구,3508, 화양사거리,202002,1026,1028,2054,37.548222,127.067879
광진구,3508, 화양사거리,202003,1892,1934,3826,37.548222,127.067879
광진구,3508, 화양사거리,202004,2524,2526,5050,37.548222,127.067879
광진구,3508, 화양사거리,202005,2967,2973,5940,37.548222,127.067879
광진구,3508, 화양사거리,202006,2904,2884,5788,37.548222,127.067879
광진구,3509, 세종사이버대학교,201901,1046,1116,2162,37.553417,127.073196
광진구,3509, 세종사이버대학교,201902,836,939,1775,37.553417,127.073196
광진구,3509, 세종사이버대학교,201903,1594,1741,3335,37.553417,127.073196
광진구,3509, 세종사이버대학교,201904,2485,2630,5115,37.553417,127.073196
광진구,3509, 세종사이버대학교,201905,3640,3767,7407,37.553417,127.073196
광진구,3509, 세종사이버대학교,201906,3842,3935,7777,37.553417,127.073196
광진구,3509, 세종사이버대학교,201907,3641,3707,7348,37.553417,127.073196
광진구,3509, 세종사이버대학교,201908,3348,3405,6753,37.553417,127.073196
광진구,3509, 세종사이버대학교,201909,3513,3525,7038,37.553417,127.073196
광진구,3509, 세종사이버대학교,201910,3713,3724,7437,37.553417,127.073196
광진구,3509, 세종사이버대학교,201911,2720,2811,5531,37.553417,127.073196
광진구,3509, 세종사이버대학교,201912,1782,1811,3593,37.553417,127.073196
광진구,3509, 세종사이버대학교,202001,1425,1486,2911,37.553417,127.073196
광진구,3509, 세종사이버대학교,202002,1340,1432,2772,37.553417,127.073196
광진구,3509, 세종사이버대학교,202003,1994,2085,4079,37.553417,127.073196
광진구,3509, 세종사이버대학교,202004,2336,2369,4705,37.553417,127.073196
광진구,3509, 세종사이버대학교,202005,2713,2753,5466,37.553417,127.073196
광진구,3509, 세종사이버대학교,202006,3332,3360,6692,37.553417,127.073196
광진구,3510, 중곡SK아파트앞,201901,209,194,403,37.568649,127.08625
광진구,3510, 중곡SK아파트앞,201902,156,144,300,37.568649,127.08625
광진구,3510, 중곡SK아파트앞,201903,290,279,569,37.568649,127.08625
광진구,3510, 중곡SK아파트앞,201904,395,397,792,37.568649,127.08625
광진구,3510, 중곡SK아파트앞,201905,604,596,1200,37.568649,127.08625
광진구,3510, 중곡SK아파트앞,201906,722,718,1440,37.568649,127.08625
광진구,3510, 중곡SK아파트앞,201907,516,509,1025,37.568649,127.08625
광진구,3510, 중곡SK아파트앞,201908,672,671,1343,37.568649,127.08625
광진구,3510, 중곡SK아파트앞,201909,574,594,1168,37.568649,127.08625
광진구,3510, 중곡SK아파트앞,201910,840,839,1679,37.568649,127.08625
광진구,3510, 중곡SK아파트앞,201911,518,529,1047,37.568649,127.08625
광진구,3510, 중곡SK아파트앞,201912,294,287,581,37.568649,127.08625
광진구,3510, 중곡SK아파트앞,202001,241,245,486,37.568649,127.08625
광진구,3510, 중곡SK아파트앞,202002,252,228,480,37.568649,127.08625
광진구,3510, 중곡SK아파트앞,202003,390,387,777,37.568649,127.08625
광진구,3510, 중곡SK아파트앞,202004,628,596,1224,37.568649,127.08625
광진구,3510, 중곡SK아파트앞,202005,763,700,1463,37.568649,127.08625
광진구,3510, 중곡SK아파트앞,202006,808,754,1562,37.568649,127.08625
성동구,3511, 응봉역 1번출구,201901,517,587,1104,37.55125,127.035103
성동구,3511, 응봉역 1번출구,201902,616,748,1364,37.55125,127.035103
성동구,3511, 응봉역 1번출구,201903,1242,1402,2644,37.55125,127.035103
성동구,3511, 응봉역 1번출구,201904,2092,2382,4474,37.55125,127.035103
성동구,3511, 응봉역 1번출구,201905,3309,3710,7019,37.55125,127.035103
성동구,3511, 응봉역 1번출구,201906,3349,3632,6981,37.55125,127.035103
성동구,3511, 응봉역 1번출구,201907,2993,3467,6460,37.55125,127.035103
성동구,3511, 응봉역 1번출구,201908,3441,3899,7340,37.55125,127.035103
성동구,3511, 응봉역 1번출구,201909,3798,4060,7858,37.55125,127.035103
성동구,3511, 응봉역 1번출구,201910,3477,3828,7305,37.55125,127.035103
성동구,3511, 응봉역 1번출구,201911,1938,2110,4048,37.55125,127.035103
성동구,3511, 응봉역 1번출구,201912,857,947,1804,37.55125,127.035103
성동구,3511, 응봉역 1번출구,202001,898,1016,1914,37.55125,127.035103
성동구,3511, 응봉역 1번출구,202002,1004,1125,2129,37.55125,127.035103
성동구,3511, 응봉역 1번출구,202003,4012,4479,8491,37.55125,127.035103
성동구,3511, 응봉역 1번출구,202004,5541,6064,11605,37.55125,127.035103
성동구,3511, 응봉역 1번출구,202005,6192,6488,12680,37.55125,127.035103
성동구,3511, 응봉역 1번출구,202006,5560,5751,11311,37.55125,127.035103
성동구,3513, 상왕십리역 1번출구,201901,642,434,1076,37.56461,127.029198
성동구,3513, 상왕십리역 1번출구,201902,457,352,809,37.56461,127.029198
성동구,3513, 상왕십리역 1번출구,201903,815,648,1463,37.56461,127.029198
성동구,3513, 상왕십리역 1번출구,201904,1201,1021,2222,37.56461,127.029198
성동구,3513, 상왕십리역 1번출구,201905,2019,1852,3871,37.56461,127.029198
성동구,3513, 상왕십리역 1번출구,201906,1935,1578,3513,37.56461,127.029198
성동구,3513, 상왕십리역 1번출구,201907,2000,1506,3506,37.56461,127.029198
성동구,3513, 상왕십리역 1번출구,201908,1871,1343,3214,37.56461,127.029198
성동구,3513, 상왕십리역 1번출구,201909,1461,1284,2745,37.56461,127.029198
성동구,3513, 상왕십리역 1번출구,201910,2091,1446,3537,37.56461,127.029198
성동구,3513, 상왕십리역 1번출구,201911,1480,951,2431,37.56461,127.029198
성동구,3513, 상왕십리역 1번출구,201912,788,566,1354,37.56461,127.029198
성동구,3513, 상왕십리역 1번출구,202001,789,476,1265,37.56461,127.029198
성동구,3513, 상왕십리역 1번출구,202002,624,478,1102,37.56461,127.029198
성동구,3513, 상왕십리역 1번출구,202003,1052,894,1946,37.56461,127.029198
성동구,3513, 상왕십리역 1번출구,202004,1290,1220,2510,37.56461,127.029198
성동구,3513, 상왕십리역 1번출구,202005,1237,1191,2428,37.56461,127.029198
성동구,3513, 상왕십리역 1번출구,202006,1418,1393,2811,37.56461,127.029198
성동구,3514, 왕십리교회옆,201901,566,490,1056,37.566261,127.023697
성동구,3514, 왕십리교회옆,201902,455,433,888,37.566261,127.023697
성동구,3514, 왕십리교회옆,201903,889,857,1746,37.566261,127.023697
성동구,3514, 왕십리교회옆,201904,1237,1182,2419,37.566261,127.023697
성동구,3514, 왕십리교회옆,201905,1866,1770,3636,37.566261,127.023697
성동구,3514, 왕십리교회옆,201906,2071,1994,4065,37.566261,127.023697
성동구,3514, 왕십리교회옆,201907,2306,2231,4537,37.566261,127.023697
성동구,3514, 왕십리교회옆,201908,2180,2069,4249,37.566261,127.023697
성동구,3514, 왕십리교회옆,201909,1949,1888,3837,37.566261,127.023697
성동구,3514, 왕십리교회옆,201910,2363,2329,4692,37.566261,127.023697
성동구,3514, 왕십리교회옆,201911,1740,1658,3398,37.566261,127.023697
성동구,3514, 왕십리교회옆,201912,1073,1036,2109,37.566261,127.023697
성동구,3514, 왕십리교회옆,202001,892,888,1780,37.566261,127.023697
성동구,3514, 왕십리교회옆,202002,856,814,1670,37.566261,127.023697
성동구,3514, 왕십리교회옆,202003,1402,1388,2790,37.566261,127.023697
성동구,3514, 왕십리교회옆,202004,1697,1681,3378,37.566261,127.023697
성동구,3514, 왕십리교회옆,202005,1813,1791,3604,37.566261,127.023697
성동구,3514, 왕십리교회옆,202006,2198,2191,4389,37.566261,127.023697
성동구,3515, 서울숲 관리사무소,201901,205,230,435,37.542816,127.042084
성동구,3515, 서울숲 관리사무소,201902,452,476,928,37.542816,127.042084
성동구,3515, 서울숲 관리사무소,201903,1308,1398,2706,37.542816,127.042084
성동구,3515, 서울숲 관리사무소,201904,3264,3410,6674,37.542816,127.042084
성동구,3515, 서울숲 관리사무소,201905,5254,5155,10409,37.542816,127.042084
성동구,3515, 서울숲 관리사무소,201906,3824,3612,7436,37.542816,127.042084
성동구,3515, 서울숲 관리사무소,201907,2373,2169,4542,37.542816,127.042084
성동구,3515, 서울숲 관리사무소,201908,2715,2581,5296,37.542816,127.042084
성동구,3515, 서울숲 관리사무소,201909,3322,3254,6576,37.542816,127.042084
성동구,3515, 서울숲 관리사무소,201910,3929,3995,7924,37.542816,127.042084
성동구,3515, 서울숲 관리사무소,201911,1559,1623,3182,37.542816,127.042084
성동구,3515, 서울숲 관리사무소,201912,381,397,778,37.542816,127.042084
성동구,3515, 서울숲 관리사무소,202001,568,573,1141,37.542816,127.042084
성동구,3515, 서울숲 관리사무소,202002,866,874,1740,37.542816,127.042084
성동구,3515, 서울숲 관리사무소,202003,4447,4688,9135,37.542816,127.042084
성동구,3515, 서울숲 관리사무소,202004,6022,6203,12225,37.542816,127.042084
성동구,3515, 서울숲 관리사무소,202005,5713,5622,11335,37.542816,127.042084
성동구,3515, 서울숲 관리사무소,202006,3704,3592,7296,37.542816,127.042084
광진구,3516, 구의아리수정수센터앞,201901,235,194,429,37.543705,127.093246
광진구,3516, 구의아리수정수센터앞,201902,220,199,419,37.543705,127.093246
광진구,3516, 구의아리수정수센터앞,201903,502,478,980,37.543705,127.093246
광진구,3516, 구의아리수정수센터앞,201904,831,826,1657,37.543705,127.093246
광진구,3516, 구의아리수정수센터앞,201905,1117,1105,2222,37.543705,127.093246
광진구,3516, 구의아리수정수센터앞,201906,1186,1186,2372,37.543705,127.093246
광진구,3516, 구의아리수정수센터앞,201907,346,358,704,37.543705,127.093246
광진구,3516, 구의아리수정수센터앞,201908,870,869,1739,37.543705,127.093246
광진구,3516, 구의아리수정수센터앞,201909,1219,1140,2359,37.543705,127.093246
광진구,3516, 구의아리수정수센터앞,201910,1309,1292,2601,37.543705,127.093246
광진구,3516, 구의아리수정수센터앞,201911,855,814,1669,37.543705,127.093246
광진구,3516, 구의아리수정수센터앞,201912,617,599,1216,37.543705,127.093246
광진구,3516, 구의아리수정수센터앞,202001,580,537,1117,37.543705,127.093246
광진구,3516, 구의아리수정수센터앞,202002,418,384,802,37.543705,127.093246
광진구,3516, 구의아리수정수센터앞,202003,664,665,1329,37.543705,127.093246
광진구,3516, 구의아리수정수센터앞,202004,879,863,1742,37.543705,127.093246
광진구,3516, 구의아리수정수센터앞,202005,996,962,1958,37.543705,127.093246
광진구,3516, 구의아리수정수센터앞,202006,1077,1075,2152,37.543705,127.093246
광진구,3517, 용마사거리,201901,300,341,641,37.562527,127.082275
광진구,3517, 용마사거리,201902,258,284,542,37.562527,127.082275
광진구,3517, 용마사거리,201903,534,651,1185,37.562527,127.082275
광진구,3517, 용마사거리,201904,811,974,1785,37.562527,127.082275
광진구,3517, 용마사거리,201905,1400,1684,3084,37.562527,127.082275
광진구,3517, 용마사거리,201906,1572,1921,3493,37.562527,127.082275
광진구,3517, 용마사거리,201907,1640,2044,3684,37.562527,127.082275
광진구,3517, 용마사거리,201908,1684,2043,3727,37.562527,127.082275
광진구,3517, 용마사거리,201909,1726,1887,3613,37.562527,127.082275
광진구,3517, 용마사거리,201910,2234,2372,4606,37.562527,127.082275
광진구,3517, 용마사거리,201911,1509,1644,3153,37.562527,127.082275
광진구,3517, 용마사거리,201912,878,941,1819,37.562527,127.082275
광진구,3517, 용마사거리,202001,693,809,1502,37.562527,127.082275
광진구,3517, 용마사거리,202002,723,825,1548,37.562527,127.082275
광진구,3517, 용마사거리,202003,1238,1395,2633,37.562527,127.082275
광진구,3517, 용마사거리,202004,1907,2036,3943,37.562527,127.082275
광진구,3517, 용마사거리,202005,2174,2208,4382,37.562527,127.082275
광진구,3517, 용마사거리,202006,2308,2516,4824,37.562527,127.082275
광진구,3518, 군자역 7번출구뒤,201901,680,710,1390,37.556862,127.07914
광진구,3518, 군자역 7번출구뒤,201902,844,885,1729,37.556862,127.07914
광진구,3518, 군자역 7번출구뒤,201903,1662,1699,3361,37.556862,127.07914
광진구,3518, 군자역 7번출구뒤,201904,2378,2463,4841,37.556862,127.07914
광진구,3518, 군자역 7번출구뒤,201905,4170,4202,8372,37.556862,127.07914
광진구,3518, 군자역 7번출구뒤,201906,4489,4519,9008,37.556862,127.07914
광진구,3518, 군자역 7번출구뒤,201907,3828,3823,7651,37.556862,127.07914
광진구,3518, 군자역 7번출구뒤,201908,3621,3635,7256,37.556862,127.07914
광진구,3518, 군자역 7번출구뒤,201909,3717,3717,7434,37.556862,127.07914
광진구,3518, 군자역 7번출구뒤,201910,4094,4098,8192,37.556862,127.07914
광진구,3518, 군자역 7번출구뒤,201911,2992,3078,6070,37.556862,127.07914
광진구,3518, 군자역 7번출구뒤,201912,1818,1850,3668,37.556862,127.07914
광진구,3518, 군자역 7번출구뒤,202001,1619,1615,3234,37.556862,127.07914
광진구,3518, 군자역 7번출구뒤,202002,1582,1597,3179,37.556862,127.07914
광진구,3518, 군자역 7번출구뒤,202003,2458,2534,4992,37.556862,127.07914
광진구,3518, 군자역 7번출구뒤,202004,3470,3460,6930,37.556862,127.07914
광진구,3518, 군자역 7번출구뒤,202005,3966,3964,7930,37.556862,127.07914
광진구,3518, 군자역 7번출구뒤,202006,4303,4293,8596,37.556862,127.07914
성동구,3519, 용답역 1번 출구,201901,555,703,1258,#N/A,#N/A
성동구,3519, 용답역 1번 출구,201902,470,640,1110,#N/A,#N/A
성동구,3519, 용답역 1번 출구,201903,1115,1483,2598,#N/A,#N/A
성동구,3519, 용답역 1번 출구,201904,1621,2120,3741,#N/A,#N/A
성동구,3519, 용답역 1번 출구,201905,2771,3298,6069,#N/A,#N/A
성동구,3519, 용답역 1번 출구,201906,2732,3271,6003,#N/A,#N/A
성동구,3519, 용답역 1번 출구,201907,2370,3003,5373,#N/A,#N/A
성동구,3519, 용답역 1번 출구,201908,2324,2832,5156,#N/A,#N/A
성동구,3519, 용답역 1번 출구,201909,2744,3227,5971,#N/A,#N/A
성동구,3519, 용답역 1번 출구,201910,3289,3638,6927,#N/A,#N/A
성동구,3519, 용답역 1번 출구,201911,1811,2291,4102,#N/A,#N/A
성동구,3519, 용답역 1번 출구,201912,1076,1393,2469,#N/A,#N/A
성동구,3519, 용답역 1번 출구,202001,1089,1378,2467,#N/A,#N/A
성동구,3519, 용답역 1번 출구,202002,1110,1348,2458,#N/A,#N/A
성동구,3519, 용답역 1번 출구,202003,2877,3268,6145,#N/A,#N/A
성동구,3519, 용답역 1번 출구,202004,4112,4529,8641,#N/A,#N/A
성동구,3519, 용답역 1번 출구,202005,4921,5433,10354,#N/A,#N/A
성동구,3519, 용답역 1번 출구,202006,3006,3463,6469,#N/A,#N/A
광진구,3520, 광진경찰서,201901,776,729,1505,37.542519,127.084084
광진구,3520, 광진경찰서,201902,625,629,1254,37.542519,127.084084
광진구,3520, 광진경찰서,201903,1283,1248,2531,37.542519,127.084084
광진구,3520, 광진경찰서,201904,1804,1768,3572,37.542519,127.084084
광진구,3520, 광진경찰서,201905,2563,2590,5153,37.542519,127.084084
광진구,3520, 광진경찰서,201906,2679,2651,5330,37.542519,127.084084
광진구,3520, 광진경찰서,201907,2631,2626,5257,37.542519,127.084084
광진구,3520, 광진경찰서,201908,2388,2374,4762,37.542519,127.084084
광진구,3520, 광진경찰서,201909,2418,2395,4813,37.542519,127.084084
광진구,3520, 광진경찰서,201910,2717,2657,5374,37.542519,127.084084
광진구,3520, 광진경찰서,201911,1774,1752,3526,37.542519,127.084084
광진구,3520, 광진경찰서,201912,1029,1012,2041,37.542519,127.084084
광진구,3520, 광진경찰서,202001,942,961,1903,37.542519,127.084084
광진구,3520, 광진경찰서,202002,854,881,1735,37.542519,127.084084
광진구,3520, 광진경찰서,202003,1399,1442,2841,37.542519,127.084084
광진구,3520, 광진경찰서,202004,1852,1850,3702,37.542519,127.084084
광진구,3520, 광진경찰서,202005,1937,1931,3868,37.542519,127.084084
광진구,3520, 광진경찰서,202006,2389,2407,4796,37.542519,127.084084
광진구,3521, 현대홈타운 뒷길,201901,105,92,197,37.543427,127.096619
광진구,3521, 현대홈타운 뒷길,201902,94,68,162,37.543427,127.096619
광진구,3521, 현대홈타운 뒷길,201903,162,122,284,37.543427,127.096619
광진구,3521, 현대홈타운 뒷길,201904,311,216,527,37.543427,127.096619
광진구,3521, 현대홈타운 뒷길,201905,331,272,603,37.543427,127.096619
광진구,3521, 현대홈타운 뒷길,201906,317,277,594,37.543427,127.096619
광진구,3521, 현대홈타운 뒷길,201907,339,296,635,37.543427,127.096619
광진구,3521, 현대홈타운 뒷길,201908,406,377,783,37.543427,127.096619
광진구,3521, 현대홈타운 뒷길,201909,313,277,590,37.543427,127.096619
광진구,3521, 현대홈타운 뒷길,201910,429,403,832,37.543427,127.096619
광진구,3521, 현대홈타운 뒷길,201911,278,265,543,37.543427,127.096619
광진구,3521, 현대홈타운 뒷길,201912,208,167,375,37.543427,127.096619
광진구,3521, 현대홈타운 뒷길,202001,112,113,225,37.543427,127.096619
광진구,3521, 현대홈타운 뒷길,202002,182,137,319,37.543427,127.096619
광진구,3521, 현대홈타운 뒷길,202003,290,264,554,37.543427,127.096619
광진구,3521, 현대홈타운 뒷길,202004,393,386,779,37.543427,127.096619
광진구,3521, 현대홈타운 뒷길,202005,349,341,690,37.543427,127.096619
광진구,3521, 현대홈타운 뒷길,202006,347,337,684,37.543427,127.096619
성동구,3522, 사근삼거리,201901,61,53,114,#N/A,#N/A
성동구,3522, 사근삼거리,201902,340,342,682,#N/A,#N/A
성동구,3522, 사근삼거리,201903,1047,1059,2106,#N/A,#N/A
성동구,3522, 사근삼거리,201904,1389,1471,2860,#N/A,#N/A
성동구,3522, 사근삼거리,201905,2511,2598,5109,#N/A,#N/A
성동구,3522, 사근삼거리,201906,2355,2390,4745,#N/A,#N/A
성동구,3522, 사근삼거리,201907,1906,1960,3866,#N/A,#N/A
성동구,3522, 사근삼거리,201908,1848,1909,3757,#N/A,#N/A
성동구,3522, 사근삼거리,201909,2300,2379,4679,#N/A,#N/A
성동구,3522, 사근삼거리,201910,2559,2568,5127,#N/A,#N/A
성동구,3522, 사근삼거리,201911,1579,1602,3181,#N/A,#N/A
성동구,3522, 사근삼거리,201912,655,666,1321,#N/A,#N/A
성동구,3522, 사근삼거리,202001,19,20,39,#N/A,#N/A
광진구,3523, 건국대학교 과학관(이과대) 앞,201901,314,384,698,37.541718,127.08017
광진구,3523, 건국대학교 과학관(이과대) 앞,201902,210,243,453,37.541718,127.08017
광진구,3523, 건국대학교 과학관(이과대) 앞,201903,828,1160,1988,37.541718,127.08017
광진구,3523, 건국대학교 과학관(이과대) 앞,201904,1318,1712,3030,37.541718,127.08017
광진구,3523, 건국대학교 과학관(이과대) 앞,201905,1837,2154,3991,37.541718,127.08017
광진구,3523, 건국대학교 과학관(이과대) 앞,201906,1846,2002,3848,37.541718,127.08017
광진구,3523, 건국대학교 과학관(이과대) 앞,201907,1106,1220,2326,37.541718,127.08017
광진구,3523, 건국대학교 과학관(이과대) 앞,201908,994,1122,2116,37.541718,127.08017
광진구,3523, 건국대학교 과학관(이과대) 앞,201909,1465,1668,3133,37.541718,127.08017
광진구,3523, 건국대학교 과학관(이과대) 앞,201910,1897,2030,3927,37.541718,127.08017
광진구,3523, 건국대학교 과학관(이과대) 앞,201911,1414,1546,2960,37.541718,127.08017
광진구,3523, 건국대학교 과학관(이과대) 앞,201912,722,837,1559,37.541718,127.08017
광진구,3523, 건국대학교 과학관(이과대) 앞,202001,297,365,662,37.541718,127.08017
광진구,3523, 건국대학교 과학관(이과대) 앞,202002,248,275,523,37.541718,127.08017
광진구,3523, 건국대학교 과학관(이과대) 앞,202003,418,427,845,37.541718,127.08017
광진구,3523, 건국대학교 과학관(이과대) 앞,202004,474,480,954,37.541718,127.08017
광진구,3523, 건국대학교 과학관(이과대) 앞,202005,504,563,1067,37.541718,127.08017
광진구,3523, 건국대학교 과학관(이과대) 앞,202006,821,909,1730,37.541718,127.08017
광진구,3524, 세종대학교,201901,176,167,343,37.550236,127.073822
광진구,3524, 세종대학교,201902,123,108,231,37.550236,127.073822
광진구,3524, 세종대학교,201903,381,396,777,37.550236,127.073822
광진구,3524, 세종대학교,201904,581,512,1093,37.550236,127.073822
광진구,3524, 세종대학교,201905,709,671,1380,37.550236,127.073822
광진구,3524, 세종대학교,201906,659,653,1312,37.550236,127.073822
광진구,3524, 세종대학교,201907,559,508,1067,37.550236,127.073822
광진구,3524, 세종대학교,201908,397,372,769,37.550236,127.073822
광진구,3524, 세종대학교,201909,669,651,1320,37.550236,127.073822
광진구,3524, 세종대학교,201910,769,753,1522,37.550236,127.073822
광진구,3524, 세종대학교,201911,591,559,1150,37.550236,127.073822
광진구,3524, 세종대학교,201912,290,275,565,37.550236,127.073822
광진구,3524, 세종대학교,202001,91,90,181,37.550236,127.073822
광진구,3524, 세종대학교,202002,83,60,143,37.550236,127.073822
광진구,3524, 세종대학교,202003,124,85,209,37.550236,127.073822
광진구,3524, 세종대학교,202004,86,88,174,37.550236,127.073822
광진구,3524, 세종대학교,202005,132,132,264,37.550236,127.073822
광진구,3524, 세종대학교,202006,211,212,423,37.550236,127.073822
성동구,3525, 금호스포츠센터앞,201901,78,103,181,37.546089,127.02507
성동구,3525, 금호스포츠센터앞,201902,98,134,232,37.546089,127.02507
성동구,3525, 금호스포츠센터앞,201903,238,319,557,37.546089,127.02507
성동구,3525, 금호스포츠센터앞,201904,566,660,1226,37.546089,127.02507
성동구,3525, 금호스포츠센터앞,201905,1189,1289,2478,37.546089,127.02507
성동구,3525, 금호스포츠센터앞,201906,1057,1234,2291,37.546089,127.02507
성동구,3525, 금호스포츠센터앞,201907,924,1169,2093,37.546089,127.02507
성동구,3525, 금호스포츠센터앞,201908,1043,1164,2207,37.546089,127.02507
성동구,3525, 금호스포츠센터앞,201909,1267,1355,2622,37.546089,127.02507
성동구,3525, 금호스포츠센터앞,201910,1297,1397,2694,37.546089,127.02507
성동구,3525, 금호스포츠센터앞,201911,680,721,1401,37.546089,127.02507
성동구,3525, 금호스포츠센터앞,201912,248,284,532,37.546089,127.02507
성동구,3525, 금호스포츠센터앞,202001,194,254,448,37.546089,127.02507
성동구,3525, 금호스포츠센터앞,202002,297,351,648,37.546089,127.02507
성동구,3525, 금호스포츠센터앞,202003,1482,1527,3009,37.546089,127.02507
성동구,3525, 금호스포츠센터앞,202004,2226,2372,4598,37.546089,127.02507
성동구,3525, 금호스포츠센터앞,202005,2332,2470,4802,37.546089,127.02507
성동구,3525, 금호스포츠센터앞,202006,1874,1969,3843,37.546089,127.02507
성동구,3527, 왕십리 자이아파트,201901,66,4,70,37.56179,127.024391
성동구,3527, 왕십리 자이아파트,201902,54,4,58,37.56179,127.024391
성동구,3527, 왕십리 자이아파트,201903,93,14,107,37.56179,127.024391
성동구,3527, 왕십리 자이아파트,201904,106,30,136,37.56179,127.024391
성동구,3527, 왕십리 자이아파트,201905,77,14,91,37.56179,127.024391
성동구,3527, 왕십리 자이아파트,201906,106,27,133,37.56179,127.024391
성동구,3527, 왕십리 자이아파트,201907,191,32,223,37.56179,127.024391
성동구,3527, 왕십리 자이아파트,201908,87,33,120,37.56179,127.024391
성동구,3527, 왕십리 자이아파트,201909,87,29,116,37.56179,127.024391
성동구,3527, 왕십리 자이아파트,201910,112,25,137,37.56179,127.024391
성동구,3527, 왕십리 자이아파트,201911,126,28,154,37.56179,127.024391
성동구,3527, 왕십리 자이아파트,201912,63,18,81,37.56179,127.024391
성동구,3527, 왕십리 자이아파트,202001,87,9,96,37.56179,127.024391
성동구,3527, 왕십리 자이아파트,202002,13,7,20,37.56179,127.024391
성동구,3527, 왕십리 자이아파트,202003,15,16,31,37.56179,127.024391
성동구,3527, 왕십리 자이아파트,202004,29,22,51,37.56179,127.024391
성동구,3527, 왕십리 자이아파트,202005,30,26,56,37.56179,127.024391
성동구,3527, 왕십리 자이아파트,202006,17,14,31,37.56179,127.024391
광진구,3528, 광진정보도서관,201901,256,343,599,37.550598,127.110512
광진구,3528, 광진정보도서관,201902,229,320,549,37.550598,127.110512
광진구,3528, 광진정보도서관,201903,492,590,1082,37.550598,127.110512
광진구,3528, 광진정보도서관,201904,860,1029,1889,37.550598,127.110512
광진구,3528, 광진정보도서관,201905,1225,1428,2653,37.550598,127.110512
광진구,3528, 광진정보도서관,201906,1478,1646,3124,37.550598,127.110512
광진구,3528, 광진정보도서관,201907,1344,1423,2767,37.550598,127.110512
광진구,3528, 광진정보도서관,201908,1363,1478,2841,37.550598,127.110512
광진구,3528, 광진정보도서관,201909,1350,1476,2826,37.550598,127.110512
광진구,3528, 광진정보도서관,201910,1571,1706,3277,37.550598,127.110512
광진구,3528, 광진정보도서관,201911,908,1032,1940,37.550598,127.110512
광진구,3528, 광진정보도서관,201912,532,568,1100,37.550598,127.110512
광진구,3528, 광진정보도서관,202001,438,545,983,37.550598,127.110512
광진구,3528, 광진정보도서관,202002,288,321,609,37.550598,127.110512
광진구,3528, 광진정보도서관,202003,744,857,1601,37.550598,127.110512
광진구,3528, 광진정보도서관,202004,1092,1215,2307,37.550598,127.110512
광진구,3528, 광진정보도서관,202005,1289,1413,2702,37.550598,127.110512
광진구,3528, 광진정보도서관,202006,1105,1268,2373,37.550598,127.110512
광진구,3529, 어린이대공원정문,201901,232,211,443,37.549789,127.075928
광진구,3529, 어린이대공원정문,201902,197,169,366,37.549789,127.075928
광진구,3529, 어린이대공원정문,201903,612,505,1117,37.549789,127.075928
광진구,3529, 어린이대공원정문,201904,1333,1075,2408,37.549789,127.075928
광진구,3529, 어린이대공원정문,201905,1472,1277,2749,37.549789,127.075928
광진구,3529, 어린이대공원정문,201906,1665,1474,3139,37.549789,127.075928
광진구,3529, 어린이대공원정문,201907,1390,1201,2591,37.549789,127.075928
광진구,3529, 어린이대공원정문,201908,1246,1163,2409,37.549789,127.075928
광진구,3529, 어린이대공원정문,201909,1070,1019,2089,37.549789,127.075928
광진구,3529, 어린이대공원정문,201910,1279,1227,2506,37.549789,127.075928
광진구,3529, 어린이대공원정문,201911,828,727,1555,37.549789,127.075928
광진구,3529, 어린이대공원정문,201912,486,432,918,37.549789,127.075928
광진구,3529, 어린이대공원정문,202001,439,364,803,37.549789,127.075928
광진구,3529, 어린이대공원정문,202002,437,371,808,37.549789,127.075928
광진구,3529, 어린이대공원정문,202003,1063,861,1924,37.549789,127.075928
광진구,3529, 어린이대공원정문,202004,1372,1150,2522,37.549789,127.075928
광진구,3529, 어린이대공원정문,202005,1248,1130,2378,37.549789,127.075928
광진구,3529, 어린이대공원정문,202006,1351,1156,2507,37.549789,127.075928
성동구,3530, 왕십리자이아파트 후문(삼거리),201901,120,76,196,37.560146,127.02636
성동구,3530, 왕십리자이아파트 후문(삼거리),201902,119,98,217,37.560146,127.02636
성동구,3530, 왕십리자이아파트 후문(삼거리),201903,256,203,459,37.560146,127.02636
성동구,3530, 왕십리자이아파트 후문(삼거리),201904,371,320,691,37.560146,127.02636
성동구,3530, 왕십리자이아파트 후문(삼거리),201905,409,366,775,37.560146,127.02636
성동구,3530, 왕십리자이아파트 후문(삼거리),201906,410,375,785,37.560146,127.02636
성동구,3530, 왕십리자이아파트 후문(삼거리),201907,443,409,852,37.560146,127.02636
성동구,3530, 왕십리자이아파트 후문(삼거리),201908,352,336,688,37.560146,127.02636
성동구,3530, 왕십리자이아파트 후문(삼거리),201909,312,300,612,37.560146,127.02636
성동구,3530, 왕십리자이아파트 후문(삼거리),201910,294,307,601,37.560146,127.02636
성동구,3530, 왕십리자이아파트 후문(삼거리),201911,273,255,528,37.560146,127.02636
성동구,3530, 왕십리자이아파트 후문(삼거리),201912,182,152,334,37.560146,127.02636
성동구,3530, 왕십리자이아파트 후문(삼거리),202001,215,189,404,37.560146,127.02636
성동구,3530, 왕십리자이아파트 후문(삼거리),202002,221,167,388,37.560146,127.02636
성동구,3530, 왕십리자이아파트 후문(삼거리),202003,316,251,567,37.560146,127.02636
성동구,3530, 왕십리자이아파트 후문(삼거리),202004,266,267,533,37.560146,127.02636
성동구,3530, 왕십리자이아파트 후문(삼거리),202005,235,233,468,37.560146,127.02636
성동구,3530, 왕십리자이아파트 후문(삼거리),202006,302,300,602,37.560146,127.02636
성동구,3531, 논골사거리(금호도서관 입구),201901,139,30,169,37.554779,127.024841
성동구,3531, 논골사거리(금호도서관 입구),201902,123,8,131,37.554779,127.024841
성동구,3531, 논골사거리(금호도서관 입구),201903,170,34,204,37.554779,127.024841
성동구,3531, 논골사거리(금호도서관 입구),201904,254,60,314,37.554779,127.024841
성동구,3531, 논골사거리(금호도서관 입구),201905,121,49,170,37.554779,127.024841
성동구,3531, 논골사거리(금호도서관 입구),201906,128,52,180,37.554779,127.024841
성동구,3531, 논골사거리(금호도서관 입구),201907,235,57,292,37.554779,127.024841
성동구,3531, 논골사거리(금호도서관 입구),201908,158,61,219,37.554779,127.024841
성동구,3531, 논골사거리(금호도서관 입구),201909,80,36,116,37.554779,127.024841
성동구,3531, 논골사거리(금호도서관 입구),201910,134,43,177,37.554779,127.024841
성동구,3531, 논골사거리(금호도서관 입구),201911,226,44,270,37.554779,127.024841
성동구,3531, 논골사거리(금호도서관 입구),201912,117,22,139,37.554779,127.024841
성동구,3531, 논골사거리(금호도서관 입구),202001,158,19,177,37.554779,127.024841
성동구,3531, 논골사거리(금호도서관 입구),202002,161,13,174,37.554779,127.024841
성동구,3531, 논골사거리(금호도서관 입구),202003,174,29,203,37.554779,127.024841
성동구,3531, 논골사거리(금호도서관 입구),202004,100,60,160,37.554779,127.024841
성동구,3531, 논골사거리(금호도서관 입구),202005,73,43,116,37.554779,127.024841
성동구,3531, 논골사거리(금호도서관 입구),202006,104,64,168,37.554779,127.024841
성동구,3532, 왕십리KCC스위첸아파트,201901,117,81,198,37.56068,127.026779
성동구,3532, 왕십리KCC스위첸아파트,201902,97,74,171,37.56068,127.026779
성동구,3532, 왕십리KCC스위첸아파트,201903,149,115,264,37.56068,127.026779
성동구,3532, 왕십리KCC스위첸아파트,201904,180,116,296,37.56068,127.026779
성동구,3532, 왕십리KCC스위첸아파트,201905,159,120,279,37.56068,127.026779
성동구,3532, 왕십리KCC스위첸아파트,201906,193,145,338,37.56068,127.026779
성동구,3532, 왕십리KCC스위첸아파트,201907,305,200,505,37.56068,127.026779
성동구,3532, 왕십리KCC스위첸아파트,201908,252,181,433,37.56068,127.026779
성동구,3532, 왕십리KCC스위첸아파트,201909,190,128,318,37.56068,127.026779
성동구,3532, 왕십리KCC스위첸아파트,201910,292,172,464,37.56068,127.026779
성동구,3532, 왕십리KCC스위첸아파트,201911,167,113,280,37.56068,127.026779
성동구,3532, 왕십리KCC스위첸아파트,201912,94,76,170,37.56068,127.026779
성동구,3532, 왕십리KCC스위첸아파트,202001,78,75,153,37.56068,127.026779
성동구,3532, 왕십리KCC스위첸아파트,202002,74,58,132,37.56068,127.026779
성동구,3532, 왕십리KCC스위첸아파트,202003,75,60,135,37.56068,127.026779
성동구,3532, 왕십리KCC스위첸아파트,202004,105,97,202,37.56068,127.026779
성동구,3532, 왕십리KCC스위첸아파트,202005,131,119,250,37.56068,127.026779
성동구,3532, 왕십리KCC스위첸아파트,202006,109,99,208,37.56068,127.026779
광진구,3533, 건대입구역 사거리(롯데백화점),201901,1021,1151,2172,37.539139,127.070618
광진구,3533, 건대입구역 사거리(롯데백화점),201902,934,1134,2068,37.539139,127.070618
광진구,3533, 건대입구역 사거리(롯데백화점),201903,2210,2557,4767,37.539139,127.070618
광진구,3533, 건대입구역 사거리(롯데백화점),201904,4207,4481,8688,37.539139,127.070618
광진구,3533, 건대입구역 사거리(롯데백화점),201905,7795,7913,15708,37.539139,127.070618
광진구,3533, 건대입구역 사거리(롯데백화점),201906,7955,8189,16144,37.539139,127.070618
광진구,3533, 건대입구역 사거리(롯데백화점),201907,7107,7352,14459,37.539139,127.070618
광진구,3533, 건대입구역 사거리(롯데백화점),201908,7280,7441,14721,37.539139,127.070618
광진구,3533, 건대입구역 사거리(롯데백화점),201909,7419,7510,14929,37.539139,127.070618
광진구,3533, 건대입구역 사거리(롯데백화점),201910,8267,8358,16625,37.539139,127.070618
광진구,3533, 건대입구역 사거리(롯데백화점),201911,4580,4979,9559,37.539139,127.070618
광진구,3533, 건대입구역 사거리(롯데백화점),201912,2524,2674,5198,37.539139,127.070618
광진구,3533, 건대입구역 사거리(롯데백화점),202001,2120,2425,4545,37.539139,127.070618
광진구,3533, 건대입구역 사거리(롯데백화점),202002,2054,2311,4365,37.539139,127.070618
광진구,3533, 건대입구역 사거리(롯데백화점),202003,5098,5384,10482,37.539139,127.070618
광진구,3533, 건대입구역 사거리(롯데백화점),202004,7313,7483,14796,37.539139,127.070618
광진구,3533, 건대입구역 사거리(롯데백화점),202005,8161,8218,16379,37.539139,127.070618
광진구,3533, 건대입구역 사거리(롯데백화점),202006,7564,7646,15210,37.539139,127.070618
광진구,3534, 건대입구역 5번출구 뒤,201901,669,644,1313,37.540138,127.069283
광진구,3534, 건대입구역 5번출구 뒤,201902,641,662,1303,37.540138,127.069283
광진구,3534, 건대입구역 5번출구 뒤,201903,1314,1312,2626,37.540138,127.069283
광진구,3534, 건대입구역 5번출구 뒤,201904,2332,2353,4685,37.540138,127.069283
광진구,3534, 건대입구역 5번출구 뒤,201905,3843,3819,7662,37.540138,127.069283
광진구,3534, 건대입구역 5번출구 뒤,201906,4107,4096,8203,37.540138,127.069283
광진구,3534, 건대입구역 5번출구 뒤,201907,3821,3808,7629,37.540138,127.069283
광진구,3534, 건대입구역 5번출구 뒤,201908,3756,3759,7515,37.540138,127.069283
광진구,3534, 건대입구역 5번출구 뒤,201909,3505,3499,7004,37.540138,127.069283
광진구,3534, 건대입구역 5번출구 뒤,201910,4074,4077,8151,37.540138,127.069283
광진구,3534, 건대입구역 5번출구 뒤,201911,2681,2706,5387,37.540138,127.069283
광진구,3534, 건대입구역 5번출구 뒤,201912,1518,1515,3033,37.540138,127.069283
광진구,3534, 건대입구역 5번출구 뒤,202001,1307,1309,2616,37.540138,127.069283
광진구,3534, 건대입구역 5번출구 뒤,202002,1210,1237,2447,37.540138,127.069283
광진구,3534, 건대입구역 5번출구 뒤,202003,2239,2240,4479,37.540138,127.069283
광진구,3534, 건대입구역 5번출구 뒤,202004,3138,3112,6250,37.540138,127.069283
광진구,3534, 건대입구역 5번출구 뒤,202005,3414,3408,6822,37.540138,127.069283
광진구,3534, 건대입구역 5번출구 뒤,202006,3538,3510,7048,37.540138,127.069283
광진구,3535, 중곡사거리(국민은행),201901,266,354,620,37.559158,127.087517
광진구,3535, 중곡사거리(국민은행),201902,345,409,754,37.559158,127.087517
광진구,3535, 중곡사거리(국민은행),201903,663,792,1455,37.559158,127.087517
광진구,3535, 중곡사거리(국민은행),201904,1003,1236,2239,37.559158,127.087517
광진구,3535, 중곡사거리(국민은행),201905,1515,1899,3414,37.559158,127.087517
광진구,3535, 중곡사거리(국민은행),201906,1852,2306,4158,37.559158,127.087517
광진구,3535, 중곡사거리(국민은행),201907,1878,2437,4315,37.559158,127.087517
광진구,3535, 중곡사거리(국민은행),201908,2014,2472,4486,37.559158,127.087517
광진구,3535, 중곡사거리(국민은행),201909,1975,2345,4320,37.559158,127.087517
광진구,3535, 중곡사거리(국민은행),201910,2296,2662,4958,37.559158,127.087517
광진구,3535, 중곡사거리(국민은행),201911,1616,1892,3508,37.559158,127.087517
광진구,3535, 중곡사거리(국민은행),201912,1091,1258,2349,37.559158,127.087517
광진구,3535, 중곡사거리(국민은행),202001,916,1096,2012,37.559158,127.087517
광진구,3535, 중곡사거리(국민은행),202002,902,974,1876,37.559158,127.087517
광진구,3535, 중곡사거리(국민은행),202003,1438,1602,3040,37.559158,127.087517
광진구,3535, 중곡사거리(국민은행),202004,1896,2095,3991,37.559158,127.087517
광진구,3535, 중곡사거리(국민은행),202005,2274,2388,4662,37.559158,127.087517
광진구,3535, 중곡사거리(국민은행),202006,2473,2785,5258,37.559158,127.087517
광진구,3536, 중앙농협(자양동),201901,339,367,706,37.531811,127.080742
광진구,3536, 중앙농협(자양동),201902,289,344,633,37.531811,127.080742
광진구,3536, 중앙농협(자양동),201903,723,738,1461,37.531811,127.080742
광진구,3536, 중앙농협(자양동),201904,1017,1070,2087,37.531811,127.080742
광진구,3536, 중앙농협(자양동),201905,1727,1820,3547,37.531811,127.080742
광진구,3536, 중앙농협(자양동),201906,1963,2241,4204,37.531811,127.080742
광진구,3536, 중앙농협(자양동),201907,2235,2482,4717,37.531811,127.080742
광진구,3536, 중앙농협(자양동),201908,2335,2557,4892,37.531811,127.080742
광진구,3536, 중앙농협(자양동),201909,2145,2267,4412,37.531811,127.080742
광진구,3536, 중앙농협(자양동),201910,2630,2831,5461,37.531811,127.080742
광진구,3536, 중앙농협(자양동),201911,1734,1786,3520,37.531811,127.080742
광진구,3536, 중앙농협(자양동),201912,1054,1095,2149,37.531811,127.080742
광진구,3536, 중앙농협(자양동),202001,895,933,1828,37.531811,127.080742
광진구,3536, 중앙농협(자양동),202002,876,939,1815,37.531811,127.080742
광진구,3536, 중앙농협(자양동),202003,1541,1677,3218,37.531811,127.080742
광진구,3536, 중앙농협(자양동),202004,2102,2179,4281,37.531811,127.080742
광진구,3536, 중앙농협(자양동),202005,2221,2288,4509,37.531811,127.080742
광진구,3536, 중앙농협(자양동),202006,2499,2609,5108,37.531811,127.080742
광진구,3537, 아차산 휴먼시아 아파트 옆,201901,215,99,314,37.548489,127.093758
광진구,3537, 아차산 휴먼시아 아파트 옆,201902,161,100,261,37.548489,127.093758
광진구,3537, 아차산 휴먼시아 아파트 옆,201903,396,181,577,37.548489,127.093758
광진구,3537, 아차산 휴먼시아 아파트 옆,201904,640,380,1020,37.548489,127.093758
광진구,3537, 아차산 휴먼시아 아파트 옆,201905,927,564,1491,37.548489,127.093758
광진구,3537, 아차산 휴먼시아 아파트 옆,201906,978,612,1590,37.548489,127.093758
광진구,3537, 아차산 휴먼시아 아파트 옆,201907,847,552,1399,37.548489,127.093758
광진구,3537, 아차산 휴먼시아 아파트 옆,201908,739,464,1203,37.548489,127.093758
광진구,3537, 아차산 휴먼시아 아파트 옆,201909,676,431,1107,37.548489,127.093758
광진구,3537, 아차산 휴먼시아 아파트 옆,201910,767,556,1323,37.548489,127.093758
광진구,3537, 아차산 휴먼시아 아파트 옆,201911,595,438,1033,37.548489,127.093758
광진구,3537, 아차산 휴먼시아 아파트 옆,201912,358,228,586,37.548489,127.093758
광진구,3537, 아차산 휴먼시아 아파트 옆,202001,400,211,611,37.548489,127.093758
광진구,3537, 아차산 휴먼시아 아파트 옆,202002,297,201,498,37.548489,127.093758
광진구,3537, 아차산 휴먼시아 아파트 옆,202003,546,356,902,37.548489,127.093758
광진구,3537, 아차산 휴먼시아 아파트 옆,202004,576,554,1130,37.548489,127.093758
광진구,3537, 아차산 휴먼시아 아파트 옆,202005,556,542,1098,37.548489,127.093758
광진구,3537, 아차산 휴먼시아 아파트 옆,202006,772,551,1323,37.548489,127.093758
성동구,3538, 서울숲 IT캐슬,201901,126,108,234,37.550892,127.044762
성동구,3538, 서울숲 IT캐슬,201902,122,93,215,37.550892,127.044762
성동구,3538, 서울숲 IT캐슬,201903,313,256,569,37.550892,127.044762
성동구,3538, 서울숲 IT캐슬,201904,470,384,854,37.550892,127.044762
성동구,3538, 서울숲 IT캐슬,201905,761,718,1479,37.550892,127.044762
성동구,3538, 서울숲 IT캐슬,201906,659,654,1313,37.550892,127.044762
성동구,3538, 서울숲 IT캐슬,201907,601,605,1206,37.550892,127.044762
성동구,3538, 서울숲 IT캐슬,201908,762,763,1525,37.550892,127.044762
성동구,3538, 서울숲 IT캐슬,201909,668,683,1351,37.550892,127.044762
성동구,3538, 서울숲 IT캐슬,201910,895,896,1791,37.550892,127.044762
성동구,3538, 서울숲 IT캐슬,201911,572,578,1150,37.550892,127.044762
성동구,3538, 서울숲 IT캐슬,201912,238,236,474,37.550892,127.044762
성동구,3538, 서울숲 IT캐슬,202001,249,250,499,37.550892,127.044762
성동구,3538, 서울숲 IT캐슬,202002,313,310,623,37.550892,127.044762
성동구,3538, 서울숲 IT캐슬,202003,861,857,1718,37.550892,127.044762
성동구,3538, 서울숲 IT캐슬,202004,1124,1125,2249,37.550892,127.044762
성동구,3538, 서울숲 IT캐슬,202005,1161,1165,2326,37.550892,127.044762
성동구,3538, 서울숲 IT캐슬,202006,1018,1016,2034,37.550892,127.044762
강동구,3539, 서원마을,201901,33,59,92,37.56382,127.132843
강동구,3539, 서원마을,201902,28,31,59,37.56382,127.132843
강동구,3539, 서원마을,201903,33,57,90,37.56382,127.132843
강동구,3539, 서원마을,201904,74,78,152,37.56382,127.132843
강동구,3539, 서원마을,201905,160,159,319,37.56382,127.132843
강동구,3539, 서원마을,201906,166,179,345,37.56382,127.132843
강동구,3539, 서원마을,201907,148,167,315,37.56382,127.132843
강동구,3539, 서원마을,201908,141,158,299,37.56382,127.132843
강동구,3539, 서원마을,201909,142,161,303,37.56382,127.132843
강동구,3539, 서원마을,201910,170,206,376,37.56382,127.132843
강동구,3539, 서원마을,201911,100,97,197,37.56382,127.132843
강동구,3539, 서원마을,201912,76,64,140,37.56382,127.132843
강동구,3539, 서원마을,202001,86,95,181,37.56382,127.132843
강동구,3539, 서원마을,202002,56,44,100,37.56382,127.132843
강동구,3539, 서원마을,202003,142,116,258,37.56382,127.132843
강동구,3539, 서원마을,202004,217,185,402,37.56382,127.132843
강동구,3539, 서원마을,202005,240,240,480,37.56382,127.132843
강동구,3539, 서원마을,202006,194,180,374,37.56382,127.132843
광진구,3541, 커먼그라운드,201901,615,560,1175,37.54504,127.089958
광진구,3541, 커먼그라운드,201902,673,637,1310,37.54504,127.089958
광진구,3541, 커먼그라운드,201903,1539,1346,2885,37.54504,127.089958
광진구,3541, 커먼그라운드,201904,2592,2344,4936,37.54504,127.089958
광진구,3541, 커먼그라운드,201905,4386,3981,8367,37.54504,127.089958
광진구,3541, 커먼그라운드,201906,4701,4340,9041,37.54504,127.089958
광진구,3541, 커먼그라운드,201907,4316,3967,8283,37.54504,127.089958
광진구,3541, 커먼그라운드,201908,4107,3841,7948,37.54504,127.089958
광진구,3541, 커먼그라운드,201909,3852,3706,7558,37.54504,127.089958
광진구,3541, 커먼그라운드,201910,4700,4460,9160,37.54504,127.089958
광진구,3541, 커먼그라운드,201911,2956,2817,5773,37.54504,127.089958
광진구,3541, 커먼그라운드,201912,1774,1771,3545,37.54504,127.089958
광진구,3541, 커먼그라운드,202001,1442,1450,2892,37.54504,127.089958
광진구,3541, 커먼그라운드,202002,1341,1407,2748,37.54504,127.089958
광진구,3541, 커먼그라운드,202003,2607,2597,5204,37.54504,127.089958
광진구,3541, 커먼그라운드,202004,3747,3760,7507,37.54504,127.089958
광진구,3541, 커먼그라운드,202005,3959,3947,7906,37.54504,127.089958
광진구,3541, 커먼그라운드,202006,3927,3919,7846,37.54504,127.089958
광진구,3542, 래미안 구의파크 스위트,201901,405,368,773,37.54504,127.089958
광진구,3542, 래미안 구의파크 스위트,201902,361,342,703,37.54504,127.089958
광진구,3542, 래미안 구의파크 스위트,201903,590,510,1100,37.54504,127.089958
광진구,3542, 래미안 구의파크 스위트,201904,962,884,1846,37.54504,127.089958
광진구,3542, 래미안 구의파크 스위트,201905,1679,1664,3343,37.54504,127.089958
광진구,3542, 래미안 구의파크 스위트,201906,1922,1914,3836,37.54504,127.089958
광진구,3542, 래미안 구의파크 스위트,201907,2085,2076,4161,37.54504,127.089958
광진구,3542, 래미안 구의파크 스위트,201908,2172,2175,4347,37.54504,127.089958
광진구,3542, 래미안 구의파크 스위트,201909,1916,1924,3840,37.54504,127.089958
광진구,3542, 래미안 구의파크 스위트,201910,2165,2169,4334,37.54504,127.089958
광진구,3542, 래미안 구의파크 스위트,201911,1406,1399,2805,37.54504,127.089958
광진구,3542, 래미안 구의파크 스위트,201912,939,923,1862,37.54504,127.089958
광진구,3542, 래미안 구의파크 스위트,202001,743,760,1503,37.54504,127.089958
광진구,3542, 래미안 구의파크 스위트,202002,622,595,1217,37.54504,127.089958
광진구,3542, 래미안 구의파크 스위트,202003,837,835,1672,37.54504,127.089958
광진구,3542, 래미안 구의파크 스위트,202004,1481,1452,2933,37.54504,127.089958
광진구,3542, 래미안 구의파크 스위트,202005,1517,1520,3037,37.54504,127.089958
광진구,3542, 래미안 구의파크 스위트,202006,1777,1783,3560,37.54504,127.089958
광진구,3543, 세종대학교(학술정보원),201912,7,3,10,37.551373,127.07444
광진구,3543, 세종대학교(학술정보원),202001,262,224,486,37.551373,127.07444
광진구,3543, 세종대학교(학술정보원),202002,243,225,468,37.551373,127.07444
광진구,3543, 세종대학교(학술정보원),202003,241,205,446,37.551373,127.07444
광진구,3543, 세종대학교(학술정보원),202004,370,297,667,37.551373,127.07444
광진구,3543, 세종대학교(학술정보원),202005,412,372,784,37.551373,127.07444
광진구,3543, 세종대학교(학술정보원),202006,596,508,1104,37.551373,127.07444
성동구,3544,한양대역 3번 출구,202004,3,3,6,37.554539,127.043778
성동구,3544,한양대역 3번 출구,202006,621,587,1208,37.554539,127.043778
성동구,3545,한양대역 1번출구,202004,2,2,4,37.55658,127.043358
성동구,3545,한양대역 1번출구,202005,511,508,1019,37.55658,127.043358
성동구,3545,한양대역 1번출구,202006,1015,1016,2031,37.55658,127.043358
성동구,3548,뚝섬역 6번출구,202006,115,112,227,37.546959,127.047669
성동구,3549,건영아파트 앞,202006,106,110,216,37.555141,127.071106
성동구,3550,금호나들목,202004,1,1,2,37.544041,127.023201
성동구,3550,금호나들목,202005,155,152,307,37.544041,127.023201
성동구,3550,금호나들목,202006,713,704,1417,37.544041,127.023201
성동구,3551,성동도로사업소,202004,1,1,2,37.559799,127.056328
성동구,3551,성동도로사업소,202005,59,49,108,37.559799,127.056328
성동구,3551,성동도로사업소,202006,217,207,424,37.559799,127.056328
성동구,3552,서울숲 공영주차장앞,202004,2,2,4,37.541958,127.04277
성동구,3552,서울숲 공영주차장앞,202005,527,513,1040,37.541958,127.04277
성동구,3552,서울숲 공영주차장앞,202006,914,893,1807,37.541958,127.04277
성동구,3553,마장역3번출구,202004,2,2,4,37.565979,127.043114
성동구,3553,마장역3번출구,202005,61,60,121,37.565979,127.043114
성동구,3553,마장역3번출구,202006,264,271,535,37.565979,127.043114
성동구,3555,양지사거리(센트라스APT 115동앞),202004,1,1,2,37.566818,127.029152
성동구,3555,양지사거리(센트라스APT 115동앞),202005,18,13,31,37.566818,127.029152
성동구,3555,양지사거리(센트라스APT 115동앞),202006,93,72,165,37.566818,127.029152
성동구,3556,신금호파크자이APT앞,202004,1,1,2,37.555313,127.019791
성동구,3556,신금호파크자이APT앞,202006,31,19,50,37.555313,127.019791
성동구,3557,서울숲리버뷰자이APT105동 앞,202004,2,2,4,37.55653,127.039131
성동구,3557,서울숲리버뷰자이APT105동 앞,202006,200,185,385,37.55653,127.039131
성동구,3558,마장동 금호어울림APT앞,202004,2,2,4,37.563396,127.04187
성동구,3558,마장동 금호어울림APT앞,202005,136,138,274,37.563396,127.04187
성동구,3558,마장동 금호어울림APT앞,202006,455,451,906,37.563396,127.04187
성동구,3559,성동구민종합체육센터 앞,202004,2,2,4,37.54591,127.044601
성동구,3559,성동구민종합체육센터 앞,202005,556,550,1106,37.54591,127.044601
성동구,3559,성동구민종합체육센터 앞,202006,1700,1668,3368,37.54591,127.044601
성동구,3560,성동구 견인차량 보관소 앞,202004,2,1,3,37.563709,127.05645
성동구,3560,성동구 견인차량 보관소 앞,202005,223,225,448,37.563709,127.05645
성동구,3560,성동구 견인차량 보관소 앞,202006,927,919,1846,37.563709,127.05645
성동구,3561,행당동 삼부APT후문,202004,1,1,2,37.559269,127.038399
성동구,3561,행당동 삼부APT후문,202006,48,48,96,37.559269,127.038399
성동구,3562,행당중학교 후문,202004,1,2,3,#N/A,#N/A
성동구,3562,행당중학교 후문,202005,1,0,1,#N/A,#N/A
광진구,3563,구의7단지현대아파트,202006,7,5,12,37.53651,127.091393
광진구,3564,나루마당,202004,1,1,2,37.547752,127.095757
광진구,3564,나루마당,202006,36,10,46,37.547752,127.095757
광진구,3566,우성4차아파트,202004,3,3,6,37.535072,127.076111
광진구,3566,우성4차아파트,202006,231,231,462,37.535072,127.076111
광진구,3568,구의공원,202006,1,1,2,#N/A,#N/A
광진구,3569,건대병원후문,202006,622,609,1231,37.539566,127.072441
광진구,3570,구의역 리버비스타 오피스텔,202004,1,1,2,37.538097,127.08902
광진구,3570,구의역 리버비스타 오피스텔,202006,463,461,924,37.538097,127.08902
광진구,3571,화양 APT(횡단보도 옆),202004,4,4,8,37.54435,127.065407
광진구,3571,화양 APT(횡단보도 옆),202006,418,418,836,37.54435,127.065407
광진구,3572,중곡동 성당,202004,1,1,2,#N/A,#N/A
광진구,3575,자양사거리 (LG 유플러스),202004,18,19,37,37.536575,127.082581
광진구,3575,자양사거리 (LG 유플러스),202005,4,3,7,37.536575,127.082581
광진구,3575,자양사거리 (LG 유플러스),202006,464,465,929,37.536575,127.082581
광진구,3576,강변SK뷰 APT앞,202004,2,3,5,#N/A,#N/A
광진구,3576,강변SK뷰 APT앞,202005,1,0,1,#N/A,#N/A
광진구,3577,신자초교 입구 교차로(SC제일은행),202004,30,30,60,#N/A,#N/A
광진구,3577,신자초교 입구 교차로(SC제일은행),202005,3,1,4,#N/A,#N/A
광진구,3577,신자초교 입구 교차로(SC제일은행),202006,673,680,1353,#N/A,#N/A
광진구,3578,중곡동 파크웨이빌딩,202004,1,1,2,37.555008,127.085815
광진구,3578,중곡동 파크웨이빌딩,202006,201,199,400,37.555008,127.085815
광진구,3579,광진 캠퍼스시티,202004,1,1,2,37.54789,127.067452
광진구,3579,광진 캠퍼스시티,202006,405,401,806,37.54789,127.067452
광진구,3581,광진광장,202004,1,1,2,37.54747,127.073967
광진구,3581,광진광장,202006,190,183,373,37.54747,127.073967
광진구,3582,화양동 우체국,202004,5,5,10,37.547989,127.069504
광진구,3582,화양동 우체국,202006,213,195,408,37.547989,127.069504
광진구,3586,군자역 비채온 오피스텔,202004,3,3,6,37.557713,127.077271
광진구,3586,군자역 비채온 오피스텔,202006,304,301,605,37.557713,127.077271
광진구,3587,우성식품 앞,202006,57,64,121,#N/A,#N/A
광진구,3588,세종대학교(영실관),202006,85,79,164,#N/A,#N/A
정비센터,9993, 개화정비,201906,14,7,21,#N/A,#N/A
정비센터,9993, 개화정비,201907,40,25,65,#N/A,#N/A
정비센터,9993, 개화정비,201908,17,21,38,#N/A,#N/A
정비센터,9993, 개화정비,201909,15,12,27,#N/A,#N/A
정비센터,9993, 개화정비,201910,13,26,39,#N/A,#N/A
정비센터,9993, 개화정비,201911,29,39,68,#N/A,#N/A
정비센터,9993, 개화정비,201912,14,24,38,#N/A,#N/A
정비센터,9993, 개화정비,202001,4,6,10,#N/A,#N/A
정비센터,9993, 개화정비,202002,2,6,8,#N/A,#N/A
정비센터,9993, 개화정비,202003,26,64,90,#N/A,#N/A
정비센터,9993, 개화정비,202004,4,13,17,#N/A,#N/A
정비센터,9993, 개화정비,202006,1,1,2,#N/A,#N/A
성동구,9996, 시설2,201902,2,2,4,#N/A,#N/A
성동구,9996, 시설2,201903,2,2,4,#N/A,#N/A
정비센터,9997,강남센터,201906,40,58,98,#N/A,#N/A
정비센터,9997,강남센터,201907,58,55,113,#N/A,#N/A
정비센터,9997,강남센터,201908,71,87,158,#N/A,#N/A
정비센터,9997,강남센터,201909,126,174,300,#N/A,#N/A
정비센터,9997,강남센터,201910,61,103,164,#N/A,#N/A
정비센터,9997,강남센터,201911,38,39,77,#N/A,#N/A
정비센터,9997,강남센터,201912,20,19,39,#N/A,#N/A
정비센터,9997,강남센터,202001,4,4,8,#N/A,#N/A
정비센터,9997,강남센터,202002,4,5,9,#N/A,#N/A
정비센터,9997,강남센터,202003,6,7,13,#N/A,#N/A
정비센터,9997,강남센터,202004,12,9,21,#N/A,#N/A
정비센터,9997,강남센터,202005,23,17,40,#N/A,#N/A
정비센터,9997,강남센터,202006,33,18,51,#N/A,#N/A
정비센터,9998, 영남주차장 정비센터,201906,5,17,22,#N/A,#N/A
정비센터,9998, 영남주차장 정비센터,201907,0,12,12,#N/A,#N/A
정비센터,9998, 영남주차장 정비센터,201908,5,11,16,#N/A,#N/A
정비센터,9998, 영남주차장 정비센터,201909,13,10,23,#N/A,#N/A
정비센터,9998, 영남주차장 정비센터,201910,13,9,22,#N/A,#N/A
정비센터,9998, 영남주차장 정비센터,201911,11,12,23,#N/A,#N/A
정비센터,9998, 영남주차장 정비센터,201912,12,13,25,#N/A,#N/A
정비센터,9998, 영남주차장 정비센터,202001,4,4,8,#N/A,#N/A
정비센터,9998, 영남주차장 정비센터,202002,1,1,2,#N/A,#N/A
정비센터,9998, 영남주차장 정비센터,202004,3,4,7,#N/A,#N/A
정비센터,9998, 영남주차장 정비센터,202005,0,1,1,#N/A,#N/A
정비센터,9998, 영남주차장 정비센터,202006,1,2,3,#N/A,#N/A
정비센터,99998, 상암단말정비,201910,1,1,2,#N/A,#N/A
정비센터,99998, 상암단말정비,201911,2,1,3,#N/A,#N/A
정비센터,99998, 상암단말정비,201912,3,5,8,#N/A,#N/A
정비센터,99998, 상암단말정비,202001,0,1,1,#N/A,#N/A
정비센터,99998, 상암단말정비,202002,2,6,8,#N/A,#N/A
정비센터,99998, 상암단말정비,202003,4,14,18,#N/A,#N/A
정비센터,99998, 상암단말정비,202004,0,9,9,#N/A,#N/A
정비센터,99998, 상암단말정비,202005,0,3,3,#N/A,#N/A
정비센터,99998, 상암단말정비,202006,1,1,2,#N/A,#N/A
정비센터,99999, 영남단말기정비,201907,1,0,1,#N/A,#N/A
정비센터,99999, 영남단말기정비,201908,46,9,55,#N/A,#N/A
정비센터,99999, 영남단말기정비,201909,34,10,44,#N/A,#N/A
정비센터,99999, 영남단말기정비,201910,43,36,79,#N/A,#N/A
정비센터,99999, 영남단말기정비,201911,33,22,55,#N/A,#N/A
정비센터,99999, 영남단말기정비,201912,22,24,46,#N/A,#N/A
정비센터,99999, 영남단말기정비,202001,20,19,39,#N/A,#N/A
정비센터,99999, 영남단말기정비,202002,19,20,39,#N/A,#N/A
정비센터,99999, 영남단말기정비,202003,10,16,26,#N/A,#N/A
정비센터,99999, 영남단말기정비,202004,5,6,11,#N/A,#N/A
정비센터,99999, 영남단말기정비,202005,0,1,1,#N/A,#N/A
정비센터,99999, 영남단말기정비,202006,6,5,11,#N/A,#N/A
구분,대여소명,,대여일자,대여건수,,0,#N/A,#N/A
